Date,time,close,quote,H_L,H_C,C_L,avg_c10_filt,avg_vol10_filt
2001/1/4,945,5060,-89,89,80,9,0.965,0.699
2001/1/4,1045,5130,65,68,-1,69,0.959,1.26
2001/1/4,1145,5105,-25,50,30,20,0.97,1.294
2001/1/4,1245,5128,18,33,7,26,0.97,1.83
2001/1/4,1345,5121,-8,52,54,-2,0.976,0.935
2001/1/5,945,5170,20,72,23,49,0.973,0.726
2001/1/5,1045,5140,-31,55,40,15,0.984,1.054
2001/1/5,1145,5175,33,40,1,39,0.982,1.412
2001/1/5,1245,5225,49,110,42,68,0.978,0.77
2001/1/5,1345,5340,116,119,-11,130,0.963,0.94
2001/1/8,945,5265,-25,46,21,25,0.979,0.846
2001/1/8,1045,5303,43,82,16,66,0.976,1.078
2001/1/8,1145,5320,15,58,28,30,0.976,1.034
2001/1/8,1245,5281,-39,77,77,0,0.987,1.233
2001/1/8,1345,5196,-84,100,78,22,1.006,0.696
2001/1/9,945,5269,48,81,36,45,0.994,0.766
2001/1/9,1045,5290,29,40,15,25,0.992,1.23
2001/1/9,1145,5276,-19,70,64,6,0.997,0.8
2001/1/9,1245,5316,41,85,14,71,0.991,0.927
2001/1/9,1345,5400,84,109,19,90,0.978,0.815
2001/1/10,945,5380,0,59,39,20,0.983,0.966
2001/1/10,1045,5364,-19,68,57,11,0.988,1.346
2001/1/10,1145,5400,40,93,15,78,0.983,1.172
2001/1/10,1245,5417,17,74,32,42,0.981,1.057
2001/1/10,1345,5408,-12,82,32,50,0.985,0.99
2001/1/11,945,5420,-2,58,50,8,0.987,1.075
2001/1/11,1045,5451,28,59,24,35,0.984,1.486
2001/1/11,1145,5410,-41,102,84,18,0.995,0.964
2001/1/11,1245,5331,-79,99,86,13,1.012,0.707
2001/1/11,1345,5340,14,35,15,20,1.01,1.026
2001/1/12,945,5309,-76,108,84,24,1.016,0.952
2001/1/12,1045,5309,-1,38,21,17,1.015,1.395
2001/1/12,1145,5301,-4,39,24,15,1.015,2.287
2001/1/12,1245,5261,-42,49,48,1,1.021,1.66
2001/1/12,1345,5378,113,107,-13,120,0.996,0.986
2001/1/15,945,5282,-38,56,44,12,1.012,1.362
2001/1/15,1045,5287,5,23,13,10,1.009,2.81
2001/1/15,1145,5288,0,26,15,11,1.005,3.248
2001/1/15,1245,5330,36,56,17,39,0.995,1.32
2001/1/15,1345,5407,77,108,23,85,0.981,0.746
2001/1/16,945,5516,92,163,33,130,0.963,0.804
2001/1/16,1045,5682,153,204,30,174,0.938,0.769
2001/1/16,1145,5678,-4,65,12,53,0.946,1.062
2001/1/16,1245,5685,4,49,21,28,0.951,1.958
2001/1/16,1345,5746,61,60,2,58,0.948,1.217
2001/1/17,945,5718,-106,70,52,18,0.962,1.406
2001/1/17,1045,5777,57,81,16,65,0.959,2.905
2001/1/17,1145,5722,-61,108,86,22,0.977,2.826
2001/1/17,1245,5775,50,53,3,50,0.976,3.545
2001/1/17,1345,5802,25,59,17,42,0.979,1.203
2001/1/18,945,5801,-29,90,59,31,0.986,0.432
2001/1/18,1045,5863,61,82,25,57,0.98,0.489
2001/1/18,1145,5870,6,70,60,10,0.982,0.485
2001/1/18,1245,5910,40,80,0,80,0.979,0.58
2001/1/18,1345,5949,48,65,1,64,0.976,0.547
2001/1/29,945,5905,-17,88,33,55,0.985,0.885
2001/1/29,1045,5936,34,70,24,46,0.983,1.217
2001/1/29,1145,5930,-6,52,32,20,0.986,1.44
2001/1/29,1245,5903,-24,64,62,2,0.994,1.574
2001/1/29,1345,5658,-248,250,241,9,1.04,0.645
2001/1/30,945,5770,102,80,-5,85,1.017,1.089
2001/1/30,1045,5680,-99,130,110,20,1.033,0.727
2001/1/30,1145,5604,-85,128,126,2,1.043,0.892
2001/1/30,1245,5700,98,114,4,110,1.021,0.824
2001/1/30,1345,5819,119,150,31,119,0.997,0.689
2001/1/31,945,5888,38,100,42,58,0.984,1.035
2001/1/31,1045,5931,41,48,4,44,0.977,1.098
2001/1/31,1145,5908,-24,124,81,43,0.98,0.802
2001/1/31,1245,5960,59,80,0,80,0.971,1.281
2001/1/31,1345,5951,-13,80,69,11,0.974,0.842
2001/2/1,945,5940,0,68,29,39,0.98,1.468
2001/2/1,1045,5906,-42,68,42,26,0.989,1.284
2001/2/1,1145,5935,27,75,22,53,0.987,1.225
2001/2/1,1245,5850,-86,109,110,-1,1.008,0.948
2001/2/1,1345,5900,55,79,0,79,1.001,0.875
2001/2/2,945,6011,61,71,20,51,0.985,0.747
2001/2/2,1045,6020,9,55,15,40,0.985,1.333
2001/2/2,1145,6011,-9,49,39,10,0.988,1.209
2001/2/2,1245,6042,28,61,23,38,0.985,1.12
2001/2/2,1345,6019,-21,55,41,14,0.99,0.926
2001/2/5,945,5936,-33,37,12,25,1.004,0.978
2001/2/5,1045,5880,-60,66,54,12,1.014,1.13
2001/2/5,1145,5896,14,27,13,14,1.01,1.689
2001/2/5,1245,5914,24,28,6,22,1.007,1.786
2001/2/5,1345,5911,-3,48,32,16,1.008,0.98
2001/2/6,945,5990,109,130,0,130,0.994,0.636
2001/2/6,1045,5927,-58,60,63,-3,1.004,1.046
2001/2/6,1145,5910,-15,53,14,39,1.005,0.787
2001/2/6,1245,5822,-93,118,108,10,1.019,0.703
2001/2/6,1345,5837,17,47,11,36,1.012,0.868
2001/2/7,945,5737,-58,46,44,2,1.027,0.779
2001/2/7,1045,5757,21,36,14,22,1.02,1.654
2001/2/7,1145,5736,-24,35,21,14,1.021,1.452
2001/2/7,1245,5735,-1,37,12,25,1.019,1.568
2001/2/7,1345,5683,-52,64,71,-7,1.025,1.244
2001/2/8,945,5725,45,99,40,59,1.014,0.876
2001/2/8,1045,5704,-24,48,24,24,1.013,1.094
2001/2/8,1145,5716,15,29,13,16,1.007,1.619
2001/2/8,1245,5710,-9,47,42,5,1.005,1.122
2001/2/8,1345,5776,66,72,6,66,0.992,0.727
2001/2/9,945,5745,-3,34,20,14,0.996,0.957
2001/2/9,1045,5737,-8,34,13,21,0.998,1.449
2001/2/9,1145,5795,58,60,8,52,0.987,0.675
2001/2/9,1245,5825,30,53,13,40,0.983,0.859
2001/2/9,1345,5755,-70,107,105,2,0.997,0.684
2001/2/12,945,5790,45,77,10,67,0.992,1.149
2001/2/12,1045,5810,11,39,15,24,0.99,1.19
2001/2/12,1145,5817,7,33,21,12,0.99,1.285
2001/2/12,1245,5770,-47,58,59,-1,1,1.641
2001/2/12,1345,5820,55,65,-5,70,0.992,0.874
2001/2/13,945,5910,32,65,36,29,0.979,0.76
2001/2/13,1045,5936,26,44,13,31,0.978,1.201
2001/2/13,1145,5945,8,30,10,20,0.98,1.377
2001/2/13,1245,5965,21,49,14,35,0.979,1.259
2001/2/13,1345,6040,74,112,5,107,0.969,0.693
2001/2/14,945,5981,-59,74,64,10,0.984,0.832
2001/2/14,1045,6008,22,33,6,27,0.982,1.767
2001/2/14,1145,6007,-1,39,22,17,0.986,1.569
2001/2/14,1245,5928,-79,108,81,27,1.002,0.725
2001/2/14,1345,5840,-85,115,105,10,1.02,0.657
2001/2/15,945,5955,64,77,5,72,1.001,0.67
2001/2/15,1045,6016,62,86,24,62,0.991,0.735
2001/2/15,1145,6094,79,77,-4,81,0.98,1.143
2001/2/15,1245,6045,-45,74,49,25,0.99,1.315
2001/2/15,1345,6095,53,107,23,84,0.983,0.835
2001/2/16,945,6050,-90,86,69,17,0.992,0.898
2001/2/16,1045,6028,-22,42,21,21,0.997,1.215
2001/2/16,1145,5985,-44,89,50,39,1.004,0.973
2001/2/16,1245,6007,25,68,19,49,1,1.432
2001/2/16,1345,6025,16,79,54,25,0.999,0.907
2001/2/19,945,5913,-12,48,17,31,1.018,1.225
2001/2/19,1045,5938,26,36,10,26,1.013,2.16
2001/2/19,1145,5919,-19,38,29,9,1.015,2.404
2001/2/19,1245,5933,14,56,16,40,1.01,2.315
2001/2/19,1345,5943,3,51,2,49,1.006,1.536
2001/2/20,945,6012,57,66,25,41,0.992,1.614
2001/2/20,1045,6010,-2,43,24,19,0.992,2.928
2001/2/20,1145,6006,-4,28,14,14,0.992,3.141
2001/2/20,1245,5967,5967,53,42,11,0.898,1.965
2001/2/20,1345,5956,-9,63,22,41,0.899,1.348
2001/2/21,945,5866,-19,39,24,15,0.912,1.049
2001/2/21,1045,5873,3,18,15,3,0.91,2.719
2001/2/21,1145,5879,6,25,6,19,0.908,3.187
2001/2/21,1245,5890,5890,29,9,20,0.806,2.016
2001/2/21,1345,5981,5981,85,-6,91,0.695,0.951
2001/2/22,945,5815,-36,36,22,14,0.713,0.238
2001/2/22,1045,5771,-44,48,48,0,0.715,0.416
2001/2/22,1145,5757,-14,35,33,2,0.712,0.682
2001/2/22,1245,5751,-6,37,16,21,0.813,0.596
2001/2/22,1345,5769,14,48,16,32,0.807,0.564
2001/2/23,945,5762,17,69,28,41,0.805,0.57
2001/2/23,1045,5760,-2,36,9,27,0.804,1.455
2001/2/23,1145,5775,15,28,5,23,0.8,1.249
2001/2/23,1245,5764,-16,42,13,29,0.902,1.378
2001/2/23,1345,5746,-16,38,23,15,1.005,1.249
2001/2/26,945,5762,16,45,23,22,1,1.233
2001/2/26,1045,5768,6,23,7,16,0.998,1.886
2001/2/26,1145,5740,-27,36,30,6,1.003,1.812
2001/2/26,1245,5747,8,25,3,22,1.001,1.297
2001/2/26,1345,5760,10,35,0,35,0.999,1.176
2001/2/27,945,5785,-20,49,34,15,0.996,0.606
2001/2/27,1045,5785,0,21,11,10,0.996,1.452
2001/2/27,1145,5742,-43,35,43,-8,1.004,1.094
2001/2/27,1245,5691,-50,64,54,10,1.012,0.718
2001/2/27,1345,5665,-32,57,32,25,1.016,0.592
2001/3/1,945,5559,-22,43,21,22,1.032,0.621
2001/3/1,1045,5550,-10,30,20,10,1.03,1.946
2001/3/1,1145,5519,-31,50,40,10,1.032,1.402
2001/3/1,1245,5495,-25,37,38,-1,1.033,1.268
2001/3/1,1345,5536,41,51,1,50,1.02,1.004
2001/3/2,945,5500,-41,75,65,10,1.022,0.766
2001/3/2,1045,5534,34,74,26,48,1.011,0.898
2001/3/2,1145,5543,7,27,-1,28,1.005,1.58
2001/3/2,1245,5513,-31,43,35,8,1.007,1.447
2001/3/2,1345,5505,-8,39,31,8,1.005,0.97
2001/3/5,945,5515,5,50,25,25,1.002,1.017
2001/3/5,1045,5541,25,25,4,21,0.996,1.203
2001/3/5,1145,5556,15,34,14,20,0.993,0.949
2001/3/5,1245,5572,12,27,6,21,0.991,1.246
2001/3/5,1345,5619,45,51,7,44,0.984,0.738
2001/3/6,945,5636,-14,56,48,8,0.983,0.571
2001/3/6,1045,5690,55,58,2,56,0.976,0.758
2001/3/6,1145,5700,9,31,-1,32,0.977,0.896
2001/3/6,1245,5650,-50,59,46,13,0.989,0.879
2001/3/6,1345,5632,-14,39,17,22,0.994,0.811
2001/3/7,945,5707,18,31,23,8,0.984,0.674
2001/3/7,1045,5736,26,32,3,29,0.983,1.213
2001/3/7,1145,5720,-15,32,20,12,0.989,1.391
2001/3/7,1245,5715,-2,45,10,35,0.992,1.067
2001/3/7,1345,5733,20,39,17,22,0.992,0.853
2001/3/8,945,5690,-59,49,54,-5,1.001,1.065
2001/3/8,1045,5702,5,26,16,10,1,1.724
2001/3/8,1145,5694,-9,39,26,13,1.002,1.376
2001/3/8,1245,5703,9,33,12,21,1,1.928
2001/3/8,1345,5710,7,25,-1,26,1,1.444
2001/3/9,945,5644,-5,18,4,14,1.011,0.747
2001/3/9,1045,5616,-28,30,26,4,1.015,1.147
2001/3/9,1145,5629,9,13,0,13,1.01,2.628
2001/3/9,1245,5620,-9,25,19,6,1.01,1.837
2001/3/9,1345,5630,10,33,23,10,1.007,1.015
2001/3/12,945,5548,49,51,3,48,1.017,0.708
2001/3/12,1045,5548,3,20,7,13,1.014,1.481
2001/3/12,1145,5529,-19,37,28,9,1.015,1.447
2001/3/12,1245,5535,12,23,4,19,1.011,1.286
2001/3/12,1345,5535,-4,27,24,3,1.008,1.006
2001/3/13,945,5546,66,100,4,96,1.003,0.483
2001/3/13,1045,5587,40,53,-3,56,0.994,0.641
2001/3/13,1145,5630,42,45,3,42,0.986,0.644
2001/3/13,1245,5613,-17,40,37,3,0.989,0.902
2001/3/13,1345,5631,18,42,-1,43,0.985,0.843
2001/3/14,945,5638,-48,68,56,12,0.987,0.691
2001/3/14,1045,5630,-7,23,20,3,0.99,1.6
2001/3/14,1145,5655,25,24,0,24,0.988,1.883
2001/3/14,1245,5626,-24,33,34,-1,0.995,1.524
2001/3/14,1345,5651,25,38,12,26,0.992,1.459
2001/3/15,945,5585,-23,70,55,15,1.006,0.719
2001/3/15,1045,5610,25,40,15,25,1.002,1.198
2001/3/15,1145,5683,73,78,-3,81,0.99,0.67
2001/3/15,1245,5716,33,51,5,46,0.985,0.821
2001/3/15,1345,5780,64,80,0,80,0.976,0.609
2001/3/16,945,5770,20,58,28,30,0.979,0.876
2001/3/16,1045,5745,-25,27,32,-5,0.985,1.518
2001/3/16,1145,5769,24,23,0,23,0.983,2.606
2001/3/16,1245,5780,11,30,15,15,0.983,1.978
2001/3/16,1345,5760,-20,60,55,5,0.989,1.042
2001/3/19,945,5701,-26,78,66,12,1.002,1.104
2001/3/19,1045,5690,-11,31,17,14,1.006,1.974
2001/3/19,1145,5667,-23,32,25,7,1.011,1.829
2001/3/19,1245,5662,-4,27,22,5,1.012,2.114
2001/3/19,1345,5640,-30,49,34,15,1.015,0.845
2001/3/20,945,5642,-17,40,48,-8,1.013,1.185
2001/3/20,1045,5655,13,29,5,24,1.008,1.84
2001/3/20,1145,5675,24,28,5,23,1.003,2.571
2001/3/20,1245,5650,-25,38,25,13,1.006,2.233
2001/3/20,1345,5675,25,39,-1,40,0.999,1.423
2001/3/21,945,5650,95,99,20,79,1.001,1.033
2001/3/21,1045,5650,0,32,17,15,1,2.427
2001/3/21,1145,5634,-16,36,35,1,1.002,2.414
2001/3/21,1245,5620,-15,37,30,7,1.004,1.81
2001/3/21,1345,5632,12,25,13,12,1.001,0.613
2001/3/22,945,5708,77,68,-8,76,0.987,0.213
2001/3/22,1045,5720,12,37,10,27,0.986,0.411
2001/3/22,1145,5705,-17,23,18,5,0.99,0.817
2001/3/22,1245,5720,15,34,15,19,0.988,0.877
2001/3/22,1345,5750,26,50,0,50,0.984,0.636
2001/3/23,945,5809,-21,42,35,7,0.979,0.48
2001/3/23,1045,5808,1,24,7,17,0.981,1.307
2001/3/23,1145,5805,-3,20,5,15,0.985,1.741
2001/3/23,1245,5831,26,28,-1,29,0.983,1.22
2001/3/23,1345,5813,-18,28,17,11,0.99,1.084
2001/3/26,945,5792,-41,50,48,2,0.997,0.874
2001/3/26,1045,5805,20,35,3,32,0.996,1.179
2001/3/26,1145,5817,15,24,6,18,0.995,1.924
2001/3/26,1245,5864,47,48,1,47,0.989,0.797
2001/3/26,1345,5899,34,44,11,33,0.986,0.684
2001/3/27,945,5912,3,51,15,36,0.985,0.863
2001/3/27,1045,5913,5,30,7,23,0.987,1.201
2001/3/27,1145,5921,10,34,24,10,0.987,1.009
2001/3/27,1245,5895,-26,49,34,15,0.993,0.944
2001/3/27,1345,5868,-26,44,27,17,0.999,0.751
2001/3/28,945,5886,-14,42,9,33,0.997,1.005
2001/3/28,1045,5848,-37,55,43,12,1.005,1.084
2001/3/28,1145,5823,-25,33,31,2,1.01,1.753
2001/3/28,1245,5823,0,18,16,2,1.01,1.76
2001/3/28,1345,5830,8,43,28,15,1.008,0.992
2001/3/29,945,5843,37,41,6,35,1.004,0.87
2001/3/29,1045,5829,-11,26,13,13,1.006,1.983
2001/3/29,1145,5812,-16,21,17,4,1.007,1.978
2001/3/29,1245,5842,29,46,0,46,1,1.458
2001/3/29,1345,5870,27,48,8,40,0.995,0.66
2001/3/30,945,5840,-18,48,30,18,0.999,0.84
2001/3/30,1045,5837,-3,23,17,6,0.999,1.566
2001/3/30,1145,5804,-32,41,41,0,1.004,0.761
2001/3/30,1245,5811,9,24,4,20,1.003,1.033
2001/3/30,1345,5795,-19,45,25,20,1.005,0.792
2001/4/2,945,5751,-24,30,24,6,1.012,0.88
2001/4/2,1045,5730,-20,33,28,5,1.014,1.226
2001/4/2,1145,5710,-18,42,20,22,1.016,0.939
2001/4/2,1245,5688,-22,39,21,18,1.018,1.381
2001/4/2,1345,5621,-59,65,62,3,1.028,0.652
2001/4/3,945,5526,-69,78,58,20,1.041,0.494
2001/4/3,1045,5548,18,43,22,21,1.031,1.028
2001/4/3,1145,5531,-15,24,18,6,1.029,1.704
2001/4/3,1245,5515,-20,32,24,8,1.027,1.286
2001/4/3,1345,5470,-45,60,60,0,1.03,0.7
2001/4/4,945,5481,75,85,12,73,1.021,0.753
2001/4/4,1045,5422,-56,54,56,-2,1.027,1.307
2001/4/4,1145,5419,-4,34,31,3,1.022,1.979
2001/4/4,1245,5438,20,48,2,46,1.013,0.929
2001/4/4,1345,5469,33,54,16,38,1.003,0.838
2001/4/6,945,5560,-21,29,20,9,0.986,0.62
2001/4/6,1045,5564,9,30,13,17,0.986,1.331
2001/4/6,1145,5550,-13,32,28,4,0.989,1.813
2001/4/6,1345,5530,-36,66,46,20,0.993,0.706
2001/4/9,945,5431,-59,67,57,10,1.011,1.078
2001/4/9,1045,5418,-13,25,12,13,1.014,1.617
2001/4/9,1145,5404,-14,18,17,1,1.015,2.661
2001/4/9,1245,5430,28,47,8,39,1.01,1.382
2001/4/9,1345,5419,-11,35,16,19,1.012,1.183
2001/4/10,945,5489,70,65,1,64,0.999,0.734
2001/4/10,1045,5475,-12,34,30,4,1,0.887
2001/4/10,1145,5435,-40,44,40,4,1.006,0.878
2001/4/10,1245,5425,-13,28,14,14,1.005,1.247
2001/4/10,1345,5321,-102,108,99,9,1.022,0.511
2001/4/11,945,5390,-11,62,39,23,1.007,0.568
2001/4/11,1045,5395,5,51,46,5,1.006,0.793
2001/4/11,1145,5363,-30,49,27,22,1.011,0.952
2001/4/11,1245,5395,35,69,34,35,1.004,0.964
2001/4/11,1345,5495,101,98,0,98,0.985,0.566
2001/4/12,945,5494,-21,54,26,28,0.987,1.075
2001/4/12,1045,5503,8,33,5,28,0.986,2.227
2001/4/12,1145,5528,27,59,12,47,0.982,1.208
2001/4/12,1245,5534,6,35,16,19,0.983,1.42
2001/4/12,1345,5520,-15,28,13,15,0.987,1.391
2001/4/13,945,5547,-14,40,33,7,0.985,1.22
2001/4/13,1045,5549,2,15,11,4,0.988,2.343
2001/4/13,1145,5503,-44,55,40,15,0.999,1.227
2001/4/13,1245,5482,-18,50,28,22,1.005,1.219
2001/4/13,1345,5461,-20,48,42,6,1.01,0.985
2001/4/16,945,5416,-9,45,34,11,1.017,1.161
2001/4/16,1045,5422,7,24,14,10,1.015,2.345
2001/4/16,1145,5417,-4,20,15,5,1.014,2.774
2001/4/16,1245,5410,-4,20,20,0,1.013,1.907
2001/4/16,1345,5423,5423,21,6,15,0.909,1.14
2001/4/17,945,5410,-15,39,4,35,0.908,0.768
2001/4/17,1045,5455,40,63,1,62,0.899,1.197
2001/4/17,1145,5463,5,27,11,16,0.896,1.556
2001/4/17,1245,5410,-54,65,55,10,0.904,1.96
2001/4/17,1345,5440,30,51,22,29,0.897,1.579
2001/4/18,945,5494,14,26,16,10,0.89,0.737
2001/4/18,1045,5504,13,27,6,21,0.889,1.906
2001/4/18,1145,5515,12,28,14,14,0.889,1.596
2001/4/18,1245,5520,5,20,3,17,0.89,2.353
2001/4/18,1345,5527,7,13,1,12,0.989,0.994
2001/4/19,945,5652,-1,46,38,8,0.971,0.266
2001/4/19,1045,5631,-21,37,29,8,0.979,0.427
2001/4/19,1145,5640,9,25,10,15,0.98,0.718
2001/4/19,1245,5651,12,20,9,11,0.982,0.937
2001/4/19,1345,5628,-25,50,42,8,0.99,0.629
2001/4/20,945,5600,-43,67,58,9,0.998,0.625
2001/4/20,1045,5612,12,33,3,30,0.998,1.26
2001/4/20,1145,5619,8,31,5,26,0.998,1.631
2001/4/20,1245,5611,-7,33,8,25,1.001,1.636
2001/4/20,1345,5588,-25,24,24,0,1.007,1.646
2001/4/23,945,5575,-13,38,31,7,1.008,1.055
2001/4/23,1045,5608,33,43,10,33,1.001,1.1
2001/4/23,1145,5597,-11,26,13,13,1.003,1.522
2001/4/23,1245,5584,-14,18,16,2,1.004,2.301
2001/4/23,1345,5644,60,65,3,62,0.992,0.659
2001/4/24,945,5663,42,70,17,53,0.989,0.465
2001/4/24,1045,5670,7,15,0,15,0.989,1.061
2001/4/24,1145,5642,-28,39,35,4,0.995,0.959
2001/4/24,1245,5621,-19,25,29,-4,0.999,1.091
2001/4/24,1345,5621,-1,35,17,18,0.999,0.848
2001/4/25,945,5580,-29,44,39,5,1.006,0.762
2001/4/25,1045,5580,-1,21,6,15,1.007,0.876
2001/4/25,1145,5555,-25,30,25,5,1.011,1.161
2001/4/25,1245,5536,-18,21,19,2,1.013,1.162
2001/4/25,1345,5525,-12,35,14,21,1.014,0.732
2001/4/26,945,5498,-43,58,47,11,1.018,0.867
2001/4/26,1045,5492,-3,34,8,26,1.016,1.047
2001/4/26,1145,5480,-12,21,13,8,1.015,1.887
2001/4/26,1245,5539,62,79,5,74,1.001,0.752
2001/4/26,1345,5560,21,39,17,22,0.996,0.679
2001/4/27,945,5490,-29,48,37,11,1.007,0.899
2001/4/27,1045,5489,-1,19,8,11,1.006,1.826
2001/4/27,1145,5507,18,37,0,37,1.001,1.366
2001/4/27,1245,5474,-33,48,47,1,1.006,1.365
2001/4/27,1345,5439,-35,72,55,17,1.011,0.701
2001/4/30,945,5430,5,47,34,13,1.011,0.867
2001/4/30,1045,5493,63,66,-2,68,0.998,0.935
2001/4/30,1145,5474,-18,31,18,13,1.001,1.604
2001/4/30,1245,5450,-27,47,42,5,1.006,1.464
2001/4/30,1345,5430,-20,51,31,20,1.008,0.833
2001/5/2,945,5470,-6,60,55,5,1,0.747
2001/5/2,1045,5441,-28,35,34,1,1.005,0.871
2001/5/2,1145,5360,-81,79,79,0,1.019,0.722
2001/5/2,1245,5351,-10,40,17,23,1.018,0.955
2001/5/2,1345,5349,-2,56,20,36,1.016,0.892
2001/5/3,945,5353,-7,68,35,33,1.014,0.774
2001/5/3,1045,5376,21,41,8,33,1.008,1.314
2001/5/3,1145,5399,24,30,1,29,1.002,1.141
2001/5/3,1245,5389,-10,37,10,27,1.002,1.645
2001/5/3,1345,5431,42,43,-2,45,0.993,0.793
2001/5/4,945,5404,-15,42,20,22,0.997,0.957
2001/5/4,1045,5360,-44,48,43,5,1.004,1.085
2001/5/4,1145,5335,-23,40,35,5,1.007,1.162
2001/5/4,1245,5273,-62,63,60,3,1.019,0.823
2001/5/4,1345,5227,-47,84,57,27,1.026,0.752
2001/5/7,945,5310,67,69,-11,80,1.008,0.783
2001/5/7,1045,5256,-49,74,52,22,1.017,0.853
2001/5/7,1145,5244,-11,69,15,54,1.017,0.898
2001/5/7,1245,5260,16,66,40,26,1.011,0.897
2001/5/7,1345,5268,13,61,27,34,1.007,1.036
2001/5/8,945,5220,-35,53,46,7,1.013,0.961
2001/5/8,1045,5215,-5,28,19,9,1.011,1.063
2001/5/8,1145,5182,-33,53,32,21,1.015,1.054
2001/5/8,1245,5175,-8,38,25,13,1.013,1.575
2001/5/8,1345,5229,54,102,4,98,1.001,0.77
2001/5/9,945,5262,33,67,16,51,0.994,0.816
2001/5/9,1045,5244,-19,34,27,7,0.997,1.26
2001/5/9,1145,5244,0,26,4,22,0.997,1.724
2001/5/9,1245,5233,-10,40,37,3,0.999,1.156
2001/5/9,1345,5223,-9,41,42,-1,1,0.941
2001/5/10,945,5175,-26,47,43,4,1.008,0.924
2001/5/10,1045,5161,-14,29,22,7,1.01,1.45
2001/5/10,1145,5181,20,31,7,24,1.005,2.192
2001/5/10,1245,5170,-10,20,16,4,1.007,2.406
2001/5/10,1345,5162,-12,26,17,9,1.009,1.181
2001/5/11,945,5144,2,44,35,9,1.011,0.808
2001/5/11,1045,5087,-57,74,57,17,1.02,0.662
2001/5/11,1145,5145,56,70,7,63,1.005,0.898
2001/5/11,1245,5220,77,71,-6,77,0.989,0.619
2001/5/11,1345,5240,20,44,28,16,0.985,0.696
2001/5/14,945,5205,31,40,14,26,0.991,1.117
2001/5/14,1045,5182,-24,42,31,11,0.996,1.557
2001/5/14,1145,5190,8,43,28,15,0.995,1.737
2001/5/14,1245,5205,15,23,0,23,0.992,3.871
2001/5/14,1345,5205,0,36,30,6,0.993,1.71
2001/5/15,945,5195,14,31,22,9,0.995,2.101
2001/5/15,1045,5206,11,26,15,11,0.994,2.89
2001/5/15,1145,5210,5,18,8,10,0.996,2.934
2001/5/15,1245,5192,-18,25,24,1,1,1.588
2001/5/15,1345,5185,-6,20,7,13,1.001,0.869
2001/5/16,945,5129,-26,77,61,16,1.012,0.777
2001/5/16,1045,5137,9,28,13,15,1.009,1.474
2001/5/16,1145,5128,-12,20,12,8,1.01,1.14
2001/5/16,1245,5135,5135,24,11,13,0.907,1.376
2001/5/16,1345,5080,-56,58,58,0,0.916,0.402
2001/5/17,945,5163,13,50,2,48,0.9,0.28
2001/5/17,1045,5175,10,31,12,19,0.898,0.522
2001/5/17,1145,5167,-8,26,6,20,0.898,1.056
2001/5/17,1245,5160,-6,26,17,9,0.899,1.223
2001/5/17,1345,5150,-9,27,17,10,0.9,1.021
2001/5/18,945,5129,-39,40,36,4,0.904,0.64
2001/5/18,1045,5110,-18,24,19,5,0.907,1.062
2001/5/18,1145,5130,17,55,35,20,0.903,1.024
2001/5/18,1245,5110,-23,46,44,2,1.007,1.199
2001/5/18,1345,5089,-21,35,19,16,1.011,0.805
2001/5/21,945,5045,-44,87,57,30,1.018,0.724
2001/5/21,1045,5022,-23,33,27,6,1.021,1.167
2001/5/21,1145,5013,-7,35,27,8,1.019,1.234
2001/5/21,1245,4990,-23,34,29,5,1.021,1.192
2001/5/21,1345,4982,-8,53,11,42,1.019,0.89
2001/5/22,945,5047,30,59,21,38,1.003,0.632
2001/5/22,1045,5038,-8,26,16,10,1.003,1.52
2001/5/22,1145,5019,-19,33,29,4,1.006,1.671
2001/5/22,1245,4980,-39,40,40,0,1.011,0.857
2001/5/22,1345,4993,13,41,18,23,1.006,1.198
2001/5/23,945,5069,87,108,9,99,0.989,0.53
2001/5/23,1045,5135,66,82,15,67,0.977,0.525
2001/5/23,1145,5180,44,40,-1,41,0.97,0.978
2001/5/23,1245,5185,5,36,19,17,0.973,1.006
2001/5/23,1345,5225,35,41,1,40,0.969,0.96
2001/5/24,945,5197,-13,48,43,5,0.978,0.932
2001/5/24,1045,5215,18,39,5,34,0.977,1.5
2001/5/24,1145,5231,14,37,7,30,0.978,1.643
2001/5/24,1245,5219,-12,26,9,17,0.984,1.817
2001/5/24,1345,5223,4,44,7,37,0.988,1.575
2001/5/25,945,5180,-10,40,27,13,1,0.917
2001/5/25,1045,5188,9,18,4,14,1.001,1.805
2001/5/25,1145,5200,11,29,-3,32,1,2.165
2001/5/25,1245,5181,-19,25,24,1,1.004,2.214
2001/5/25,1345,5182,2,23,16,7,1.003,1.363
2001/5/28,945,5131,-23,47,38,9,1.012,0.669
2001/5/28,1045,5122,-9,20,22,-2,1.013,1.179
2001/5/28,1145,5110,-12,21,19,2,1.013,0.969
2001/5/28,1245,5100,-9,25,18,7,1.013,0.968
2001/5/28,1345,5110,10,23,6,17,1.008,1.09
2001/5/29,945,5165,90,129,35,94,0.995,0.403
2001/5/29,1045,5183,16,29,2,27,0.992,1.158
2001/5/29,1145,5144,-40,50,41,9,0.999,0.878
2001/5/29,1245,5108,-36,50,33,17,1.005,0.767
2001/5/29,1345,5112,0,31,15,16,1.003,1.235
2001/5/30,945,5062,-23,41,37,4,1.012,0.664
2001/5/30,1045,5074,12,28,16,12,1.008,1.487
2001/5/30,1145,5075,0,23,7,16,1.007,1.714
2001/5/30,1245,5078,7,20,7,13,1.005,2.544
2001/5/30,1345,5102,21,50,16,34,1,0.901
2001/5/31,945,5067,-5,43,21,22,1.007,0.77
2001/5/31,1045,5083,17,41,26,15,1.002,1.016
2001/5/31,1145,5073,-10,23,14,9,1.002,2.067
2001/5/31,1245,5082,9,31,14,17,0.999,1.926
2001/5/31,1345,5085,3,32,20,12,0.998,0.965
2001/6/1,945,5080,-30,51,53,-2,0.999,0.684
2001/6/1,1045,5052,-23,35,23,12,1.005,0.597
2001/6/1,1145,5034,-18,34,19,15,1.008,0.957
2001/6/1,1245,5044,9,24,5,19,1.005,1.668
2001/6/1,1345,5031,-14,30,20,10,1.007,1.275
2001/6/4,945,5000,-45,73,60,13,1.013,0.799
2001/6/4,1045,4990,-10,22,21,1,1.014,1.769
2001/6/4,1145,4998,6,23,6,17,1.01,2.162
2001/6/4,1245,5000,1,13,0,13,1.008,3.76
2001/6/4,1345,5030,30,19,-15,34,1.001,1.413
2001/6/5,945,5022,-7,53,36,17,1.001,0.733
2001/6/5,1045,5044,26,32,6,26,0.995,0.834
2001/6/5,1145,5048,3,21,11,10,0.994,1.022
2001/6/5,1245,5046,-2,24,6,18,0.995,1.461
2001/6/5,1345,5094,49,58,5,53,0.985,0.495
2001/6/6,945,5161,19,34,8,26,0.974,0.405
2001/6/6,1045,5180,18,21,0,21,0.974,0.846
2001/6/6,1145,5193,17,32,2,30,0.975,0.992
2001/6/6,1245,5200,9,25,10,15,0.978,0.953
2001/6/6,1345,5194,-6,29,31,-2,0.982,1.127
2001/6/7,945,5164,-6,29,16,13,0.991,0.839
2001/6/7,1045,5158,-4,19,6,13,0.995,1.518
2001/6/7,1145,5159,1,18,6,12,0.997,2.327
2001/6/7,1245,5150,-10,16,12,4,1.001,2.031
2001/6/7,1345,5155,4,26,22,4,1.002,1.36
2001/6/8,945,5240,34,50,13,37,0.987,0.497
2001/6/8,1045,5244,3,19,7,12,0.988,0.849
2001/6/8,1145,5252,8,17,7,10,0.987,1.2
2001/6/8,1245,5242,-10,21,11,10,0.99,1.498
2001/6/8,1345,5240,-2,40,0,40,0.992,0.66
2001/6/11,945,5215,4,30,3,27,0.997,0.907
2001/6/11,1045,5201,-13,15,14,1,1.001,2.184
2001/6/11,1145,5209,7,20,2,18,1,2.42
2001/6/11,1245,5225,5225,21,3,18,0.898,1.895
2001/6/11,1345,5289,64,71,1,70,0.889,0.643
2001/6/12,945,5257,-3,25,19,6,0.895,0.923
2001/6/12,1045,5241,-16,22,9,13,0.898,0.794
2001/6/12,1145,5258,17,34,1,33,0.895,1.229
2001/6/12,1245,5275,17,43,8,35,0.893,1.51
2001/6/12,1345,5245,-34,44,35,9,0.898,0.856
2001/6/13,945,5263,18,51,8,43,0.896,0.66
2001/6/13,1045,5270,6,34,19,15,0.896,0.787
2001/6/13,1145,5242,-28,41,30,11,0.902,1.053
2001/6/13,1245,5221,-21,34,26,8,1.006,1.007
2001/6/13,1345,5193,-30,42,35,7,1.011,0.729
2001/6/14,945,5155,-10,20,12,8,1.017,1.046
2001/6/14,1045,5120,-35,54,44,10,1.022,0.708
2001/6/14,1145,5146,22,34,4,30,1.014,1.025
2001/6/14,1245,5148,5,15,2,13,1.012,2.245
2001/6/14,1345,5140,-8,23,8,15,1.011,1.809
2001/6/15,945,5125,16,42,10,32,1.011,1.089
2001/6/15,1045,5125,0,15,5,10,1.008,2.91
2001/6/15,1145,5129,4,25,1,24,1.005,1.869
2001/6/15,1245,5143,13,23,2,21,1,1.999
2001/6/15,1345,5149,6,35,16,19,0.997,1.033
2001/6/18,945,5090,-51,52,47,5,1.008,0.801
2001/6/18,1045,5079,-11,20,16,4,1.009,1.188
2001/6/18,1145,5091,12,26,6,20,1.006,1.464
2001/6/18,1245,5086,5086,15,14,1,0.906,3.055
2001/6/18,1345,5088,3,22,19,3,0.904,1.612
2001/6/19,945,5080,11,35,30,5,0.905,1.069
2001/6/19,1045,5081,-3,17,18,-1,0.904,2.084
2001/6/19,1145,5083,1,8,3,5,0.903,2.649
2001/6/19,1245,5077,-6,10,8,2,0.903,1.059
2001/6/19,1345,5082,7,13,2,11,0.9,0.891
2001/6/20,945,5069,-10,26,14,12,0.902,0.646
2001/6/20,1045,5045,-25,21,28,-7,0.905,1.471
2001/6/20,1145,5054,7,17,5,12,0.903,0.932
2001/6/20,1245,5050,-6,6,6,0,1.004,1.802
2001/6/20,1345,5036,-14,23,29,-6,1.006,0.391
2001/6/21,945,5063,-17,21,18,3,1.001,0.405
2001/6/21,1045,5031,-31,34,29,5,1.007,0.566
2001/6/21,1145,4980,-50,47,52,-5,1.016,0.471
2001/6/21,1245,4993,15,28,10,18,1.011,0.851
2001/6/21,1345,4990,-3,32,28,4,1.01,0.809
2001/6/22,945,4996,6,46,30,16,1.007,0.71
2001/6/22,1045,4998,2,13,5,8,1.006,2.332
2001/6/22,1145,4970,-27,40,30,10,1.01,1.271
2001/6/22,1245,4946,-19,25,24,1,1.013,1.339
2001/6/22,1345,4965,19,34,0,34,1.007,0.874
2001/6/26,945,4953,-12,44,22,22,1.007,1.071
2001/6/26,1045,4910,-44,46,43,3,1.014,1.278
2001/6/26,1145,4875,-30,39,35,4,1.019,0.928
2001/6/26,1245,4860,-19,31,23,8,1.02,1.2
2001/6/26,1345,4834,-26,33,34,-1,1.023,0.948
2001/6/27,945,4881,51,56,9,47,1.009,0.573
2001/6/27,1045,4871,-10,25,25,0,1.009,1.022
2001/6/27,1145,4855,-16,32,29,3,1.01,1.325
2001/6/27,1245,4821,-37,43,35,8,1.015,0.79
2001/6/27,1345,4890,69,73,-12,85,0.998,0.761
2001/6/28,945,4826,-30,55,43,12,1.009,0.693
2001/6/28,1045,4822,-2,30,3,27,1.007,1.303
2001/6/28,1145,4807,-16,32,21,11,1.009,1.183
2001/6/28,1245,4797,-8,19,17,2,1.009,1.86
2001/6/28,1345,4839,47,40,-4,44,0.999,1.212
2001/6/29,945,4880,10,29,21,8,0.991,0.585
2001/6/29,1045,4880,0,26,13,13,0.991,1.193
2001/6/29,1145,4895,14,27,10,17,0.988,1.152
2001/6/29,1245,4896,-3,16,16,0,0.989,1.499
2001/6/29,1345,4891,-4,35,29,6,0.992,0.98
2001/7/2,945,4850,-42,45,46,-1,1.001,0.769
2001/7/2,1045,4849,-1,17,3,14,1.002,1.361
2001/7/2,1145,4839,-9,21,14,7,1.004,2.017
2001/7/2,1245,4853,14,32,4,28,1.002,1.117
2001/7/2,1345,4935,80,89,10,79,0.987,0.397
2001/7/3,945,4923,22,48,7,41,0.99,0.977
2001/7/3,1045,4896,-26,39,34,5,0.996,1.408
2001/7/3,1145,4920,25,37,5,32,0.991,1.418
2001/7/3,1245,4884,-39,52,50,2,0.999,1.192
2001/7/3,1345,4845,-37,48,43,5,1.007,0.589
2001/7/4,945,4770,-45,59,60,-1,1.021,0.695
2001/7/4,1045,4766,-2,28,18,10,1.02,1.322
2001/7/4,1145,4763,-3,15,16,-1,1.019,2.402
2001/7/4,1245,4764,1,21,7,14,1.017,2.085
2001/7/4,1345,4770,6,28,14,14,1.014,0.841
2001/7/5,945,4755,6,61,18,43,1.014,0.538
2001/7/5,1045,4752,-1,25,13,12,1.011,1.453
2001/7/5,1145,4739,-14,30,19,11,1.011,2.186
2001/7/5,1245,4733,-6,18,10,8,1.008,2.039
2001/7/5,1345,4743,12,34,21,13,1.003,0.876
2001/7/6,945,4775,63,72,11,61,0.994,0.501
2001/7/6,1045,4799,21,30,9,21,0.989,0.713
2001/7/6,1145,4787,-12,25,13,12,0.993,1.705
2001/7/6,1245,4765,-18,29,26,3,0.998,1.62
2001/7/6,1345,4766,2,34,11,23,0.997,0.94
2001/7/9,945,4728,2,34,15,19,1.005,0.95
2001/7/9,1045,4717,-10,27,17,10,1.007,1.233
2001/7/9,1145,4719,2,24,0,24,1.006,1.603
2001/7/9,1245,4732,15,33,3,30,1.002,1.478
2001/7/9,1345,4721,-10,30,24,6,1.005,0.942
2001/7/10,945,4720,-17,46,38,8,1.005,0.825
2001/7/10,1045,4725,8,23,15,8,1.003,1.665
2001/7/10,1145,4719,-4,14,11,3,1.003,2.02
2001/7/10,1245,4707,-13,42,15,27,1.004,0.629
2001/7/10,1345,4668,-38,51,49,2,1.011,0.798
2001/7/11,945,4647,17,30,9,21,1.014,0.742
2001/7/11,1045,4642,-5,19,3,16,1.013,1.798
2001/7/11,1145,4617,-25,31,29,2,1.017,1.352
2001/7/11,1245,4642,25,24,-2,26,1.009,1.376
2001/7/11,1345,4577,-66,65,68,-3,1.022,0.594
2001/7/12,945,4617,10,39,37,2,1.01,0.567
2001/7/12,1045,4640,20,21,1,20,1.003,1.497
2001/7/12,1145,4648,10,30,12,18,0.999,1.104
2001/7/12,1245,4662,16,24,7,17,0.995,1.088
2001/7/12,1345,4679,17,30,-1,31,0.99,0.791
2001/7/13,945,4687,-22,36,33,3,0.99,0.607
2001/7/13,1045,4660,-27,46,41,5,0.997,0.959
2001/7/13,1145,4607,-53,53,56,-3,1.009,1.021
2001/7/13,1245,4562,-44,58,56,2,1.018,0.773
2001/7/13,1345,4490,-72,83,66,17,1.033,0.653
2001/7/16,945,4453,-29,82,75,7,1.039,0.971
2001/7/16,1045,4413,-38,49,56,-7,1.044,2.298
2001/7/16,1145,4361,-57,82,72,10,1.052,1.411
2001/7/16,1245,4325,-37,52,49,3,1.054,1.989
2001/7/16,1345,4394,68,108,4,104,1.03,1.081
2001/7/17,945,4343,8,60,57,3,1.033,1.955
2001/7/17,1045,4364,21,65,5,60,1.02,2.653
2001/7/17,1145,4406,42,70,20,50,1.004,1.94
2001/7/17,1245,4396,-11,61,18,43,1.002,2.066
2001/7/17,1345,4353,-38,54,42,12,1.008,2.308
2001/7/18,945,4293,-50,90,92,-2,1.018,1.188
2001/7/18,1045,4245,-46,83,72,11,1.026,1.789
2001/7/18,1145,4230,-15,45,25,20,1.026,2.354
2001/7/18,1245,4197,4197,177,40,137,0.93,1.355
2001/7/18,1345,4176,-21,38,34,4,0.931,0.547
2001/7/19,945,4232,57,114,23,91,0.915,0.212
2001/7/19,1045,4122,-107,104,102,2,0.937,0.407
2001/7/19,1145,4105,-17,49,39,10,0.935,0.572
2001/7/19,1245,4146,40,103,14,89,0.918,0.467
2001/7/19,1345,4175,30,91,42,49,0.906,0.557
2001/7/20,945,4202,52,100,8,92,0.896,0.576
2001/7/20,1045,4191,-14,54,40,14,0.896,0.907
2001/7/20,1145,4200,9,39,4,35,0.893,1.792
2001/7/20,1245,4151,-49,63,45,18,1.005,1.321
2001/7/20,1345,4160,5,48,38,10,1.001,1.385
2001/7/23,945,4169,-33,80,61,19,1,0.849
2001/7/23,1045,4165,-6,35,25,10,0.999,1.919
2001/7/23,1145,4135,-30,40,40,0,1.008,1.862
2001/7/23,1245,4120,-15,23,20,3,1.012,1.803
2001/7/23,1345,4118,-2,40,37,3,1.012,1.243
2001/7/24,945,4066,-34,61,43,18,1.024,0.695
2001/7/24,1045,4062,-4,27,20,7,1.021,1.154
2001/7/24,1145,4035,-26,37,35,2,1.025,1.484
2001/7/24,1245,4053,18,45,15,30,1.016,0.982
2001/7/24,1345,4062,6,21,-3,24,1.012,1.268
2001/7/25,945,4090,52,92,28,64,1.001,0.507
2001/7/25,1045,4064,-26,24,24,0,1.005,1.336
2001/7/25,1145,4080,15,35,8,27,0.999,1.556
2001/7/25,1245,4080,0,28,20,8,0.997,1.3
2001/7/25,1345,4138,56,48,-8,56,0.982,0.711
2001/7/26,945,4087,-51,67,65,2,0.996,0.681
2001/7/26,1045,4149,56,64,11,53,0.981,0.694
2001/7/26,1145,4193,45,50,2,48,0.973,0.724
2001/7/26,1245,4222,28,40,8,32,0.97,0.828
2001/7/26,1345,4255,34,74,40,34,0.967,0.75
2001/7/27,945,4255,-16,57,40,17,0.972,0.753
2001/7/27,1045,4297,41,52,-2,54,0.966,1.163
2001/7/27,1145,4293,-7,48,26,22,0.973,1.207
2001/7/27,1245,4318,25,47,13,34,0.972,1.444
2001/7/27,1345,4242,-79,107,108,-1,0.995,0.771
2001/7/31,945,4269,8,40,1,39,0.992,1.495
2001/7/31,1045,4275,6,43,20,23,0.994,1.401
2001/7/31,1145,4272,-2,23,6,17,0.998,2.218
2001/7/31,1245,4249,-25,31,28,3,1.005,1.889
2001/7/31,1345,4291,43,57,18,39,0.996,1.027
2001/8/1,945,4277,-18,73,56,17,1,0.72
2001/8/1,1045,4286,10,25,13,12,0.998,1.421
2001/8/1,1145,4286,1,32,18,14,0.998,1.75
2001/8/1,1245,4258,-32,64,46,18,1.005,0.844
2001/8/1,1345,4267,10,43,17,26,1.001,0.941
2001/8/2,945,4368,67,78,-3,81,0.979,0.554
2001/8/2,1045,4384,16,43,11,32,0.977,0.574
2001/8/2,1145,4405,22,49,25,24,0.975,0.765
2001/8/2,1245,4391,-14,37,34,3,0.981,1.134
2001/8/2,1345,4455,64,60,0,60,0.97,0.883
2001/8/3,945,4435,-45,47,42,5,0.979,1.131
2001/8/3,1045,4464,28,29,3,26,0.976,2.443
2001/8/3,1145,4478,14,26,7,19,0.977,1.575
2001/8/3,1245,4507,30,60,31,29,0.975,0.944
2001/8/3,1345,4495,-11,40,5,35,0.983,0.88
2001/8/6,945,4457,-24,33,22,11,0.995,1.225
2001/8/6,1045,4449,-8,24,21,3,0.999,2.275
2001/8/6,1145,4436,-12,24,18,6,1.004,1.406
2001/8/6,1245,4422,-13,31,22,9,1.008,1.516
2001/8/6,1345,4420,0,28,15,13,1.009,1.119
2001/8/7,945,4350,-40,40,35,5,1.023,0.628
2001/8/7,1045,4337,-13,36,31,5,1.024,1.028
2001/8/7,1145,4328,-8,23,16,7,1.023,1.352
2001/8/7,1245,4350,22,21,-2,23,1.014,1.726
2001/8/7,1345,4395,47,69,22,47,1,0.464
2001/8/8,945,4425,53,60,5,55,0.991,0.65
2001/8/8,1045,4484,58,70,7,63,0.977,0.57
2001/8/8,1145,4457,-27,34,33,1,0.984,1.177
2001/8/8,1245,4453,-5,30,7,23,0.986,0.954
2001/8/8,1345,4516,61,80,0,80,0.973,0.64
2001/8/9,945,4481,15,48,29,19,0.982,0.923
2001/8/9,1045,4467,-14,41,36,5,0.988,1.536
2001/8/9,1145,4438,-28,41,36,5,0.997,0.958
2001/8/9,1245,4464,24,45,2,43,0.994,1.407
2001/8/9,1345,4405,-59,77,75,2,1.01,0.818
2001/8/10,945,4368,-42,68,68,0,1.019,0.849
2001/8/10,1045,4387,20,29,7,22,1.014,1.611
2001/8/10,1145,4350,-38,37,40,-3,1.02,1.333
2001/8/10,1245,4422,73,74,2,72,1.001,1.005
2001/8/10,1345,4469,47,60,21,39,0.99,0.705
2001/8/13,945,4525,56,69,-4,73,0.978,1.096
2001/8/13,1045,4505,-20,35,23,12,0.983,2.25
2001/8/13,1145,4517,10,24,8,16,0.981,3.343
2001/8/13,1245,4492,-21,29,29,0,0.988,3.175
2001/8/13,1345,4490,-1,37,12,25,0.989,1.665
2001/8/14,945,4496,-29,44,23,21,0.991,1.992
2001/8/14,1045,4517,21,37,8,29,0.989,2.208
2001/8/14,1145,4523,6,36,27,9,0.99,2.027
2001/8/14,1245,4540,15,32,5,27,0.99,2.452
2001/8/14,1345,4619,79,77,-4,81,0.976,0.737
2001/8/15,945,4623,-16,55,14,41,0.979,1.179
2001/8/15,1145,4649,36,48,-3,51,0.975,1.077
2001/8/15,1245,4650,0,23,6,17,0.978,1.317
2001/8/15,1345,4620,-34,60,46,14,0.988,0.653
2001/8/16,945,4650,70,65,-5,70,0.983,0.336
2001/8/16,1045,4645,-5,29,18,11,0.987,0.531
2001/8/16,1145,4636,-14,38,22,16,0.992,0.797
2001/8/16,1245,4620,-18,44,20,24,0.998,0.752
2001/8/16,1345,4649,29,37,7,30,0.994,0.678
2001/8/17,945,4617,-38,62,58,4,1.003,0.624
2001/8/17,1045,4610,-10,33,14,19,1.004,0.824
2001/8/17,1145,4615,5,23,3,20,1.003,1.288
2001/8/17,1245,4622,6,31,13,18,1.001,1.198
2001/8/17,1345,4630,8,31,-4,35,0.999,1.171
2001/8/20,945,4554,4,23,5,18,1.015,0.655
2001/8/20,1045,4563,11,26,7,19,1.011,1.448
2001/8/20,1145,4563,0,19,15,4,1.009,1.837
2001/8/20,1245,4546,-17,22,17,5,1.011,1.471
2001/8/20,1345,4542,-4,26,21,5,1.01,1.028
2001/8/21,945,4542,-9,34,28,6,1.008,0.911
2001/8/21,1045,4516,-26,38,32,6,1.012,0.858
2001/8/21,1145,4517,-1,21,19,2,1.01,1.292
2001/8/21,1245,4541,24,20,-3,23,1.002,2.221
2001/8/21,1345,4566,23,38,14,24,0.995,0.565
2001/8/22,945,4531,10,26,5,21,1.002,0.71
2001/8/22,1045,4560,29,32,3,29,0.995,0.855
2001/8/22,1145,4538,-22,33,22,11,1,1.32
2001/8/22,1245,4530,-8,24,10,14,1.001,1.149
2001/8/22,1345,4460,-70,69,74,-5,1.016,0.558
2001/8/23,945,4468,8,44,26,18,1.012,0.812
2001/8/23,1045,4469,2,28,4,24,1.011,1.052
2001/8/23,1145,4488,19,20,-2,22,1.005,1.299
2001/8/23,1245,4470,-18,37,21,16,1.009,1.266
2001/8/23,1345,4468,-2,33,1,32,1.007,0.987
2001/8/24,945,4422,-32,54,46,8,1.016,0.834
2001/8/24,1045,4372,-50,53,54,-1,1.026,1.022
2001/8/24,1145,4369,-5,28,14,14,1.022,1.054
2001/8/24,1245,4329,-40,63,46,17,1.028,1.028
2001/8/24,1345,4303,-23,51,42,9,1.029,0.953
2001/8/27,945,4357,27,50,13,37,1.013,0.706
2001/8/27,1045,4344,-13,33,21,12,1.014,1.253
2001/8/27,1145,4312,-30,42,35,7,1.018,1.247
2001/8/27,1245,4353,43,44,-1,45,1.005,1.312
2001/8/27,1345,4341,-12,35,33,2,1.005,0.891
2001/8/28,945,4320,-20,50,39,11,1.007,0.956
2001/8/28,1045,4291,-29,41,44,-3,1.011,1.186
2001/8/28,1145,4322,31,43,1,42,1.002,1.194
2001/8/28,1245,4323,1,34,17,17,1.001,1.117
2001/8/28,1345,4311,-7,23,17,6,1.004,1.187
2001/8/29,945,4297,15,44,18,26,1.006,0.822
2001/8/29,1045,4367,68,71,0,71,0.988,0.648
2001/8/29,1145,4409,41,57,19,38,0.979,0.58
2001/8/29,1245,4450,40,59,10,49,0.973,0.921
2001/8/29,1345,4485,35,51,1,50,0.967,0.811
2001/8/30,945,4533,50,69,-13,82,0.96,0.794
2001/8/30,1045,4477,-50,66,56,10,0.977,1.131
2001/8/30,1145,4488,16,45,27,18,0.978,1.876
2001/8/30,1245,4440,-48,67,57,10,0.993,0.994
2001/8/30,1345,4457,20,44,8,36,0.992,1.252
2001/8/31,945,4401,-9,44,18,26,1.007,0.895
2001/8/31,1045,4389,-12,33,16,17,1.012,1.662
2001/8/31,1145,4397,8,23,3,20,1.011,2.474
2001/8/31,1245,4383,-13,44,42,2,1.014,0.934
2001/8/31,1345,4442,59,67,13,54,0.999,0.766
2001/9/3,945,4445,-7,54,48,6,0.997,0.997
2001/9/3,1045,4450,6,22,6,16,0.994,1.606
2001/9/3,1145,4426,-27,46,40,6,0.999,1.118
2001/9/3,1245,4416,-10,23,17,6,1,1.472
2001/9/3,1345,4378,-37,50,50,0,1.008,0.761
2001/9/4,945,4360,-18,44,35,9,1.012,0.835
2001/9/4,1045,4410,50,49,-1,50,0.999,1.065
2001/9/4,1145,4414,3,27,11,16,0.999,0.943
2001/9/4,1245,4406,-8,43,40,3,1.001,0.842
2001/9/4,1345,4479,75,79,0,79,0.985,0.643
2001/9/5,945,4458,25,36,5,31,0.99,0.96
2001/9/5,1045,4406,-53,53,52,1,1.002,1.047
2001/9/5,1145,4389,-16,27,20,7,1.004,1.083
2001/9/5,1245,4400,11,34,18,16,1.001,1.37
2001/9/5,1345,4376,-25,60,49,11,1.006,0.802
2001/9/6,945,4360,-16,42,24,18,1.01,0.833
2001/9/6,1045,4343,-19,28,28,0,1.014,1.837
2001/9/6,1145,4323,-20,32,27,5,1.017,1.181
2001/9/6,1245,4302,-21,29,28,1,1.02,1.285
2001/9/6,1345,4330,29,40,5,35,1.011,0.85
2001/9/7,945,4277,-9,30,8,22,1.02,0.941
2001/9/7,1045,4243,-34,41,38,3,1.024,1.12
2001/9/7,1145,4260,18,25,2,23,1.016,2.039
2001/9/7,1245,4265,5,28,13,15,1.012,1.469
2001/9/7,1345,4284,19,33,10,23,1.004,0.971
2001/9/10,945,4232,-22,29,28,1,1.014,0.857
2001/9/10,1045,4238,6,24,7,17,1.009,1.41
2001/9/10,1145,4248,9,29,19,10,1.004,1.237
2001/9/10,1245,4285,32,45,8,37,0.994,1.143
2001/9/10,1345,4280,-5,33,20,13,0.995,0.829
2001/9/11,945,4251,-39,53,44,9,1.002,0.763
2001/9/11,1045,4236,-14,24,13,11,1.004,0.779
2001/9/11,1145,4230,-6,27,18,9,1.006,1.119
2001/9/11,1245,4190,-40,44,40,4,1.015,0.751
2001/9/11,1345,4152,-38,43,42,1,1.022,0.722
2001/9/13,1045,3862,0,28,28,0,1.089,0.484
2001/9/13,1145,3865,3865,19,16,3,0.978,1.111
2001/9/13,1345,3862,-2,2,2,0,0.969,5.235
2001/9/14,945,3876,-12,48,34,14,0.957,0.814
2001/9/14,1045,3789,-90,122,108,14,0.968,0.734
2001/9/14,1145,3743,-47,82,69,13,0.966,1.127
2001/9/14,1245,3736,-9,44,45,-1,0.955,1.982
2001/9/14,1345,3705,-25,59,24,35,0.949,0.987
2001/9/19,945,3600,-11,64,55,9,0.959,1.068
2001/9/19,1045,3583,-16,20,18,2,0.948,2.39
2001/9/19,1145,3615,32,36,4,32,0.931,2.462
2001/9/19,1245,3629,10,37,18,19,1.028,2.593
2001/9/19,1345,3737,107,95,-10,105,0.992,1.348
2001/9/20,945,3642,-7,52,18,34,1.011,0.655
2001/9/20,1045,3590,-51,62,53,9,1.019,0.629
2001/9/20,1145,3608,13,37,16,21,1.008,1.074
2001/9/20,1245,3570,-35,58,49,9,1.015,0.858
2001/9/20,1345,3551,-19,34,34,0,1.016,0.787
2001/9/21,945,3447,-13,47,27,20,1.042,0.559
2001/9/21,1045,3432,-16,22,23,-1,1.043,2.076
2001/9/21,1345,3427,0,9,9,0,1.04,2.515
2001/9/24,945,3495,93,116,48,68,1.013,0.46
2001/9/24,1045,3439,-56,115,76,39,1.026,0.671
2001/9/24,1145,3450,12,79,-5,84,1.016,0.934
2001/9/24,1245,3534,79,139,16,123,0.987,0.656
2001/9/24,1345,3510,-25,50,30,20,0.992,0.938
2001/9/25,945,3612,-36,65,38,27,0.965,0.748
2001/9/25,1045,3601,-11,47,39,8,0.969,0.982
2001/9/25,1145,3554,-48,69,55,14,0.986,0.796
2001/9/25,1245,3485,-67,119,85,34,1.009,0.769
2001/9/25,1345,3430,-55,78,69,9,1.026,0.899
2001/9/26,945,3412,-38,100,96,4,1.033,0.753
2001/9/26,1045,3512,92,114,3,111,1.002,0.758
2001/9/26,1145,3648,135,183,21,162,0.966,0.546
2001/9/26,1245,3606,-44,78,39,39,0.983,1.079
2001/9/26,1345,3625,15,47,22,25,0.98,1.205
2001/9/27,945,3547,-47,55,48,7,1,1.05
2001/9/27,1045,3551,4,48,17,31,0.997,1.48
2001/9/27,1145,3562,11,51,32,19,0.993,1.224
2001/9/27,1245,3554,-9,58,46,12,0.995,1.269
2001/9/27,1345,3560,6,40,6,34,0.995,1.207
2001/9/28,945,3648,49,69,16,53,0.975,0.782
2001/9/28,1045,3630,-15,30,10,20,0.986,1.266
2001/9/28,1145,3598,-32,64,37,27,0.998,1.068
2001/9/28,1245,3627,28,60,8,52,0.989,1.145
2001/9/28,1345,3616,-9,45,44,1,0.993,0.853
2001/10/2,945,3528,-83,93,80,13,1.018,0.847
2001/10/2,1045,3480,-48,79,51,28,1.031,1.031
2001/10/2,1145,3467,-11,37,20,17,1.033,1.588
2001/10/2,1245,3464,-6,30,16,14,1.031,2.334
2001/10/2,1345,3427,-37,56,52,4,1.04,1.246
2001/10/3,945,3460,10,43,13,30,1.026,0.928
2001/10/3,1045,3465,6,40,30,10,1.019,1.024
2001/10/3,1145,3422,-43,67,46,21,1.027,0.992
2001/10/3,1245,3459,37,63,11,52,1.011,1.111
2001/10/3,1345,3430,-28,40,25,15,1.014,1.452
2001/10/4,945,3547,-73,66,61,5,0.981,0.628
2001/10/4,1045,3560,13,34,5,29,0.978,1.156
2001/10/4,1145,3528,-32,56,44,12,0.989,1.019
2001/10/4,1245,3528,-1,32,27,5,0.991,1.742
2001/10/4,1345,3473,-53,59,56,3,1.008,0.858
2001/10/5,945,3549,53,89,0,89,0.988,0.626
2001/10/5,1045,3521,-24,43,39,4,0.998,0.861
2001/10/5,1145,3530,9,33,17,16,0.997,1.69
2001/10/5,1245,3530,-2,42,27,15,1,1.159
2001/10/5,1345,3553,28,50,24,26,0.996,0.817
2001/10/8,945,3517,-23,69,58,11,1.004,0.648
2001/10/8,1045,3530,10,20,5,15,0.999,2.064
2001/10/8,1145,3531,1,18,7,11,0.998,3.481
2001/10/8,1245,3531,1,23,4,19,0.998,2.861
2001/10/8,1345,3512,-18,28,17,11,1.004,1.377
2001/10/9,945,3538,-11,30,27,3,0.998,0.892
2001/10/9,1045,3558,16,21,-1,22,0.992,1.68
2001/10/9,1145,3571,13,26,8,18,0.99,0.865
2001/10/9,1245,3599,29,29,0,29,0.983,0.817
2001/10/9,1345,3615,15,22,2,20,0.981,0.828
2001/10/11,945,3740,42,56,9,47,0.952,0.572
2001/10/11,1045,3840,100,104,8,96,0.933,0.63
2001/10/11,1145,3836,-4,27,7,20,0.942,1.619
2001/10/11,1245,3825,-13,35,30,5,0.953,1.352
2001/10/11,1345,3845,20,43,-7,50,0.956,1.073
2001/10/12,945,3851,-94,98,97,1,0.964,0.59
2001/10/12,1045,3815,-36,71,62,9,0.982,1.045
2001/10/12,1145,3840,21,51,-1,52,0.982,1.039
2001/10/12,1245,3841,5,37,17,20,0.989,1.221
2001/10/12,1345,3825,-14,40,5,35,0.999,0.915
2001/10/15,945,3759,-40,49,33,16,1.019,1.041
2001/10/15,1045,3745,-14,31,19,12,1.024,1.628
2001/10/15,1145,3750,5,19,5,14,1.02,4.046
2001/10/15,1245,3745,-5,22,12,10,1.019,2.919
2001/10/15,1345,3731,-14,20,14,6,1.02,1.804
2001/10/16,945,3734,14,42,22,20,1.014,1.324
2001/10/16,1045,3739,5,20,13,7,1.009,3.712
2001/10/16,1145,3733,-4,19,17,2,1.008,2.263
2001/10/16,1245,3760,27,27,0,27,0.998,3.169
2001/10/16,1345,3810,47,57,2,55,0.983,1.137
2001/10/17,945,3853,22,55,-3,58,0.973,1.012
2001/10/17,1045,3818,-32,25,27,-2,0.985,1.989
2001/10/17,1145,3811,-4,24,4,20,0.988,2.091
2001/10/17,1245,3850,40,43,0,43,0.98,1.472
2001/10/17,1345,3820,-26,55,38,17,0.99,0.841
2001/10/18,945,3732,12,26,9,17,1.013,0.266
2001/10/18,1045,3734,2,29,21,8,1.013,0.422
2001/10/18,1145,3745,12,15,0,15,1.01,1.169
2001/10/18,1245,3748,3,20,13,7,1.009,0.664
2001/10/18,1345,3770,22,31,-4,35,1.003,0.658
2001/10/19,945,3721,-39,38,39,-1,1.014,0.536
2001/10/19,1045,3765,42,43,3,40,0.999,0.752
2001/10/19,1145,3811,45,59,10,49,0.986,0.519
2001/10/19,1245,3795,-16,55,40,15,0.99,0.724
2001/10/19,1345,3820,22,45,17,28,0.982,0.844
2001/10/22,945,3863,33,49,21,28,0.974,0.711
2001/10/22,1045,3886,24,35,10,25,0.972,1.181
2001/10/22,1145,3882,-3,33,27,6,0.977,1.224
2001/10/22,1245,3882,2,28,18,10,0.98,1.638
2001/10/22,1345,3906,23,39,-6,45,0.977,1.082
2001/10/23,945,3915,-31,72,49,23,0.98,0.674
2001/10/23,1045,3894,-16,39,26,13,0.99,1.293
2001/10/23,1145,3892,-2,19,17,2,0.994,2.403
2001/10/23,1245,3853,-39,40,39,1,1.006,0.882
2001/10/23,1345,3850,-2,28,20,8,1.008,1.022
2001/10/24,945,3876,36,51,26,25,1.002,0.646
2001/10/24,1045,3911,35,55,19,36,0.993,0.594
2001/10/24,1145,3924,12,29,13,16,0.99,1.298
2001/10/24,1245,3927,3,33,31,2,0.991,0.991
2001/10/24,1345,3956,29,45,4,41,0.985,0.996
2001/10/25,945,3953,-22,56,18,38,0.986,0.595
2001/10/25,1045,3932,-20,32,20,12,0.992,1.245
2001/10/25,1145,3935,3,24,10,14,0.993,2.049
2001/10/25,1245,3940,7,24,15,9,0.992,1.907
2001/10/25,1345,3988,50,44,-18,62,0.983,1.014
2001/10/26,945,4014,13,38,15,23,0.98,0.845
2001/10/26,1045,4035,20,22,2,20,0.979,1.252
2001/10/26,1145,4052,16,20,2,18,0.978,1.085
2001/10/26,1245,4012,-40,48,40,8,0.991,0.976
2001/10/26,1345,3988,-26,41,30,11,0.999,0.842
2001/10/29,945,3980,-3,45,31,14,1.001,1.035
2001/10/29,1045,3991,11,31,13,18,0.999,1.662
2001/10/29,1145,3980,-14,32,29,3,1.003,1.811
2001/10/29,1245,4008,28,33,7,26,0.997,1.519
2001/10/29,1345,3990,-20,35,30,5,1.004,1.139
2001/10/30,945,3919,-1,16,17,-1,1.02,0.68
2001/10/30,1045,3898,-20,34,17,17,1.023,0.739
2001/10/30,1145,3890,-8,19,14,5,1.021,1.951
2001/10/30,1245,3870,-18,27,28,-1,1.022,1.79
2001/10/30,1345,3850,-20,44,46,-2,1.024,0.824
2001/10/31,945,3860,34,39,14,25,1.017,0.762
2001/10/31,1045,3871,8,29,14,15,1.011,1.052
2001/10/31,1145,3853,-17,28,17,11,1.013,1.254
2001/10/31,1245,3831,-21,29,30,-1,1.015,1.266
2001/10/31,1345,3866,35,48,-6,54,1.001,0.768
2001/11/1,945,3874,-4,24,14,10,0.998,0.847
2001/11/1,1045,3871,-4,23,21,2,0.998,1.173
2001/11/1,1145,3860,-13,28,22,6,1,1.437
2001/11/1,1245,3848,-12,28,20,8,1.003,1.475
2001/11/1,1345,3870,21,25,0,25,0.996,1.437
2001/11/2,945,3937,18,29,13,16,0.982,0.466
2001/11/2,1045,3948,10,20,9,11,0.981,1.07
2001/11/2,1145,3940,-9,22,13,9,0.985,1.383
2001/11/2,1245,3933,-8,23,22,1,0.989,1.435
2001/11/2,1345,3931,-1,26,11,15,0.992,0.826
2001/11/5,945,3941,-4,39,16,23,0.991,0.895
2001/11/5,1045,3970,33,36,1,35,0.985,0.775
2001/11/5,1145,3948,-20,23,22,1,0.993,1.565
2001/11/5,1245,3958,9,23,7,16,0.993,1.84
2001/11/5,1345,4030,72,88,13,75,0.978,0.595
2001/11/6,945,4048,-2,38,30,8,0.977,0.765
2001/11/6,1045,4044,-3,23,4,19,0.981,1.219
2001/11/6,1145,4058,15,28,2,26,0.98,1.474
2001/11/6,1245,4065,10,43,24,19,0.981,0.83
2001/11/6,1345,3990,-70,67,67,0,1.002,0.582
2001/11/7,945,4059,-6,35,14,21,0.988,0.844
2001/11/7,1045,4060,0,38,28,10,0.991,0.879
2001/11/7,1145,4062,6,18,1,17,0.993,1.515
2001/11/7,1245,4055,-6,38,13,25,0.997,1.214
2001/11/7,1345,4060,5,36,17,19,0.998,0.901
2001/11/8,945,4050,-15,41,32,9,1.001,0.748
2001/11/8,1045,4025,-25,39,25,14,1.007,0.971
2001/11/8,1145,4025,0,17,14,3,1.007,2.499
2001/11/8,1245,4045,21,31,4,27,1.001,1.502
2001/11/8,1345,4040,-1,23,16,7,1.002,1.169
2001/11/9,945,4008,-14,34,19,15,1.009,0.906
2001/11/9,1045,4015,6,16,5,11,1.006,1.865
2001/11/9,1145,4022,7,19,9,10,1.003,1.674
2001/11/9,1245,4029,9,31,17,14,1,1.134
2001/11/9,1345,4020,-10,20,15,5,1.002,1.117
2001/11/12,945,4030,-1,30,10,20,0.999,1.026
2001/11/12,1045,4052,21,31,5,26,0.993,0.806
2001/11/12,1145,4055,3,16,2,14,0.993,1.66
2001/11/12,1245,4058,3,26,10,16,0.993,1.1
2001/11/12,1345,4105,48,49,-5,54,0.982,0.691
2001/11/13,945,4080,-20,48,40,8,0.99,0.638
2001/11/13,1045,4088,12,28,17,11,0.989,1.381
2001/11/13,1145,4100,8,17,4,13,0.988,2.358
2001/11/13,1245,4075,-26,34,34,0,0.996,1.292
2001/11/13,1345,4060,-15,39,35,4,1.001,0.942
2001/11/14,945,4126,-2,24,14,10,0.988,0.606
2001/11/14,1045,4143,17,22,9,13,0.986,0.79
2001/11/14,1145,4175,32,38,3,35,0.98,0.823
2001/11/14,1245,4190,15,37,5,32,0.98,1.145
2001/11/14,1345,4230,42,71,29,42,0.974,0.543
2001/11/15,945,4270,30,69,9,60,0.968,0.835
2001/11/15,1045,4247,-23,35,38,-3,0.978,1.058
2001/11/15,1145,4301,53,52,3,49,0.969,1.417
2001/11/15,1245,4310,8,40,5,35,0.972,1.187
2001/11/15,1345,4350,40,49,9,40,0.968,0.641
2001/11/16,945,4340,-35,45,40,5,0.976,0.895
2001/11/16,1045,4356,16,29,3,26,0.977,2.037
2001/11/16,1145,4384,26,36,7,29,0.976,1.357
2001/11/16,1245,4436,52,80,24,56,0.969,0.733
2001/11/16,1345,4433,-4,44,-3,47,0.975,0.797
2001/11/19,945,4418,-26,42,35,7,0.983,1.894
2001/11/19,1045,4468,48,50,1,49,0.976,1.586
2001/11/19,1145,4487,19,37,0,37,0.977,2.082
2001/11/19,1245,4490,2,28,8,20,0.98,1.55
2001/11/19,1345,4585,96,104,1,103,0.964,0.727
2001/11/20,945,4520,-75,74,76,-2,0.982,0.96
2001/11/20,1045,4550,35,46,7,39,0.98,2.235
2001/11/20,1145,4569,19,30,11,19,0.98,3.213
2001/11/20,1245,4514,-55,73,59,14,0.996,1.803
2001/11/20,1345,4444,-65,99,90,9,1.013,1.074
2001/11/21,945,4442,-2,38,1,37,1.014,1.651
2001/11/21,1045,4440,-1,48,39,9,1.015,3.576
2001/11/21,1145,4448,8,30,12,18,1.012,3.365
2001/11/21,1245,4479,32,33,-3,36,1.004,2.342
2001/11/21,1345,4560,81,84,-5,89,0.986,0.536
2001/11/22,945,4485,10,34,12,22,1,0.346
2001/11/22,1045,4438,-49,56,51,5,1.01,0.486
2001/11/22,1145,4426,-11,25,21,4,1.01,0.514
2001/11/22,1245,4438,12,46,1,45,1.004,0.58
2001/11/22,1345,4429,-8,42,8,34,1.005,0.71
2001/11/23,945,4438,3,44,21,23,1.002,0.843
2001/11/23,1045,4482,44,57,7,50,0.992,0.59
2001/11/23,1145,4487,7,44,23,21,0.992,0.806
2001/11/23,1245,4493,5,22,4,18,0.992,1.387
2001/11/23,1345,4499,7,31,9,22,0.991,1.258
2001/11/26,945,4581,51,55,4,51,0.974,0.775
2001/11/26,1045,4580,0,30,25,5,0.976,1.151
2001/11/26,1145,4605,25,31,1,30,0.974,1.659
2001/11/26,1245,4605,1,42,12,30,0.978,1.265
2001/11/26,1345,4612,8,34,17,17,0.98,0.841
2001/11/27,945,4634,-36,72,54,18,0.981,0.603
2001/11/27,1045,4515,-120,127,117,10,1.011,0.633
2001/11/27,1145,4510,-9,51,13,38,1.013,0.72
2001/11/27,1245,4530,19,50,30,20,1.009,1.064
2001/11/27,1345,4535,9,53,44,9,1.009,1.061
2001/11/28,945,4502,-34,61,63,-2,1.016,1.213
2001/11/28,1045,4505,0,36,15,21,1.014,1.138
2001/11/28,1145,4535,28,34,3,31,1.005,1.78
2001/11/28,1245,4466,-69,88,78,10,1.019,0.979
2001/11/28,1345,4390,-76,77,72,5,1.034,0.649
2001/11/29,945,4386,16,54,19,35,1.028,0.85
2001/11/29,1045,4387,1,32,9,23,1.022,1.792
2001/11/29,1145,4378,-8,39,32,7,1.021,1.408
2001/11/29,1245,4383,7,23,11,12,1.017,2.178
2001/11/29,1345,4407,22,58,30,28,1.008,0.762
2001/11/30,945,4421,-10,32,25,7,1.003,1.137
2001/11/30,1045,4412,-10,40,8,32,1.003,1.022
2001/11/30,1145,4430,17,30,12,18,0.997,1.333
2001/11/30,1245,4430,-1,39,28,11,0.994,1.097
2001/11/30,1345,4390,-36,79,54,25,1.002,0.737
2001/12/3,945,4544,85,112,13,99,0.97,0.59
2001/12/3,1045,4558,14,40,7,33,0.971,1.113
2001/12/3,1145,4560,3,37,18,19,0.974,1.24
2001/12/3,1245,4551,-7,30,19,11,0.98,2.075
2001/12/3,1345,4589,42,50,11,39,0.975,0.963
2001/12/4,945,4555,-23,44,20,24,0.986,0.832
2001/12/4,1045,4605,50,73,18,55,0.978,0.741
2001/12/4,1145,4612,3,46,26,20,0.981,1.1
2001/12/4,1245,4638,24,54,11,43,0.979,1.255
2001/12/4,1345,4741,101,107,4,103,0.963,0.61
2001/12/5,945,4806,-13,49,34,15,0.957,0.592
2001/12/5,1045,4849,44,60,11,49,0.954,1.141
2001/12/5,1145,4881,32,46,7,39,0.954,1.128
2001/12/5,1245,4875,-6,69,69,0,0.961,0.968
2001/12/5,1345,4910,40,118,0,118,0.961,0.662
2001/12/6,945,5061,22,62,19,43,0.942,0.848
2001/12/6,1045,5110,46,82,27,55,0.943,1.23
2001/12/6,1145,5107,-5,68,41,27,0.953,1.352
2001/12/6,1245,5150,41,65,18,47,0.955,1.333
2001/12/6,1345,5253,103,103,0,103,0.946,1.116
2001/12/7,945,5250,10,80,40,40,0.954,0.912
2001/12/7,1045,5260,10,59,50,9,0.961,1.098
2001/12/7,1145,5238,-22,110,52,58,0.973,1.054
2001/12/7,1245,5235,-5,88,5,83,0.98,0.879
2001/12/7,1345,5368,133,159,12,147,0.963,0.681
2001/12/10,945,5330,18,42,2,40,0.975,1.128
2001/12/10,1045,5345,14,54,29,25,0.977,1.222
2001/12/10,1145,5365,25,66,13,53,0.977,1.436
2001/12/10,1245,5408,43,67,12,55,0.974,0.929
2001/12/10,1345,5292,-116,173,137,36,1.001,0.653
2001/12/11,945,5250,10,46,8,38,1.009,1.015
2001/12/11,1045,5264,16,54,26,28,1.006,1.611
2001/12/11,1145,5241,-19,48,27,21,1.01,1.266
2001/12/11,1245,5232,-9,61,39,22,1.012,1.275
2001/12/11,1345,5298,63,71,-2,73,1,0.895
2001/12/12,945,5398,105,121,-4,125,0.981,0.881
2001/12/12,1045,5448,53,74,16,58,0.973,0.892
2001/12/12,1145,5485,45,74,30,44,0.968,1.273
2001/12/12,1245,5639,154,165,-1,166,0.944,1.061
2001/12/12,1345,5649,1,56,18,38,0.946,0.823
2001/12/13,945,5608,-42,213,155,58,0.961,0.665
2001/12/13,1045,5686,78,121,28,93,0.954,0.991
2001/12/13,1145,5562,-124,140,148,-8,0.983,1.13
2001/12/13,1245,5490,-71,140,120,20,1.001,0.644
2001/12/13,1345,5425,-75,150,115,35,1.018,0.799
2001/12/14,945,5400,60,94,16,78,1.024,1.069
2001/12/14,1045,5414,14,74,26,48,1.021,1.142
2001/12/14,1145,5472,55,84,26,58,1.01,1.048
2001/12/14,1245,5459,-11,103,14,89,1.012,1.01
2001/12/14,1345,5550,91,118,-21,139,0.992,1.033
2001/12/17,945,5460,-30,94,54,40,1.006,1.255
2001/12/17,1045,5450,-14,52,34,18,1.005,1.928
2001/12/17,1145,5509,56,80,16,64,0.99,1.679
2001/12/17,1245,5478,-31,85,62,23,0.994,1.45
2001/12/17,1345,5453,-22,89,89,0,0.999,1.151
2001/12/18,945,5465,-55,83,83,0,1,1.267
2001/12/18,1045,5415,-55,114,74,40,1.01,1.241
2001/12/18,1145,5372,-30,69,57,12,1.018,1.825
2001/12/18,1245,5381,9,81,20,61,1.014,1.877
2001/12/18,1345,5360,-25,82,68,14,1.017,1.754
2001/12/19,945,5388,28,90,36,54,1.009,2.155
2001/12/19,1045,5366,-22,49,39,10,1.012,3.915
2001/12/19,1145,5312,-58,71,60,11,1.021,2.428
2001/12/19,1245,5228,-82,100,97,3,1.033,1.529
2001/12/19,1345,5203,-27,64,77,-13,1.034,1.53
2001/12/20,945,5246,46,75,9,66,1.019,0.382
2001/12/20,1045,5223,-21,48,41,7,1.019,0.572
2001/12/20,1145,5238,16,55,17,38,1.013,0.566
2001/12/20,1245,5290,54,61,9,52,1,0.483
2001/12/20,1345,5285,-2,43,10,33,0.999,0.656
2001/12/21,945,5200,-31,52,37,15,1.013,0.671
2001/12/21,1045,5148,-52,66,63,3,1.02,0.828
2001/12/21,1145,5115,-34,63,43,20,1.022,0.981
2001/12/21,1245,5115,4,42,18,24,1.018,1.493
2001/12/21,1345,5045,-69,72,69,3,1.03,0.978
2001/12/24,945,5122,47,48,-1,49,1.012,1.111
2001/12/24,1045,5152,31,40,8,32,1.004,1.146
2001/12/24,1145,5130,-22,43,29,14,1.007,1.574
2001/12/24,1245,5127,-4,51,17,34,1.005,1.256
2001/12/24,1345,5111,-19,55,44,11,1.005,1.153
2001/12/25,945,5238,109,135,-13,148,0.979,0.706
2001/12/25,1045,5279,44,73,6,67,0.972,0.798
2001/12/25,1145,5350,70,85,10,75,0.962,0.815
2001/12/25,1245,5348,2,40,21,19,0.966,0.997
2001/12/25,1345,5400,52,88,30,58,0.961,0.845
2001/12/26,945,5410,-20,82,77,5,0.966,0.786
2001/12/26,1045,5390,-20,58,24,34,0.975,0.718
2001/12/26,1145,5338,-54,90,57,33,0.989,0.869
2001/12/26,1245,5409,71,105,27,78,0.98,0.934
2001/12/26,1345,5375,-36,107,95,12,0.991,0.833
2001/12/27,945,5439,29,60,31,29,0.985,0.905
2001/12/27,1045,5369,-66,105,90,15,1.002,0.863
2001/12/27,1145,5335,-28,65,60,5,1.009,1.261
2001/12/27,1245,5250,-84,106,94,12,1.026,0.862
2001/12/27,1345,5282,32,64,0,64,1.018,1.049
2001/12/28,945,5300,-2,83,34,49,1.012,1.257
2001/12/28,1045,5330,27,69,32,37,1.004,1.103
2001/12/28,1145,5269,-64,91,60,31,1.014,1.061
2001/12/28,1245,5335,70,102,2,100,1.001,1.204
2001/12/28,1345,5400,65,82,5,77,0.987,0.803
2001/12/31,945,5555,125,134,9,125,0.96,0.947
2001/12/31,1045,5585,28,43,11,32,0.957,1.422
2001/12/31,1145,5570,-5,39,35,4,0.963,1.764
2001/12/31,1245,5566,-2,50,14,36,0.968,1.577
2001/12/31,1345,5598,31,60,17,43,0.968,0.987
2002/1/2,945,5510,-49,110,75,35,0.988,0.84
2002/1/2,1045,5539,29,72,25,47,0.987,1.178
2002/1/2,1145,5533,-6,60,22,38,0.992,1.284
2002/1/2,1245,5600,69,75,-10,85,0.985,1.064
2002/1/2,1345,5585,-19,81,81,0,0.992,0.718
2002/1/3,945,5558,-92,134,117,17,1.001,0.704
2002/1/3,1045,5543,-17,69,26,43,1.004,0.878
2002/1/3,1145,5521,-23,60,29,31,1.007,1.198
2002/1/3,1245,5540,19,43,15,28,1.003,1.337
2002/1/3,1345,5463,-77,124,121,3,1.016,0.746
2002/1/4,945,5646,-36,70,14,56,0.986,0.691
2002/1/4,1045,5605,-43,75,33,42,0.995,1.177
2002/1/4,1145,5621,16,52,15,37,0.994,1.753
2002/1/4,1245,5640,14,53,18,35,0.992,1.336
2002/1/4,1345,5635,-4,59,25,34,0.994,1.128
2002/1/7,945,5678,43,82,2,80,0.986,1.12
2002/1/7,1045,5700,24,38,10,28,0.984,1.006
2002/1/7,1145,5725,25,50,10,40,0.982,1.533
2002/1/7,1245,5736,11,33,19,14,0.984,1.329
2002/1/7,1345,5817,81,119,32,87,0.974,0.854
2002/1/8,945,5797,-19,64,33,31,0.979,0.92
2002/1/8,1045,5819,26,47,16,31,0.978,1.001
2002/1/8,1145,5788,-31,63,55,8,0.987,0.866
2002/1/8,1245,5766,-22,50,34,16,0.994,0.862
2002/1/8,1345,5815,45,94,10,84,0.988,0.859
2002/1/9,945,5851,36,40,19,21,0.985,0.962
2002/1/9,1045,5847,-3,46,42,4,0.988,1.002
2002/1/9,1145,5860,10,31,6,25,0.989,1.79
2002/1/9,1245,5760,-99,128,103,25,1.008,0.618
2002/1/9,1345,5859,100,114,10,104,0.991,0.777
2002/1/10,945,5780,-45,49,49,0,1.005,1.154
2002/1/10,1045,5770,-13,34,9,25,1.007,1.041
2002/1/10,1145,5797,27,42,10,32,1.001,1.189
2002/1/10,1245,5847,48,78,17,61,0.993,0.932
2002/1/10,1345,5829,-16,70,36,34,0.997,0.867
2002/1/11,945,5776,-35,101,84,17,1.006,0.877
2002/1/11,1045,5800,23,60,25,35,1.001,1.334
2002/1/11,1145,5770,-30,74,69,5,1.005,1.091
2002/1/11,1245,5695,-75,98,77,21,1.017,0.614
2002/1/11,1345,5640,-55,64,55,9,1.026,0.872
2002/1/14,945,5586,6,45,24,21,1.031,1.52
2002/1/14,1045,5569,-19,50,31,19,1.031,2.018
2002/1/14,1145,5565,-5,39,26,13,1.028,2.299
2002/1/14,1245,5598,34,44,10,34,1.018,2.29
2002/1/14,1345,5590,-5,39,9,30,1.015,1.384
2002/1/15,945,5597,47,60,3,57,1.009,1.248
2002/1/15,1045,5545,-50,52,37,15,1.015,1.293
2002/1/15,1145,5514,-29,47,36,11,1.016,1.555
2002/1/15,1245,5536,21,53,9,44,1.007,1.462
2002/1/15,1345,5590,55,69,6,63,0.995,1.144
2002/1/16,945,5549,7,47,31,16,1.001,1.958
2002/1/16,1045,5555,6,49,44,5,1,1.92
2002/1/16,1145,5555,0,41,17,24,0.999,2.705
2002/1/16,1245,5560,4,30,20,10,0.998,2.291
2002/1/16,1345,5460,-96,98,101,-3,1.016,0.825
2002/1/17,945,5364,14,38,14,24,1.03,0.418
2002/1/17,1045,5388,27,50,17,33,1.021,0.685
2002/1/17,1145,5370,-18,33,27,6,1.022,0.867
2002/1/17,1245,5415,44,61,0,61,1.011,0.629
2002/1/17,1345,5450,35,56,7,49,1.002,0.455
2002/1/18,945,5501,49,64,13,51,0.991,0.493
2002/1/18,1045,5545,44,54,0,54,0.982,0.588
2002/1/18,1145,5505,-39,49,40,9,0.989,0.954
2002/1/18,1245,5480,-21,61,38,23,0.993,0.928
2002/1/18,1345,5443,-33,65,52,13,0.998,0.813
2002/1/21,945,5593,153,170,7,163,0.973,0.628
2002/1/21,1045,5695,101,108,-6,114,0.96,0.793
2002/1/21,1145,5800,105,109,10,99,0.948,0.918
2002/1/21,1245,5809,10,46,5,41,0.953,2.049
2002/1/21,1345,5824,18,15,0,15,0.958,1.882
2002/1/22,945,5820,-14,79,50,29,0.965,0.88
2002/1/22,1045,5800,-15,38,43,-5,0.974,1.537
2002/1/22,1145,5764,-36,80,41,39,0.984,0.833
2002/1/22,1245,5800,36,83,-3,86,0.983,1.078
2002/1/22,1345,5804,3,69,38,31,0.988,1.012
2002/1/23,945,5765,14,49,29,20,1,1.243
2002/1/23,1045,5805,40,56,-7,63,0.996,1.277
2002/1/23,1145,5949,145,311,147,164,0.973,0.601
2002/1/23,1245,5801,-139,189,199,-10,1.001,0.599
2002/1/23,1345,5775,-30,169,104,65,1.005,0.622
2002/1/24,945,5790,-29,67,58,9,1.002,1.024
2002/1/24,1045,5801,11,49,34,15,1,1.527
2002/1/24,1145,5743,-59,103,92,11,1.01,1.504
2002/1/24,1245,5701,-42,44,54,-10,1.017,0.985
2002/1/24,1345,5800,95,94,0,94,0.998,0.883
2002/1/25,945,5891,41,94,58,36,0.984,0.819
2002/1/25,1045,5875,-20,55,55,0,0.989,1.71
2002/1/25,1145,5897,25,73,51,22,0.987,1.244
2002/1/25,1245,5936,39,73,22,51,0.98,1.438
2002/1/25,1345,5954,19,59,21,38,0.979,0.869
2002/1/28,945,5965,-14,75,70,5,0.98,1.198
2002/1/28,1045,5995,30,38,13,25,0.978,1.753
2002/1/28,1145,5998,1,31,17,14,0.98,1.503
2002/1/28,1245,5997,2,25,2,23,0.985,1.81
2002/1/28,1345,6029,32,53,-14,67,0.984,1.166
2002/1/29,945,5921,-87,88,80,8,1.005,0.797
2002/1/29,1045,5894,-36,45,31,14,1.01,0.84
2002/1/29,1145,5890,-2,39,19,20,1.011,1.399
2002/1/29,1245,5871,-19,40,38,2,1.014,1.344
2002/1/29,1345,5820,-51,64,56,8,1.022,0.606
2002/1/30,945,5769,34,53,4,49,1.027,0.743
2002/1/30,1045,5779,12,33,4,29,1.022,1.471
2002/1/30,1145,5755,-20,40,35,5,1.022,1.379
2002/1/30,1245,5791,36,53,-6,59,1.012,1.231
2002/1/30,1345,5815,23,48,3,45,1.004,0.946
2002/1/31,945,5810,-18,58,40,18,1.002,0.862
2002/1/31,1045,5830,23,53,25,28,0.996,1.063
2002/1/31,1145,5776,-54,77,62,15,1.005,0.935
2002/1/31,1245,5807,31,39,0,39,0.997,1.486
2002/1/31,1345,5831,17,38,29,9,0.992,0.696
2002/2/1,945,5867,-28,70,38,32,0.989,0.855
2002/2/1,1045,5877,12,45,8,37,0.989,1.258
2002/2/1,1145,5886,6,45,24,21,0.989,1.014
2002/2/1,1245,5848,-40,35,42,-7,0.998,1.449
2002/2/1,1345,5858,3,50,12,38,0.997,0.769
2002/2/4,945,5840,29,63,5,58,1,0.972
2002/2/4,1045,5820,-18,38,18,20,1.004,1.845
2002/2/4,1145,5829,17,39,-2,41,1.002,1.481
2002/2/4,1245,5861,31,48,9,39,0.997,1.056
2002/2/4,1345,5838,-22,41,23,18,1.002,1.197
2002/2/5,945,5766,4,37,22,15,1.012,1.032
2002/2/5,1045,5785,19,20,0,20,1.007,1.93
2002/2/5,1145,5805,22,28,3,25,1.002,1.844
2002/2/5,1245,5782,-23,28,26,2,1.005,1.869
2002/2/5,1345,5884,102,106,0,106,0.986,0.6
2002/2/6,945,5961,62,80,-1,81,0.975,0.547
2002/2/6,1045,5959,-2,33,21,12,0.977,0.85
2002/2/6,1145,5966,7,29,19,10,0.978,1.322
2002/2/6,1245,5970,8,25,7,18,0.98,1.392
2002/2/6,1345,5969,-1,45,11,34,0.982,0.693
2002/2/18,945,6002,-20,48,39,9,0.981,0.908
2002/2/18,1045,6008,6,22,10,12,0.984,2.303
2002/2/18,1145,6015,12,20,8,12,0.986,3.74
2002/2/18,1245,6003,-12,27,29,-2,0.992,3.005
2002/2/18,1345,5956,-44,45,35,10,1.003,0.919
2002/2/19,945,5960,-6,58,20,38,1.004,1.391
2002/2/19,1045,5931,-29,43,37,6,1.009,0.953
2002/2/19,1145,5905,-26,49,33,16,1.013,1.234
2002/2/19,1245,5887,-13,37,13,24,1.015,1.811
2002/2/19,1345,5825,-62,74,72,2,1.024,1.354
2002/2/20,945,5792,-6,36,23,13,1.026,1.897
2002/2/20,1045,5771,-19,35,28,7,1.026,2.426
2002/2/20,1145,5740,-31,35,30,5,1.028,0.911
2002/2/20,1245,5739,5739,21,13,8,0.923,3.008
2002/2/20,1345,5685,-54,58,52,6,0.927,0.925
2002/2/21,945,5675,-50,59,46,13,0.925,0.38
2002/2/21,1045,5618,-57,77,81,-4,0.929,0.459
2002/2/21,1145,5636,21,49,9,40,0.92,0.543
2002/2/21,1245,5685,45,51,4,47,0.908,0.568
2002/2/21,1345,5656,-29,74,29,45,0.909,0.61
2002/2/22,945,5552,-33,56,46,10,0.922,0.568
2002/2/22,1045,5567,17,36,18,18,0.915,1.278
2002/2/22,1145,5580,14,28,8,20,0.91,1.465
2002/2/22,1245,5594,14,50,28,22,1.007,0.888
2002/2/22,1345,5620,30,44,23,21,1,0.929
2002/2/25,945,5578,-54,90,72,18,1.006,1.003
2002/2/25,1045,5580,4,43,28,15,1.003,1.251
2002/2/25,1145,5569,-11,37,19,18,1.005,1.419
2002/2/25,1245,5584,11,55,13,42,1.001,1.3
2002/2/25,1345,5522,-58,75,56,19,1.01,0.672
2002/2/26,945,5599,18,33,19,14,0.996,0.682
2002/2/26,1045,5593,-7,33,12,21,0.998,1.068
2002/2/26,1145,5573,-22,42,42,0,1.002,1.239
2002/2/26,1245,5552,-20,34,33,1,1.006,1.114
2002/2/26,1345,5529,-21,72,26,46,1.009,0.589
2002/2/27,945,5643,114,108,1,107,0.987,0.581
2002/2/27,1045,5656,13,42,9,33,0.986,0.767
2002/2/27,1145,5666,10,41,20,21,0.986,1.107
2002/2/27,1245,5665,-2,29,15,14,0.988,1.791
2002/2/27,1345,5700,34,40,5,35,0.983,0.961
2002/3/1,945,5628,-51,55,52,3,0.997,0.774
2002/3/1,1045,5638,8,35,31,4,0.996,1.266
2002/3/1,1145,5685,48,64,15,49,0.989,1.156
2002/3/1,1245,5683,3,28,17,11,0.991,1.787
2002/3/1,1345,5650,-33,47,32,15,0.999,1.013
2002/3/4,945,5837,64,65,8,57,0.971,0.541
2002/3/4,1045,5915,80,85,5,80,0.962,0.792
2002/3/4,1145,5930,14,43,4,39,0.964,0.935
2002/3/4,1245,5910,-20,39,30,9,0.971,1.278
2002/3/4,1345,5910,0,43,29,14,0.975,1.363
2002/3/5,945,5962,-37,67,66,1,0.972,0.854
2002/3/5,1045,5938,-24,59,46,13,0.982,0.919
2002/3/5,1145,5895,-42,57,60,-3,0.994,1.208
2002/3/5,1245,5925,35,53,10,43,0.992,1.254
2002/3/5,1345,5964,39,49,-4,53,0.99,1.123
2002/3/6,945,5984,26,67,6,61,0.99,0.967
2002/3/6,1045,5989,5,37,23,14,0.992,0.926
2002/3/6,1145,5995,3,50,14,36,0.992,1.124
2002/3/6,1245,6054,57,65,4,61,0.983,0.91
2002/3/6,1345,6120,67,66,6,60,0.975,0.636
2002/3/7,945,6094,-44,74,55,19,0.981,0.832
2002/3/7,1045,6110,15,47,17,30,0.981,1.658
2002/3/7,1145,6070,-34,82,64,18,0.99,0.887
2002/3/7,1245,6088,19,57,37,20,0.99,1.349
2002/3/7,1345,6080,-12,55,28,27,0.994,1.221
2002/3/8,945,6092,32,69,42,27,0.994,0.991
2002/3/8,1045,6108,15,49,37,12,0.993,1.13
2002/3/8,1145,6061,-43,48,57,-9,1.003,1.317
2002/3/8,1245,6011,-49,53,48,5,1.012,0.741
2002/3/8,1345,6041,30,64,-3,67,1.006,0.73
2002/3/11,945,6135,64,84,0,84,0.99,0.613
2002/3/11,1045,6133,-2,60,52,8,0.991,0.911
2002/3/11,1145,6183,50,46,2,44,0.983,1.194
2002/3/11,1245,6202,18,40,8,32,0.982,1.274
2002/3/11,1345,6190,-10,31,25,6,0.986,1.345
2002/3/12,945,6121,-59,49,58,-9,0.999,0.979
2002/3/12,1045,6119,-4,24,11,13,1,1.198
2002/3/12,1145,6090,-26,49,44,5,1.005,1.265
2002/3/12,1245,6088,-2,36,20,16,1.005,1.44
2002/3/12,1345,6120,33,45,0,45,1.001,1.188
2002/3/13,945,6187,105,106,1,105,0.991,0.617
2002/3/13,1045,6120,-65,71,76,-5,1.002,0.844
2002/3/13,1145,6061,-59,63,52,11,1.012,0.657
2002/3/13,1245,6051,-14,41,34,7,1.012,1.103
2002/3/13,1345,6080,28,42,12,30,1.004,1.148
2002/3/14,945,6030,-10,40,2,38,1.01,0.922
2002/3/14,1045,6025,-6,46,34,12,1.01,1.281
2002/3/14,1145,6025,1,48,8,40,1.008,1.131
2002/3/14,1245,6029,4,23,6,17,1.006,1.773
2002/3/14,1345,6105,75,78,-7,85,0.993,1.019
2002/3/15,945,6088,16,66,31,35,0.996,0.873
2002/3/15,1045,6031,-54,58,57,1,1.003,0.97
2002/3/15,1145,6008,-26,40,22,18,1.006,0.807
2002/3/15,1245,5969,-38,64,56,8,1.011,1.118
2002/3/15,1345,5904,-66,74,70,4,1.021,0.743
2002/3/18,945,5920,-10,56,26,30,1.017,1.046
2002/3/18,1045,5905,-14,43,21,22,1.017,1.466
2002/3/18,1145,5900,-5,29,24,5,1.016,2.692
2002/3/18,1245,5940,40,59,15,44,1.007,1.556
2002/3/18,1345,5948,8,30,2,28,1.004,1.788
2002/3/19,945,5911,-30,59,59,0,1.008,1.77
2002/3/19,1045,5878,-34,48,28,20,1.011,1.145
2002/3/19,1145,5885,7,31,9,22,1.007,3.894
2002/3/19,1245,5870,-18,25,20,5,1.008,2.832
2002/3/19,1345,5902,30,48,16,32,1.001,1.321
2002/3/20,945,5899,-6,48,40,8,1.001,1.589
2002/3/20,1045,5969,69,95,19,76,0.989,1.175
2002/3/20,1145,6000,30,45,10,35,0.985,1.568
2002/3/20,1245,6050,50,63,0,63,0.978,1.522
2002/3/20,1345,6074,24,58,15,43,0.976,1.323
2002/3/21,945,6030,28,53,3,50,0.984,0.298
2002/3/21,1045,6013,-17,49,35,14,0.989,0.397
2002/3/21,1145,6025,13,35,20,15,0.989,0.749
2002/3/21,1245,6051,31,61,35,26,0.987,0.571
2002/3/21,1345,6049,-1,33,11,22,0.99,0.742
2002/3/22,945,6120,-18,33,30,3,0.983,0.571
2002/3/22,1045,6144,22,52,26,26,0.982,0.753
2002/3/22,1145,6174,29,37,11,26,0.981,1.016
2002/3/22,1245,6152,-22,39,27,12,0.987,1.477
2002/3/22,1345,6155,1,28,10,18,0.988,1.191
2002/3/25,945,6165,14,38,17,21,0.989,1.255
2002/3/25,1045,6135,-25,74,44,30,0.996,0.921
2002/3/25,1145,6169,34,47,3,44,0.992,1.08
2002/3/25,1245,6202,32,44,7,37,0.989,0.792
2002/3/25,1345,6170,-34,45,36,9,0.997,1.091
2002/3/26,945,6143,2,41,25,16,1.002,0.953
2002/3/26,1045,6153,10,33,6,27,1,1.378
2002/3/26,1145,6170,16,51,28,23,0.998,1.024
2002/3/26,1245,6183,16,34,7,27,0.995,1.321
2002/3/26,1345,6208,25,45,12,33,0.992,0.8
2002/3/27,945,6215,-5,49,28,21,0.992,0.773
2002/3/27,1045,6174,-41,71,57,14,0.999,0.838
2002/3/27,1145,6130,-44,51,39,12,1.007,0.692
2002/3/27,1245,6120,-11,39,27,12,1.008,0.989
2002/3/27,1345,6085,-35,66,62,4,1.013,0.741
2002/3/28,945,6110,11,37,19,18,1.008,1.017
2002/3/28,1045,6125,15,63,1,62,1.005,0.907
2002/3/28,1145,6115,-10,30,21,9,1.006,1.198
2002/3/28,1245,6110,-4,43,13,30,1.006,1.504
2002/3/28,1345,6130,20,45,10,35,1.001,0.976
2002/3/29,945,6132,-38,52,45,7,1,0.933
2002/3/29,1045,6092,-40,34,27,7,1.005,1.174
2002/3/29,1145,6142,51,58,6,52,0.996,1.287
2002/3/29,1245,6138,-4,27,19,8,0.997,1.308
2002/3/29,1345,6145,10,43,-6,49,0.996,0.979
2002/4/1,945,6140,37,50,5,45,0.997,1.311
2002/4/1,1045,6116,-24,28,24,4,1.001,2.152
2002/4/1,1145,6150,33,48,10,38,0.996,1.368
2002/4/1,1245,6126,-24,30,35,-5,1,1.309
2002/4/1,1345,6105,-21,24,39,-15,1.004,1.479
2002/4/2,945,6230,75,78,2,76,0.983,0.426
2002/4/2,1045,6245,16,43,23,20,0.982,0.824
2002/4/2,1145,6245,-2,41,27,14,0.985,1.147
2002/4/2,1245,6237,-12,33,21,12,0.988,1.474
2002/4/2,1345,6223,-14,48,29,19,0.992,0.788
2002/4/3,945,6195,14,36,2,34,0.998,0.686
2002/4/3,1045,6175,-15,15,16,-1,1.002,2.124
2002/4/3,1145,6200,26,42,10,32,0.999,1.455
2002/4/3,1245,6218,16,34,12,22,0.996,1.053
2002/4/3,1345,6261,42,37,-2,39,0.991,0.857
2002/4/4,945,6177,-54,62,60,2,1.006,0.652
2002/4/4,1045,6126,-51,70,59,11,1.013,0.601
2002/4/4,1145,6140,10,23,7,16,1.009,1.314
2002/4/4,1245,6139,-3,37,23,14,1.008,1.717
2002/4/4,1345,6152,15,40,18,22,1.004,1.058
2002/4/8,945,6116,-16,48,44,4,1.009,1.065
2002/4/8,1045,6135,15,44,4,40,1.005,1.216
2002/4/8,1145,6130,-5,22,5,17,1.005,2.417
2002/4/8,1245,6150,18,26,6,20,1,1.541
2002/4/8,1345,6119,-34,47,38,9,1.004,0.976
2002/4/9,945,6098,-69,79,79,0,1.007,0.637
2002/4/9,1045,6073,-25,27,24,3,1.01,0.643
2002/4/9,1145,6078,6,28,11,17,1.008,1.075
2002/4/9,1245,6045,-29,42,41,1,1.012,1.058
2002/4/9,1345,6041,-4,30,22,8,1.011,0.829
2002/4/10,945,6000,1,36,16,20,1.016,0.813
2002/4/10,1045,6010,10,25,15,10,1.012,1.596
2002/4/10,1145,5985,-24,42,29,13,1.015,1.384
2002/4/10,1245,6005,22,30,12,18,1.009,1.746
2002/4/10,1345,6025,21,40,0,40,1.003,1.22
2002/4/11,945,6042,-5,35,8,27,0.998,0.875
2002/4/11,1045,6065,23,37,4,33,0.993,0.885
2002/4/11,1145,6050,-15,26,18,8,0.996,1.7
2002/4/11,1245,6031,-20,30,24,6,0.998,1.618
2002/4/11,1345,6032,1,23,7,16,0.998,1.186
2002/4/12,945,5997,7,35,13,22,1.004,0.851
2002/4/12,1045,6018,22,25,7,18,1,1.225
2002/4/12,1145,6056,41,48,9,39,0.994,0.699
2002/4/12,1245,6110,55,58,5,53,0.986,0.605
2002/4/12,1345,6158,48,56,14,42,0.98,0.616
2002/4/15,945,6187,23,50,10,40,0.978,0.942
2002/4/15,1045,6194,7,40,21,19,0.979,1.289
2002/4/15,1145,6195,0,37,25,12,0.981,1.891
2002/4/15,1245,6201,8,29,14,15,0.982,2.93
2002/4/15,1345,6179,-22,36,22,14,0.988,1.257
2002/4/16,945,6240,50,53,6,47,0.982,1.379
2002/4/16,1045,6210,-29,43,33,10,0.991,2.221
2002/4/16,1145,6194,-16,40,26,14,0.996,2.69
2002/4/16,1245,6214,20,29,4,25,0.995,3.219
2002/4/16,1345,6231,18,39,18,21,0.994,1.017
2002/4/17,945,6359,-26,42,23,19,0.978,0.814
2002/4/17,1045,6339,-16,42,31,11,0.983,1.533
2002/4/17,1145,6365,25,30,5,25,0.982,4.438
2002/4/17,1245,6390,25,38,8,30,0.981,1.502
2002/4/17,1345,6450,60,55,-38,93,0.974,0.654
2002/4/18,945,6353,-7,45,22,23,0.992,0.36
2002/4/18,1045,6350,-2,32,25,7,0.994,0.647
2002/4/18,1145,6358,8,28,1,27,0.995,1.078
2002/4/18,1245,6360,6,31,13,18,0.997,1.114
2002/4/18,1345,6360,0,28,5,23,1,0.879
2002/4/19,945,6350,9,31,15,16,1.001,0.816
2002/4/19,1045,6348,-2,29,12,17,1.001,0.853
2002/4/19,1145,6380,30,43,10,33,0.996,0.682
2002/4/19,1245,6365,-15,32,28,4,0.999,1.08
2002/4/19,1345,6398,34,52,9,43,0.993,0.836
2002/4/22,945,6406,-2,30,4,26,0.992,1.042
2002/4/22,1045,6375,-33,54,35,19,0.998,0.853
2002/4/22,1145,6383,8,30,7,23,0.997,1.671
2002/4/22,1245,6387,4,30,8,22,0.997,1.632
2002/4/22,1345,6410,23,29,-6,35,0.994,1.097
2002/4/23,945,6344,-35,54,45,9,1.005,0.631
2002/4/23,1045,6331,-13,32,16,16,1.007,0.734
2002/4/23,1145,6338,6,24,14,10,1.005,1.274
2002/4/23,1245,6347,9,25,1,24,1.003,1.472
2002/4/23,1345,6345,0,23,0,23,1.003,1.133
2002/4/24,945,6350,32,35,10,25,1.001,0.997
2002/4/24,1045,6404,52,58,10,48,0.992,0.442
2002/4/24,1145,6407,3,26,14,12,0.992,1.081
2002/4/24,1245,6393,-16,35,25,10,0.994,1.385
2002/4/24,1345,6420,26,32,3,29,0.99,0.846
2002/4/25,945,6364,-23,44,18,26,0.999,0.519
2002/4/25,1045,6370,10,27,9,18,0.999,1.556
2002/4/25,1145,6316,-53,66,52,14,1.008,0.623
2002/4/25,1245,6329,12,25,11,14,1.005,1.387
2002/4/25,1345,6318,-12,33,25,8,1.007,1.328
2002/4/26,945,6300,-9,43,28,15,1.01,1.088
2002/4/26,1045,6276,-25,39,29,10,1.013,1.253
2002/4/26,1145,6273,-3,23,12,11,1.011,1.851
2002/4/26,1245,6276,3,25,12,13,1.008,1.781
2002/4/26,1345,6308,31,39,1,38,1.001,1.075
2002/4/29,945,6234,-17,35,16,19,1.011,0.628
2002/4/29,1045,6227,-6,18,13,5,1.01,1.899
2002/4/29,1145,6195,-31,38,27,11,1.013,0.747
2002/4/29,1245,6182,-13,18,21,-3,1.013,1.967
2002/4/29,1345,6172,-9,44,44,0,1.012,0.709
2002/4/30,945,6150,-22,41,46,-5,1.014,0.871
2002/4/30,1045,6130,-20,52,30,22,1.015,0.76
2002/4/30,1145,6094,-36,36,37,-1,1.018,1.492
2002/4/30,1245,6091,-5,29,17,12,1.016,1.381
2002/4/30,1345,6100,10,34,-10,44,1.011,0.838
2002/5/2,945,6042,-75,119,92,27,1.019,0.617
2002/5/2,1045,6042,-1,44,27,17,1.016,1.056
2002/5/2,1145,6035,-8,38,30,8,1.014,1.427
2002/5/2,1245,5899,-135,153,135,18,1.035,0.604
2002/5/2,1345,5883,-14,60,37,23,1.033,0.761
2002/5/3,945,5820,-21,75,30,45,1.038,0.679
2002/5/3,1045,5853,33,65,14,51,1.027,1.125
2002/5/3,1145,5884,29,45,16,29,1.016,0.923
2002/5/3,1245,5835,-46,46,52,-6,1.021,1.578
2002/5/3,1345,5916,81,113,28,85,1.003,0.732
2002/5/6,945,5760,-67,90,65,25,1.025,0.733
2002/5/6,1045,5692,-68,76,75,1,1.032,1.297
2002/5/6,1145,5631,-63,81,75,6,1.037,1.3
2002/5/6,1245,5550,-76,103,88,15,1.045,0.965
2002/5/6,1345,5615,65,95,22,73,1.027,1.092
2002/5/7,945,5686,145,169,3,166,1.009,0.724
2002/5/7,1045,5622,-66,77,77,0,1.018,0.964
2002/5/7,1145,5668,47,89,26,63,1.006,1.258
2002/5/7,1245,5681,11,48,7,41,1,1.718
2002/5/7,1345,5662,-27,68,48,20,1,0.986
2002/5/8,945,5726,-23,54,19,35,0.988,0.742
2002/5/8,1045,5747,19,34,-1,35,0.984,1.503
2002/5/8,1145,5745,-1,29,15,14,0.985,1.44
2002/5/8,1245,5715,-31,44,34,10,0.992,1.172
2002/5/8,1345,5750,36,95,-5,100,0.989,0.748
2002/5/9,945,5809,-71,104,80,24,0.985,0.612
2002/5/9,1045,5810,1,52,20,32,0.987,0.9
2002/5/9,1145,5780,-30,58,38,20,0.995,1.374
2002/5/9,1245,5749,-31,74,66,8,1.002,1.262
2002/5/9,1345,5758,9,43,30,13,1.002,0.996
2002/5/10,945,5687,-53,77,43,34,1.014,0.685
2002/5/10,1045,5748,61,61,-1,62,1.003,1.089
2002/5/10,1145,5726,-23,49,43,6,1.007,1.314
2002/5/10,1245,5779,53,69,16,53,0.997,0.974
2002/5/10,1345,5855,79,88,3,85,0.985,0.674
2002/5/13,945,5754,-4,50,34,16,1,0.924
2002/5/13,1045,5775,20,33,9,24,0.996,2.404
2002/5/13,1145,5754,-20,40,26,14,0.999,2.005
2002/5/13,1245,5778,28,29,4,25,0.994,2.787
2002/5/13,1345,5796,17,35,11,24,0.991,1.345
2002/5/14,945,5798,-22,53,44,9,0.992,1.139
2002/5/14,1045,5783,-13,45,12,33,0.997,1.938
2002/5/14,1145,5784,1,42,36,6,0.997,2.574
2002/5/14,1245,5810,28,33,8,25,0.994,3.103
2002/5/14,1345,5774,-36,42,41,1,1.001,1.375
2002/5/15,945,5891,71,65,5,60,0.982,0.575
2002/5/15,1045,5899,8,18,9,9,0.983,1.392
2002/5/15,1145,5895,-1,21,17,4,0.986,2.204
2002/5/15,1245,5905,10,96,1,95,0.986,1.344
2002/5/15,1345,5891,-16,49,59,-10,0.991,0.926
2002/5/16,945,5859,-17,39,29,10,0.997,0.417
2002/5/16,1045,5845,-16,21,18,3,1.001,0.745
2002/5/16,1145,5822,-26,33,27,6,1.006,0.57
2002/5/16,1245,5820,0,30,25,5,1.007,0.769
2002/5/16,1345,5742,-78,83,103,-20,1.021,0.493
2002/5/17,945,5816,21,53,-1,54,1.007,0.514
2002/5/17,1045,5830,12,37,17,20,1.004,0.681
2002/5/17,1145,5806,-21,46,28,18,1.007,0.966
2002/5/17,1245,5800,-7,46,18,28,1.006,1.419
2002/5/17,1345,5805,5,48,15,33,1.003,0.963
2002/5/20,945,5650,-101,122,103,19,1.029,0.554
2002/5/20,1045,5621,-31,48,43,5,1.03,1.414
2002/5/20,1145,5586,-35,53,29,24,1.033,1.14
2002/5/20,1245,5581,-7,47,37,10,1.029,1.744
2002/5/20,1345,5518,-67,82,75,7,1.037,0.832
2002/5/21,945,5480,-21,62,50,12,1.039,0.854
2002/5/21,1045,5497,18,54,18,36,1.029,1.038
2002/5/21,1145,5402,-95,92,96,-4,1.041,0.867
2002/5/21,1245,5415,15,57,24,33,1.031,1.057
2002/5/21,1345,5410,-3,42,22,20,1.025,1.243
2002/5/22,945,5457,46,89,33,56,1.01,0.707
2002/5/22,1045,5436,-24,52,32,20,1.01,1.327
2002/5/22,1145,5445,8,76,6,70,1.005,0.923
2002/5/22,1245,5452,7,46,30,16,1.001,1.084
2002/5/22,1345,5503,50,74,21,53,0.99,0.823
2002/5/23,945,5526,1,70,24,46,0.986,0.857
2002/5/23,1045,5506,-21,36,20,16,0.991,1.247
2002/5/23,1145,5493,-13,40,42,-2,0.993,1.547
2002/5/23,1245,5512,19,48,18,30,0.991,1.344
2002/5/23,1345,5504,-11,38,41,-3,0.995,1.059
2002/5/24,945,5616,91,97,24,73,0.977,0.641
2002/5/24,1045,5637,22,45,13,32,0.976,1.007
2002/5/24,1145,5673,36,47,2,45,0.973,1.124
2002/5/24,1245,5695,25,42,10,32,0.973,1.257
2002/5/24,1345,5698,3,29,7,22,0.977,1.299
2002/5/27,945,5652,31,57,36,21,0.987,0.999
2002/5/27,1045,5688,36,44,9,35,0.983,1.498
2002/5/27,1145,5673,-15,24,17,7,0.989,2.29
2002/5/27,1245,5695,23,29,5,24,0.988,1.934
2002/5/27,1345,5716,23,25,3,22,0.987,1.22
2002/5/28,945,5722,-28,32,32,0,0.99,0.74
2002/5/28,1045,5676,-46,53,42,11,1,0.649
2002/5/28,1145,5642,-35,69,52,17,1.007,0.693
2002/5/28,1245,5610,-30,49,32,17,1.012,0.743
2002/5/28,1345,5650,39,49,1,48,1.004,0.961
2002/5/29,945,5542,-61,66,54,12,1.023,0.641
2002/5/29,1045,5536,-6,35,7,28,1.022,0.99
2002/5/29,1145,5526,-9,25,19,6,1.021,1.817
2002/5/29,1245,5546,20,51,24,27,1.015,1.257
2002/5/29,1345,5555,5,27,13,14,1.01,1.579
2002/5/30,945,5701,152,170,9,161,0.981,0.511
2002/5/30,1045,5690,-15,39,40,-1,0.983,0.909
2002/5/30,1145,5655,-33,60,50,10,0.989,0.881
2002/5/30,1245,5670,15,45,10,35,0.987,1.435
2002/5/30,1345,5675,13,62,24,38,0.987,0.856
2002/5/31,945,5625,-59,95,50,45,0.997,0.693
2002/5/31,1045,5631,4,49,27,22,0.997,1.335
2002/5/31,1145,5636,5,36,12,24,0.998,2.07
2002/5/31,1245,5626,-12,26,21,5,1.002,3.2
2002/5/31,1345,5632,3,65,37,28,1.002,1.119
2002/6/3,945,5510,-102,129,100,29,1.025,0.573
2002/6/3,1045,5493,-13,39,16,23,1.025,1.182
2002/6/3,1145,5481,-17,18,17,1,1.024,2.261
2002/6/3,1245,5496,15,29,10,19,1.018,1.771
2002/6/3,1345,5520,24,42,4,38,1.01,1.102
2002/6/4,945,5445,35,69,15,54,1.019,0.66
2002/6/4,1045,5441,-4,27,18,9,1.017,1.444
2002/6/4,1145,5455,14,42,15,27,1.011,1.803
2002/6/4,1245,5481,26,48,13,35,1.002,1.443
2002/6/4,1345,5500,18,55,39,16,0.996,0.832
2002/6/5,945,5579,46,70,39,31,0.981,0.451
2002/6/5,1045,5590,9,24,-4,28,0.98,1.352
2002/6/5,1145,5584,-10,26,12,14,0.983,2.01
2002/6/5,1245,5610,24,47,17,30,0.98,0.863
2002/6/5,1345,5615,4,30,6,24,0.981,1.306
2002/6/6,945,5597,-36,62,8,54,0.989,0.611
2002/6/6,1045,5606,7,48,26,22,0.99,0.829
2002/6/6,1145,5587,-19,28,26,2,0.996,1.609
2002/6/6,1245,5582,-4,29,11,18,0.999,1.606
2002/6/6,1345,5561,-23,39,39,0,1.005,1.063
2002/6/7,945,5450,-10,76,7,69,1.024,0.468
2002/6/7,1045,5450,0,45,28,17,1.022,1.212
2002/6/7,1145,5447,-2,20,11,9,1.02,3.078
2002/6/7,1245,5412,-34,35,36,-1,1.024,1.434
2002/6/7,1345,5358,-52,60,58,2,1.03,0.758
2002/6/10,945,5470,-1,51,-9,60,1.006,0.677
2002/6/10,1045,5470,0,27,23,4,1.004,1.144
2002/6/10,1145,5479,8,26,10,16,1,2.689
2002/6/10,1245,5464,-16,36,26,10,1,1.785
2002/6/10,1345,5470,7,24,10,14,0.997,1.619
2002/6/11,945,5455,-8,76,75,1,1,0.553
2002/6/11,1045,5400,-55,58,46,12,1.01,0.638
2002/6/11,1145,5370,-31,58,39,19,1.015,0.839
2002/6/11,1245,5407,40,46,-7,53,1.007,1.362
2002/6/11,1345,5390,-17,36,21,15,1.01,0.963
2002/6/12,945,5400,32,68,26,42,1.006,0.635
2002/6/12,1045,5388,-12,39,12,27,1.007,1.253
2002/6/12,1145,5380,-7,35,30,5,1.007,1.753
2002/6/12,1245,5383,3,29,26,3,1.004,1.899
2002/6/12,1345,5431,47,52,3,49,0.994,1.037
2002/6/13,945,5500,25,55,20,35,0.982,0.599
2002/6/13,1045,5514,17,30,12,18,0.98,1.052
2002/6/13,1145,5559,45,54,9,45,0.974,0.856
2002/6/13,1245,5551,-6,28,21,7,0.979,1.234
2002/6/13,1345,5580,28,45,15,30,0.976,0.884
2002/6/14,945,5538,-8,57,51,6,0.987,0.83
2002/6/14,1045,5561,23,37,13,24,0.985,1.799
2002/6/14,1145,5555,-7,23,10,13,0.99,2.69
2002/6/14,1245,5570,15,29,14,15,0.99,1.899
2002/6/14,1345,5600,28,27,-5,32,0.988,1.211
2002/6/17,945,5605,-10,50,27,23,0.99,0.892
2002/6/17,1045,5600,-5,20,10,10,0.993,2.044
2002/6/17,1145,5562,-36,63,46,17,1.001,1.093
2002/6/17,1245,5558,-2,26,8,18,1.002,1.55
2002/6/17,1345,5560,-2,34,15,19,1.002,1.236
2002/6/18,945,5592,-58,75,68,7,0.998,0.763
2002/6/18,1045,5598,6,32,16,16,0.998,1.737
2002/6/18,1145,5580,-18,39,29,10,1.001,2.106
2002/6/18,1245,5576,-4,31,8,23,1.003,1.759
2002/6/18,1345,5600,29,27,-22,49,0.998,1.234
2002/6/19,945,5471,-74,104,104,0,1.021,0.75
2002/6/19,1045,5455,-25,45,29,16,1.021,1.227
2002/6/19,1145,5439,-16,22,17,5,1.022,2.017
2002/6/19,1245,5405,-30,42,28,14,1.026,1.348
2002/6/19,1345,5370,-37,60,50,10,1.03,0.932
2002/6/20,945,5336,0,85,29,56,1.03,0.286
2002/6/20,1045,5315,-21,43,35,8,1.029,0.669
2002/6/20,1145,5338,23,30,9,21,1.02,1.081
2002/6/20,1245,5385,47,63,13,50,1.006,0.575
2002/6/20,1345,5410,25,57,30,27,0.998,0.589
2002/6/21,945,5365,24,51,7,44,1.003,0.537
2002/6/21,1045,5425,59,74,0,74,0.99,0.683
2002/6/21,1145,5473,48,75,17,58,0.98,0.555
2002/6/21,1245,5483,10,39,21,18,0.979,1.011
2002/6/21,1345,5440,-43,85,68,17,0.988,0.817
2002/6/24,945,5358,-44,98,91,7,1.005,0.72
2002/6/24,1045,5355,-3,34,9,25,1.006,0.999
2002/6/24,1145,5356,1,31,13,18,1.006,2.022
2002/6/24,1245,5413,57,67,12,55,0.996,1.239
2002/6/24,1345,5415,6,56,3,53,0.996,1.147
2002/6/25,945,5355,-85,108,110,-2,1.009,0.641
2002/6/25,1045,5376,25,57,20,37,1.005,0.968
2002/6/25,1145,5402,25,50,8,42,0.999,1.254
2002/6/25,1245,5362,-40,55,53,2,1.005,1.378
2002/6/25,1345,5341,-20,41,20,21,1.007,0.824
2002/6/26,945,5225,-31,52,35,17,1.027,0.751
2002/6/26,1045,5162,-63,66,62,4,1.037,0.984
2002/6/26,1145,5130,-31,66,41,25,1.039,0.995
2002/6/26,1245,5122,-7,31,18,13,1.036,1.747
2002/6/26,1345,5083,-38,43,42,1,1.039,1.173
2002/6/27,945,5153,-10,44,12,32,1.019,0.831
2002/6/27,1045,5082,-77,74,72,2,1.03,1.04
2002/6/27,1145,5110,30,80,30,50,1.018,0.925
2002/6/27,1245,5080,-30,62,53,9,1.018,1.447
2002/6/27,1345,5095,7,49,19,30,1.01,1.158
2002/6/28,945,5150,-5,51,37,14,0.997,0.789
2002/6/28,1045,5135,-17,35,29,6,0.999,1.485
2002/6/28,1145,5155,23,26,4,22,0.994,2.236
2002/6/28,1245,5159,3,23,15,8,0.994,1.539
2002/6/28,1345,5147,-13,42,35,7,0.997,1.139
2002/7/1,945,5002,-118,125,111,14,1.025,0.693
2002/7/1,1045,4975,-27,49,35,14,1.028,1.237
2002/7/1,1145,4962,-14,40,15,25,1.028,1.214
2002/7/1,1245,4948,-11,34,17,17,1.028,2.286
2002/7/1,1345,4926,-22,29,25,4,1.03,1.157
2002/7/2,945,4962,86,104,22,82,1.017,0.551
2002/7/2,1045,4940,-22,48,45,3,1.018,1.009
2002/7/2,1145,4928,-7,42,26,16,1.016,1.157
2002/7/2,1245,4946,17,37,24,13,1.008,1.392
2002/7/2,1345,4950,4,37,30,7,1.003,1.099
2002/7/3,945,4823,-67,116,82,34,1.024,0.428
2002/7/3,1045,4863,40,63,22,41,1.012,0.971
2002/7/3,1145,4987,122,130,13,117,0.985,0.588
2002/7/3,1245,5018,31,93,28,65,0.979,0.821
2002/7/3,1345,5058,38,51,1,50,0.973,1.103
2002/7/4,945,5060,22,74,20,54,0.976,0.703
2002/7/4,1045,5076,10,35,9,26,0.975,1.132
2002/7/4,1145,5071,-4,33,6,27,0.978,1.859
2002/7/4,1245,5078,7,36,19,17,0.98,1.724
2002/7/4,1345,5080,2,44,14,30,0.982,1.403
2002/7/5,945,5101,21,73,36,37,0.982,0.835
2002/7/5,1045,5101,0,44,9,35,0.987,1.144
2002/7/5,1145,5160,59,57,-10,67,0.98,0.893
2002/7/5,1245,5169,5,35,11,24,0.982,0.971
2002/7/5,1345,5170,3,45,29,16,0.985,0.959
2002/7/8,945,5264,14,51,22,29,0.971,0.752
2002/7/8,1045,5288,25,39,21,18,0.971,0.981
2002/7/8,1145,5333,44,54,3,51,0.966,1.113
2002/7/8,1245,5288,-44,43,42,1,0.98,1.538
2002/7/8,1345,5270,-17,31,23,8,0.987,1.201
2002/7/9,945,5250,-21,54,44,10,0.994,0.937
2002/7/9,1045,5274,25,29,10,19,0.993,1.961
2002/7/9,1145,5271,-1,24,4,20,0.996,2.057
2002/7/9,1245,5295,24,36,11,25,0.994,1.209
2002/7/9,1345,5307,12,42,8,34,0.994,1.15
2002/7/10,945,5214,-43,73,51,22,1.012,0.502
2002/7/10,1045,5207,-8,29,17,12,1.012,1.211
2002/7/10,1145,5216,8,25,7,18,1.009,2.091
2002/7/10,1245,5225,8,27,13,14,1.005,1.487
2002/7/10,1345,5200,-25,47,30,17,1.009,0.871
2002/7/11,945,5156,46,67,14,53,1.014,0.592
2002/7/11,1045,5191,36,57,19,38,1.006,0.725
2002/7/11,1145,5201,6,37,8,29,1.002,1.431
2002/7/11,1245,5144,-56,52,58,-6,1.012,1.18
2002/7/11,1345,5130,-15,43,33,10,1.012,0.896
2002/7/12,945,5309,89,91,-13,104,0.977,0.522
2002/7/12,1045,5342,34,55,6,49,0.973,0.753
2002/7/12,1145,5352,11,31,4,27,0.973,1.492
2002/7/12,1245,5363,12,24,-2,26,0.974,2.198
2002/7/12,1345,5415,53,54,-5,59,0.967,0.911
2002/7/15,945,5385,4,50,18,32,0.977,0.946
2002/7/15,1045,5383,-2,22,13,9,0.982,1.615
2002/7/15,1145,5409,26,50,6,44,0.981,2.286
2002/7/15,1245,5399,-10,34,10,24,0.986,2.437
2002/7/15,1345,5370,-26,37,22,15,0.996,1.371
2002/7/16,945,5340,-59,140,119,21,1.005,0.63
2002/7/16,1045,5326,-14,50,40,10,1.009,1.657
2002/7/16,1145,5298,-28,44,37,7,1.014,1.632
2002/7/16,1245,5305,0,30,20,10,1.011,3.204
2002/7/16,1345,5318,6,42,7,35,1.008,1.999
2002/7/17,945,5255,-6,43,33,10,1.018,1.665
2002/7/17,1045,5195,-62,84,60,24,1.027,0.979
2002/7/17,1145,5195,0,34,20,14,1.024,3.18
2002/7/17,1245,5191,-4,35,34,1,1.02,2.474
2002/7/17,1345,5240,50,71,8,63,1.007,1.07
2002/7/18,945,5234,21,109,23,86,1.004,0.241
2002/7/18,1045,5245,12,37,7,30,1,0.573
2002/7/18,1145,5246,1,32,22,10,0.998,0.64
2002/7/18,1245,5192,-54,65,53,12,1.008,0.506
2002/7/18,1345,5199,6,46,31,15,1.004,0.743
2002/7/19,945,5131,24,43,4,39,1.014,0.516
2002/7/19,1045,5113,-18,25,17,8,1.015,1.492
2002/7/19,1145,5104,-8,23,19,4,1.016,1.748
2002/7/19,1245,5109,5,22,6,16,1.013,1.647
2002/7/19,1345,5124,15,31,11,20,1.008,1.236
2002/7/22,945,5047,-3,44,24,20,1.021,0.814
2002/7/22,1045,5056,10,29,4,25,1.015,1.579
2002/7/22,1145,5046,-9,21,11,10,1.013,2.829
2002/7/22,1245,5020,-25,41,28,13,1.014,1.169
2002/7/22,1345,5025,5,24,14,10,1.01,1.309
2002/7/23,945,5012,6,88,46,42,1.011,0.463
2002/7/23,1045,5070,57,68,13,55,0.997,0.567
2002/7/23,1145,5063,-9,29,16,13,0.997,1.502
2002/7/23,1245,5090,30,38,10,28,0.991,0.925
2002/7/23,1345,5190,97,94,-5,99,0.972,0.653
2002/7/24,945,5063,-37,70,37,33,0.997,0.524
2002/7/24,1045,5035,-27,31,31,0,1.003,1.162
2002/7/24,1145,5005,-30,47,25,22,1.009,0.939
2002/7/24,1245,5008,2,47,9,38,1.007,1.428
2002/7/24,1345,5042,33,43,3,40,1,1.296
2002/7/25,945,5159,-37,56,31,25,0.981,0.695
2002/7/25,1045,5135,-25,39,34,5,0.989,1.256
2002/7/25,1145,5090,-44,55,51,4,0.999,1.127
2002/7/25,1245,5077,-13,48,37,11,1.002,1.241
2002/7/25,1345,5057,-23,59,33,26,1.005,1.036
2002/7/26,945,4865,-47,80,45,35,1.041,0.557
2002/7/26,1045,4800,-65,62,65,-3,1.051,1.297
2002/7/26,1145,4764,-34,70,42,28,1.054,1.09
2002/7/26,1245,4747,-18,30,23,7,1.053,1.766
2002/7/26,1345,4745,-2,33,20,13,1.048,1.369
2002/7/29,945,4840,40,78,0,78,1.019,0.989
2002/7/29,1045,4870,30,75,28,47,1.006,0.946
2002/7/29,1145,4900,27,95,30,65,0.995,0.975
2002/7/29,1245,4848,-54,59,57,2,1.002,1.556
2002/7/29,1345,4833,-17,38,17,21,1,1.235
2002/7/30,945,4988,23,63,25,38,0.97,0.563
2002/7/30,1045,4942,-46,55,58,-3,0.981,1.209
2002/7/30,1145,4945,2,45,3,42,0.984,0.833
2002/7/30,1245,4965,20,41,14,27,0.983,1.113
2002/7/30,1345,4946,-20,35,44,-9,0.992,1.098
2002/7/31,945,4938,-38,74,46,28,0.997,0.788
2002/7/31,1045,4894,-44,52,42,10,1.008,0.998
2002/7/31,1145,4897,5,29,22,7,1.008,1.633
2002/7/31,1245,4910,14,39,19,20,1.005,1.659
2002/7/31,1345,4895,-17,31,31,0,1.009,1.328
2002/8/1,945,4920,15,87,27,60,1.003,0.553
2002/8/1,1045,4905,-15,35,20,15,1.004,1.323
2002/8/1,1145,4912,8,30,8,22,1.002,2.151
2002/8/1,1245,4910,-2,35,16,19,1.002,1.592
2002/8/1,1345,4892,-18,26,25,1,1.005,1.209
2002/8/2,945,4798,0,43,20,23,1.02,0.633
2002/8/2,1045,4803,5,25,12,13,1.017,1.469
2002/8/2,1145,4825,23,25,1,24,1.01,2.482
2002/8/2,1245,4852,29,37,3,34,1.003,1.087
2002/8/2,1345,4920,63,84,8,76,0.988,0.623
2002/8/5,945,4724,-23,69,46,23,1.026,0.424
2002/8/5,1045,4650,-75,79,75,4,1.038,0.877
2002/8/5,1145,4640,-14,38,35,3,1.035,1.937
2002/8/5,1245,4576,-69,77,77,0,1.043,0.9
2002/8/5,1345,4576,4576,11,11,0,0.936,2.188
2002/8/6,945,4605,123,154,20,134,0.923,0.535
2002/8/6,1045,4554,-46,73,49,24,0.929,0.868
2002/8/6,1145,4590,35,64,20,44,0.916,1.192
2002/8/6,1245,4579,-10,43,16,27,0.914,1.579
2002/8/6,1345,4530,-49,55,50,5,0.917,1.088
2002/8/7,945,4664,14,55,26,29,0.889,0.595
2002/8/7,1045,4665,2,32,20,12,0.887,1.197
2002/8/7,1145,4690,28,18,-7,25,0.883,1.995
2002/8/7,1245,4687,-3,23,11,12,0.884,1.451
2002/8/7,1345,4669,-18,31,28,3,0.988,1.423
2002/8/8,945,4607,-61,69,58,11,1.005,0.625
2002/8/8,1045,4637,30,48,17,31,0.999,0.946
2002/8/8,1145,4673,34,52,7,45,0.993,0.943
2002/8/8,1245,4670,-3,49,40,9,0.996,0.923
2002/8/8,1345,4632,-38,43,36,7,1.006,0.828
2002/8/9,945,4735,-2,53,45,8,0.986,0.601
2002/8/9,1045,4753,16,39,6,33,0.984,1.24
2002/8/9,1145,4790,38,42,3,39,0.978,1.039
2002/8/9,1245,4780,-10,27,14,13,0.982,1.432
2002/8/9,1345,4769,-11,32,26,6,0.986,1.24
2002/8/12,945,4778,3,50,16,34,0.987,1.197
2002/8/12,1045,4790,12,40,23,17,0.988,1.378
2002/8/12,1145,4765,-26,35,27,8,0.996,1.79
2002/8/12,1245,4768,3,24,12,12,0.997,2.538
2002/8/12,1345,4773,5,21,13,8,0.998,1.874
2002/8/13,945,4757,-12,49,33,16,1.002,0.891
2002/8/13,1045,4760,0,24,16,8,1.002,1.726
2002/8/13,1145,4760,0,19,9,10,1.002,2.196
2002/8/13,1245,4767,7,17,5,12,1,2.533
2002/8/13,1345,4771,4,15,-2,17,0.999,1.271
2002/8/14,945,4760,30,52,2,50,1.001,0.463
2002/8/14,1045,4797,37,50,23,27,0.992,0.461
2002/8/14,1145,4785,-13,21,8,13,0.995,0.937
2002/8/14,1245,4803,18,31,11,20,0.992,1.021
2002/8/14,1345,4847,45,64,11,53,0.983,0.547
2002/8/15,945,4925,-9,30,24,6,0.971,0.542
2002/8/15,1045,4939,15,29,6,23,0.972,1.381
2002/8/15,1145,4952,9,34,17,17,0.973,1.044
2002/8/15,1245,4942,-10,26,16,10,0.979,1.785
2002/8/15,1345,4907,-35,58,39,19,0.989,0.922
2002/8/16,945,4881,-46,49,58,-9,0.999,0.98
2002/8/16,1045,4908,31,44,1,43,0.996,1.086
2002/8/16,1145,4895,-14,29,19,10,1,1.632
2002/8/16,1245,4901,7,28,8,20,1.001,1.88
2002/8/16,1345,4882,-19,38,26,12,1.007,1.22
2002/8/19,945,4880,-2,48,39,9,1.007,1.203
2002/8/19,1045,4862,-18,23,14,9,1.01,0.986
2002/8/19,1145,4866,3,21,13,8,1.007,2.86
2002/8/19,1245,4868,1,24,6,18,1.005,1.886
2002/8/19,1345,4854,-13,20,18,2,1.006,1.653
2002/8/20,945,4906,-19,38,32,6,0.996,0.691
2002/8/20,1045,4889,-20,31,27,4,1,1.385
2002/8/20,1145,4906,17,40,16,24,0.996,1.305
2002/8/20,1245,4925,19,23,1,22,0.992,1.827
2002/8/20,1345,4900,-25,37,28,9,0.998,1.206
2002/8/21,945,4857,-16,40,25,15,1.006,0.818
2002/8/21,1045,4864,10,14,4,10,1.004,1.832
2002/8/21,1145,4866,4,17,1,16,1.004,1.811
2002/8/21,1245,4872,8,20,3,17,1.003,1.461
2002/8/21,1345,4894,21,24,-4,28,0.998,0.739
2002/8/22,945,4919,26,53,21,32,0.993,0.268
2002/8/22,1045,4952,33,46,15,31,0.986,0.426
2002/8/22,1145,4954,2,21,8,13,0.987,0.95
2002/8/22,1245,4948,-6,29,27,2,0.989,1.134
2002/8/22,1345,4946,-2,19,4,15,0.99,0.796
2002/8/23,945,5010,30,34,10,24,0.98,0.579
2002/8/23,1045,5010,0,23,8,15,0.983,1.878
2002/8/23,1145,4989,-22,27,24,3,0.99,1.639
2002/8/23,1245,4985,-4,22,13,9,0.993,1.776
2002/8/23,1345,4935,-50,62,57,5,1.005,0.814
2002/8/26,945,4898,-22,39,26,13,1.014,0.742
2002/8/26,1045,4886,-11,15,6,9,1.016,1.116
2002/8/26,1145,4896,10,17,1,16,1.012,2.591
2002/8/26,1245,4899,4,15,8,7,1.01,1.566
2002/8/26,1345,4948,50,38,-14,52,0.999,0.978
2002/8/27,945,4920,-19,40,26,14,1.004,0.772
2002/8/27,1045,4894,-26,42,28,14,1.008,0.761
2002/8/27,1145,4887,-6,23,8,15,1.007,1.176
2002/8/27,1245,4878,-9,25,14,11,1.006,1.227
2002/8/27,1345,4851,-27,37,39,-2,1.01,0.808
2002/8/28,945,4821,20,17,-1,18,1.014,0.741
2002/8/28,1045,4812,-10,36,26,10,1.014,0.976
2002/8/28,1145,4782,-29,42,33,9,1.019,0.89
2002/8/28,1245,4789,7,13,4,9,1.015,1.739
2002/8/28,1345,4785,-5,33,9,24,1.014,0.841
2002/8/29,945,4769,11,37,21,16,1.013,0.737
2002/8/29,1045,4741,-28,44,35,9,1.016,1.06
2002/8/29,1145,4761,20,20,-3,23,1.009,1.507
2002/8/29,1245,4780,18,50,20,30,1.002,1.081
2002/8/29,1345,4785,5,38,34,4,0.999,0.777
2002/8/30,945,4743,-34,40,37,3,1.007,0.835
2002/8/30,1045,4778,31,42,1,41,0.998,1.1
2002/8/30,1145,4759,-19,21,18,3,1.001,1.804
2002/8/30,1245,4759,2,41,39,2,1.001,1.465
2002/8/30,1345,4746,-14,27,18,9,1.003,0.938
2002/9/2,945,4677,-53,69,58,11,1.017,0.598
2002/9/2,1045,4677,0,20,9,11,1.015,1.331
2002/9/2,1145,4656,-21,23,23,0,1.019,1.403
2002/9/2,1245,4647,-10,28,18,10,1.018,1.426
2002/9/2,1345,4617,-30,38,34,4,1.022,0.951
2002/9/3,945,4643,32,47,15,32,1.013,0.59
2002/9/3,1045,4596,-47,60,46,14,1.021,0.854
2002/9/3,1145,4626,30,50,10,40,1.01,1.078
2002/9/3,1245,4560,-66,76,68,8,1.022,0.874
2002/9/3,1345,4600,40,53,-6,59,1.009,0.798
2002/9/4,945,4551,27,59,11,48,1.015,0.573
2002/9/4,1045,4582,29,68,22,46,1.005,0.743
2002/9/4,1145,4558,-24,44,37,7,1.009,1.099
2002/9/4,1245,4565,7,38,15,23,1.005,1.323
2002/9/4,1345,4557,-6,50,13,37,1.005,0.926
2002/9/5,945,4545,-43,47,42,5,1.007,1.005
2002/9/5,1045,4526,-19,25,23,2,1.009,1.242
2002/9/5,1145,4493,-34,53,41,12,1.015,0.992
2002/9/5,1245,4474,-19,30,37,-7,1.016,1.757
2002/9/5,1345,4442,-33,48,48,0,1.022,0.956
2002/9/9,945,4483,3,75,7,68,1.011,0.792
2002/9/9,1045,4473,-12,31,29,2,1.012,1.024
2002/9/9,1145,4460,-13,29,24,5,1.013,1.377
2002/9/9,1245,4468,8,30,12,18,1.009,1.566
2002/9/9,1345,4501,33,50,13,37,0.999,0.919
2002/9/10,945,4528,2,52,10,42,0.992,0.758
2002/9/10,1045,4569,42,45,6,39,0.983,0.641
2002/9/10,1145,4632,63,67,2,65,0.97,0.585
2002/9/10,1245,4614,-20,40,19,21,0.977,1.467
2002/9/10,1345,4648,34,39,3,36,0.973,0.842
2002/9/11,945,4642,-18,42,33,9,0.978,0.846
2002/9/11,1045,4650,8,40,16,24,0.98,1.3
2002/9/11,1145,4645,-7,33,15,18,0.984,2.11
2002/9/11,1245,4647,2,24,18,6,0.988,1.793
2002/9/11,1345,4660,12,23,-1,24,0.989,1.759
2002/9/12,945,4656,20,42,3,39,0.992,0.911
2002/9/12,1045,4637,-21,30,31,-1,0.999,1.457
2002/9/12,1145,4641,6,22,4,18,1,1.309
2002/9/12,1245,4583,-58,71,63,8,1.013,0.628
2002/9/12,1345,4631,48,54,3,51,1.001,0.828
2002/9/13,945,4560,4,34,14,20,1.015,0.671
2002/9/13,1045,4550,-9,24,17,7,1.015,1.218
2002/9/13,1145,4566,16,31,10,21,1.009,1.661
2002/9/13,1245,4548,-19,20,17,3,1.012,2.031
2002/9/13,1345,4540,-8,22,16,6,1.011,1.266
2002/9/16,945,4506,-44,47,46,1,1.017,0.929
2002/9/16,1045,4478,-27,34,32,2,1.02,1.024
2002/9/16,1145,4455,-23,28,31,-3,1.022,1.555
2002/9/16,1245,4439,-21,41,30,11,1.021,1.245
2002/9/16,1345,4422,-16,28,16,12,1.022,1.032
2002/9/17,945,4466,-24,58,24,34,1.01,0.876
2002/9/17,1045,4557,90,121,22,99,0.988,0.643
2002/9/17,1145,4552,-6,35,16,19,0.989,1.723
2002/9/17,1245,4598,46,55,4,51,0.979,1.45
2002/9/17,1345,4640,40,58,20,38,0.971,1.281
2002/9/18,945,4507,-38,84,43,41,1,1.447
2002/9/18,1045,4496,-11,33,24,9,1.003,3.434
2002/9/18,1145,4460,-36,31,38,-7,1.011,2.563
2002/9/18,1245,4475,15,42,12,30,1.008,2.972
2002/9/18,1345,4475,-3,20,5,15,1.009,1.196
2002/9/19,945,4495,35,70,15,55,1.003,0.3
2002/9/19,1045,4476,-19,33,18,15,1.008,0.592
2002/9/19,1145,4504,27,70,36,34,1,0.422
2002/9/19,1245,4487,-17,41,19,22,1.003,0.667
2002/9/19,1345,4441,-47,58,53,5,1.011,0.636
2002/9/19,945,4365,4365,66,1,65,0.924,0.554
2002/9/20,1045,4333,-32,45,43,2,0.928,1.095
2002/9/20,1145,4346,13,28,9,19,0.921,1.765
2002/9/20,1245,4367,21,35,13,22,0.914,1.343
2002/9/20,1345,4365,-1,31,28,3,0.912,1.167
2002/9/23,945,4340,-11,58,46,12,0.915,0.934
2002/9/23,1045,4306,-34,34,35,-1,0.918,1.215
2002/9/23,1145,4304,-1,29,5,24,0.915,1.175
2002/9/23,1245,4305,-1,33,14,19,0.91,1.453
2002/9/23,1345,4314,10,33,14,19,0.904,0.996
2002/9/24,945,4356,56,68,3,65,0.994,0.503
2002/9/24,1045,4287,-71,90,70,20,1.01,0.737
2002/9/24,1145,4278,-12,33,17,16,1.011,1.256
2002/9/24,1245,4297,19,35,15,20,1.005,1.195
2002/9/24,1345,4291,-6,34,16,18,1.005,1.276
2002/9/25,945,4244,-26,55,53,2,1.014,0.85
2002/9/25,1045,4221,-24,40,32,8,1.017,0.934
2002/9/25,1145,4208,-12,28,27,1,1.018,1.458
2002/9/25,1245,4145,-63,77,67,10,1.031,0.913
2002/9/25,1345,4175,30,81,6,75,1.02,0.844
2002/9/26,945,4232,-7,53,42,11,1.005,0.671
2002/9/26,1045,4226,-4,23,18,5,1.003,1.132
2002/9/26,1145,4234,8,26,-3,29,1,1.131
2002/9/26,1245,4237,2,35,8,27,0.998,1.444
2002/9/26,1345,4205,-31,39,35,4,1.004,1.113
2002/9/27,945,4257,38,76,6,70,0.991,0.719
2002/9/27,1045,4229,-28,31,29,2,0.998,1.154
2002/9/27,1145,4214,-14,35,31,4,1.001,1.506
2002/9/27,1245,4176,-38,52,31,21,1.011,0.786
2002/9/27,1345,4190,15,45,0,45,1.008,0.952
2002/9/30,945,4060,-58,58,50,8,1.037,0.763
2002/9/30,1045,4064,5,31,12,19,1.032,1.591
2002/9/30,1145,4070,7,22,0,22,1.027,1.988
2002/9/30,1245,4077,6,28,12,16,1.021,1.657
2002/9/30,1345,4123,45,105,57,48,1.006,0.679
2002/10/1,945,4188,77,80,-8,88,0.987,0.647
2002/10/1,1045,4154,-34,60,46,14,0.994,0.878
2002/10/1,1145,4103,-52,72,54,18,1.004,0.802
2002/10/1,1245,4100,-9,45,25,20,1.003,1.185
2002/10/1,1345,4120,23,47,15,32,0.996,1.073
2002/10/2,945,4177,-48,71,59,12,0.985,0.602
2002/10/2,1045,4160,-16,39,29,10,0.992,0.978
2002/10/2,1145,4155,-5,24,5,19,0.995,1.199
2002/10/2,1245,4146,-9,38,27,11,0.999,1.691
2002/10/2,1345,4113,-37,38,35,3,1.009,1.155
2002/10/3,945,4062,-19,35,31,4,1.021,0.923
2002/10/3,1045,4050,-13,30,15,15,1.021,1.26
2002/10/3,1145,4060,13,22,4,18,1.016,2.147
2002/10/3,1245,4041,-20,38,22,16,1.019,1.39
2002/10/3,1345,4044,2,24,4,20,1.017,1.285
2002/10/4,945,4019,-16,44,31,13,1.019,0.698
2002/10/4,1045,4077,58,93,22,71,1.001,0.58
2002/10/4,1145,4068,-14,38,15,23,1.001,1.054
2002/10/4,1245,4052,-14,41,23,18,1.003,1.41
2002/10/4,1345,4049,-2,30,25,5,1.001,1.075
2002/10/7,945,3960,-40,37,39,-2,1.021,0.754
2002/10/7,1045,3940,-20,22,17,5,1.024,1.096
2002/10/7,1145,3917,-21,34,28,6,1.027,1.602
2002/10/7,1245,3901,-17,36,22,14,1.028,1.222
2002/10/7,1345,3896,-6,29,26,3,1.025,1.228
2002/10/8,945,3897,-14,54,48,6,1.022,0.72
2002/10/8,1045,3912,19,57,17,40,1.015,0.876
2002/10/8,1145,3916,1,44,23,21,1.01,1.045
2002/10/8,1245,3946,31,47,14,33,0.998,1.09
2002/10/8,1345,3965,16,24,0,24,0.991,1.014
2002/10/9,945,3961,22,58,19,39,0.99,0.664
2002/10/9,1045,3973,12,35,2,33,0.987,0.906
2002/10/9,1145,3979,5,27,15,12,0.987,1.25
2002/10/9,1245,3946,-34,34,33,1,0.996,1.394
2002/10/9,1345,3872,-74,73,73,0,1.017,0.717
2002/10/11,945,3905,-22,59,44,15,1.008,0.792
2002/10/11,1045,3910,5,34,6,28,1.007,1.141
2002/10/11,1145,3869,-41,52,48,4,1.018,1.144
2002/10/11,1245,3810,-57,59,55,4,1.033,0.896
2002/10/11,1345,3818,6,37,2,35,1.027,0.971
2002/10/14,945,3910,41,59,3,56,1.001,0.653
2002/10/14,1045,3875,-35,45,32,13,1.009,1.371
2002/10/14,1145,3897,20,41,16,25,1,1.432
2002/10/14,1245,3871,-29,40,39,1,1.005,2.02
2002/10/14,1345,3880,9,38,8,30,1.001,1.23
2002/10/15,945,4081,151,185,29,156,0.951,0.621
2002/10/15,1045,4118,37,47,2,45,0.947,1.528
2002/10/15,1145,4151,33,35,-1,36,0.945,1.813
2002/10/15,1345,4151,0,0,0,0,0.952,9.039
2002/10/16,945,4148,-96,99,95,4,0.963,1.47
2002/10/16,1045,4170,21,40,15,25,0.964,3.488
2002/10/16,1145,4189,19,55,31,24,0.966,2.477
2002/10/16,1245,4190,0,30,20,10,0.973,2.805
2002/10/16,1345,4198,7,45,32,13,0.978,1.76
2002/10/17,945,4190,25,49,3,46,0.987,0.376
2002/10/17,1045,4252,60,85,26,59,0.979,0.346
2002/10/17,1145,4240,-12,53,46,7,0.986,0.542
2002/10/17,1245,4230,-12,48,45,3,0.991,0.76
2002/10/17,1345,4266,36,69,4,65,0.985,0.593
2002/10/18,945,4333,23,43,15,28,0.971,0.484
2002/10/18,1045,4316,-18,58,39,19,0.979,0.988
2002/10/18,1145,4335,18,32,15,17,0.978,1.284
2002/10/18,1245,4395,60,61,-1,62,0.968,0.904
2002/10/18,1345,4400,7,55,36,19,0.972,0.991
2002/10/21,945,4375,25,45,21,24,0.981,1.248
2002/10/21,1045,4393,18,50,22,28,0.981,1.41
2002/10/21,1145,4385,-7,50,33,17,0.986,1.204
2002/10/21,1245,4385,0,36,21,15,0.99,2.162
2002/10/21,1345,4360,-25,48,40,8,0.999,1.366
2002/10/22,945,4420,10,48,18,30,0.988,0.668
2002/10/22,1045,4402,-19,40,33,7,0.994,1.103
2002/10/22,1145,4349,-54,65,54,11,1.008,0.767
2002/10/22,1245,4319,-29,49,40,9,1.015,0.84
2002/10/22,1345,4292,-26,48,43,5,1.02,0.817
2002/10/23,945,4303,-11,60,32,28,1.016,0.72
2002/10/23,1045,4332,29,63,26,37,1.008,0.747
2002/10/23,1145,4490,158,167,9,158,0.971,0.65
2002/10/23,1245,4539,49,109,53,56,0.963,0.655
2002/10/23,1345,4592,55,45,-2,47,0.955,1.402
2002/10/24,945,4518,-45,69,66,3,0.974,0.882
2002/10/24,1045,4539,22,53,-2,55,0.972,1.167
2002/10/24,1145,4512,-27,72,66,6,0.98,1.185
2002/10/24,1245,4526,14,47,22,25,0.981,1.709
2002/10/24,1345,4543,15,74,51,23,0.982,1.042
2002/10/25,945,4515,15,58,4,54,0.992,1.004
2002/10/25,1045,4476,-38,55,45,10,1.006,1.452
2002/10/25,1145,4496,20,47,23,24,1.004,1.398
2002/10/25,1245,4551,53,60,6,54,0.992,0.917
2002/10/25,1345,4520,-38,74,56,18,1,0.994
2002/10/28,945,4614,44,49,6,43,0.979,0.697
2002/10/28,1045,4580,-31,35,25,10,0.989,1.38
2002/10/28,1145,4605,25,31,4,27,0.984,1.71
2002/10/28,1245,4625,20,38,6,32,0.982,1.289
2002/10/28,1345,4539,-85,90,87,3,1.003,0.894
2002/10/29,945,4523,13,49,27,22,1.006,1.066
2002/10/29,1045,4519,-2,37,10,27,1.008,1.355
2002/10/29,1145,4515,-3,21,6,15,1.009,2.028
2002/10/29,1245,4533,18,25,-3,28,1.006,1.678
2002/10/29,1345,4521,-11,38,22,16,1.008,1.068
2002/10/30,945,4512,11,27,8,19,1.008,0.861
2002/10/30,1045,4550,40,64,18,46,0.998,0.682
2002/10/30,1145,4472,-78,96,84,12,1.014,0.655
2002/10/30,1245,4431,-41,51,42,9,1.021,0.743
2002/10/30,1345,4440,9,49,14,35,1.014,0.86
2002/10/31,945,4563,79,111,17,94,0.986,0.525
2002/10/31,1045,4541,-23,24,25,-1,0.992,0.987
2002/10/31,1145,4545,4,40,17,23,0.992,1.262
2002/10/31,1245,4538,-8,36,20,16,0.994,1.88
2002/10/31,1345,4549,11,31,7,24,0.992,1.477
2002/11/1,945,4523,-35,37,34,3,0.999,1.231
2002/11/1,1045,4483,-42,65,43,22,1.008,0.717
2002/11/1,1145,4461,-21,28,32,-4,1.011,1.526
2002/11/1,1245,4465,4,24,0,24,1.01,1.415
2002/11/1,1345,4466,0,41,0,41,1.011,1.228
2002/11/4,945,4558,-28,89,82,7,0.993,0.583
2002/11/4,1045,4555,-3,48,35,13,0.993,1.207
2002/11/4,1145,4573,18,29,8,21,0.99,1.636
2002/11/4,1245,4538,-33,50,35,15,0.998,1.34
2002/11/4,1345,4595,59,71,-8,79,0.985,0.978
2002/11/5,945,4538,-67,70,67,3,0.999,0.628
2002/11/5,1045,4543,6,24,11,13,0.998,1.387
2002/11/5,1145,4540,-2,38,10,28,1,1.191
2002/11/5,1245,4551,13,21,0,21,0.999,2.013
2002/11/5,1345,4548,-4,25,12,13,1.002,1.361
2002/11/6,945,4581,13,43,-6,49,0.994,0.776
2002/11/6,1045,4612,29,40,11,29,0.988,0.608
2002/11/6,1145,4652,40,69,13,56,0.981,0.615
2002/11/6,1245,4740,88,103,10,93,0.964,0.651
2002/11/6,1345,4720,-23,30,27,3,0.973,0.935
2002/11/7,945,4730,13,45,16,29,0.973,0.841
2002/11/7,1045,4716,-14,46,23,23,0.98,1.315
2002/11/7,1145,4742,26,35,8,27,0.978,1.341
2002/11/7,1245,4751,9,45,22,23,0.981,1.312
2002/11/7,1345,4748,-2,30,8,22,0.985,1.605
2002/11/8,945,4724,25,46,10,36,0.993,0.885
2002/11/8,1045,4765,42,58,5,53,0.988,1.297
2002/11/8,1145,4772,7,38,22,16,0.989,1.025
2002/11/8,1245,4767,-4,28,10,18,0.993,1.487
2002/11/8,1345,4783,15,44,2,42,0.99,1.279
2002/11/11,945,4712,-23,40,37,3,1.005,1.009
2002/11/11,1045,4672,-39,55,43,12,1.014,0.648
2002/11/11,1145,4681,9,22,5,17,1.011,1.581
2002/11/11,1245,4666,-14,29,19,10,1.013,1.575
2002/11/11,1345,4680,13,20,0,20,1.008,1.571
2002/11/12,945,4637,11,52,23,29,1.016,0.631
2002/11/12,1045,4640,2,25,12,13,1.013,1.279
2002/11/12,1145,4670,30,41,9,32,1.004,1.17
2002/11/12,1245,4668,-2,32,21,11,1.002,1.115
2002/11/12,1345,4673,4,31,20,11,0.999,1.323
2002/11/13,945,4679,9,49,12,37,0.996,0.793
2002/11/13,1045,4660,-20,42,24,18,1,0.997
2002/11/13,1145,4617,-35,53,49,4,1.009,0.924
2002/11/13,1245,4632,13,22,3,19,1.004,1.23
2002/11/13,1345,4657,24,40,10,30,0.998,1.12
2002/11/14,945,4707,39,69,22,47,0.988,0.545
2002/11/14,1045,4708,-2,32,16,16,0.99,1.197
2002/11/14,1145,4689,-19,56,39,17,0.995,0.888
2002/11/14,1245,4677,-12,32,29,3,0.998,1.557
2002/11/14,1345,4662,-16,37,25,12,1.001,0.953
2002/11/15,945,4757,-8,36,21,15,0.983,0.642
2002/11/15,1045,4788,32,45,2,43,0.979,1.209
2002/11/15,1145,4817,27,40,8,32,0.976,0.887
2002/11/15,1245,4801,-16,24,14,10,0.983,2.117
2002/11/15,1345,4815,11,30,0,30,0.984,1.436
2002/11/18,945,4811,1,37,17,20,0.987,1.14
2002/11/18,1045,4812,1,30,11,19,0.989,1.436
2002/11/18,1145,4800,-12,28,25,3,0.994,2.156
2002/11/18,1245,4789,-9,18,13,5,0.998,2.598
2002/11/18,1345,4790,1,22,18,4,1.001,1.964
2002/11/19,945,4756,-32,49,43,6,1.008,1.101
2002/11/19,1045,4732,-26,28,28,0,1.013,1.165
2002/11/19,1145,4738,6,23,7,16,1.011,2.075
2002/11/19,1245,4745,5,17,8,9,1.008,2.98
2002/11/19,1345,4740,2,18,5,13,1.007,1.61
2002/11/20,945,4659,-52,99,80,19,1.023,0.856
2002/11/20,1045,4662,4,20,3,17,1.019,1.585
2002/11/20,1145,4668,6,15,2,13,1.014,3.145
2002/11/20,1245,4683,16,19,-1,20,1.008,2.274
2002/11/20,1345,4661,-23,36,36,0,1.011,0.811
2002/11/21,945,4683,-47,63,60,3,1.005,0.246
2002/11/21,1045,4661,-22,41,35,6,1.008,0.497
2002/11/21,1145,4639,-23,48,34,14,1.011,0.546
2002/11/21,1245,4637,1,29,19,10,1.009,0.867
2002/11/21,1345,4631,-4,53,13,40,1.009,0.525
2002/11/22,945,4729,4,59,31,28,0.988,0.377
2002/11/22,1045,4735,7,33,12,21,0.988,1.138
2002/11/22,1145,4734,-1,26,23,3,0.99,1.399
2002/11/22,1245,4723,-11,19,21,-2,0.994,2.312
2002/11/22,1345,4710,-13,30,29,1,0.997,1.3
2002/11/25,945,4667,-64,88,72,16,1.006,0.731
2002/11/25,1045,4682,15,31,5,26,1.003,1.387
2002/11/25,1145,4695,15,29,8,21,1,1.563
2002/11/25,1245,4682,-12,20,18,2,1.004,2.888
2002/11/25,1345,4748,66,68,0,68,0.991,0.848
2002/11/26,945,4736,14,52,9,43,0.994,0.655
2002/11/26,1045,4724,-12,29,21,8,0.997,1.343
2002/11/26,1145,4704,-21,42,39,3,1.001,1.461
2002/11/26,1245,4695,-10,27,10,17,1.002,0.966
2002/11/26,1345,4681,-14,23,14,9,1.004,1.002
2002/11/27,945,4648,8,28,11,17,1.01,0.664
2002/11/27,1045,4625,-23,30,29,1,1.014,1.178
2002/11/27,1145,4614,-10,31,21,10,1.015,0.812
2002/11/27,1245,4626,11,20,4,16,1.011,1.772
2002/11/27,1345,4655,27,29,0,29,1.004,0.939
2002/11/28,945,4651,-69,91,91,0,1.004,0.477
2002/11/28,1045,4658,7,34,7,27,1.001,1.016
2002/11/28,1145,4674,15,32,-2,34,0.996,1.547
2002/11/28,1245,4671,-2,29,15,14,0.996,1.17
2002/11/28,1345,4640,-32,63,44,19,1.002,0.893
2002/11/29,945,4678,34,57,7,50,0.994,0.815
2002/11/29,1045,4664,-16,26,15,11,0.998,1.55
2002/11/29,1145,4654,-9,25,11,14,1.001,1.659
2002/11/29,1245,4655,2,22,10,12,1.001,2.528
2002/11/29,1345,4670,15,23,6,17,0.999,1.043
2002/12/2,945,4634,-26,41,43,-2,1.005,1.137
2002/12/2,1045,4634,1,27,9,18,1.005,0.887
2002/12/2,1145,4638,5,17,-1,18,1.004,2.074
2002/12/2,1245,4642,5,13,5,8,1.002,2.138
2002/12/2,1345,4713,70,74,2,72,0.986,0.536
2002/12/3,945,4739,37,69,10,59,0.982,0.454
2002/12/3,1045,4751,11,35,7,28,0.981,0.736
2002/12/3,1145,4773,22,38,13,25,0.978,0.705
2002/12/3,1245,4777,5,18,6,12,0.98,1.407
2002/12/3,1345,4776,0,31,29,2,0.982,0.748
2002/12/4,945,4755,14,23,3,20,0.989,0.886
2002/12/4,1045,4747,-10,23,11,12,0.993,2.021
2002/12/4,1145,4743,-3,12,12,0,0.996,3.826
2002/12/4,1245,4765,22,26,4,22,0.994,2.686
2002/12/4,1345,4745,-21,22,19,3,1,1.81
2002/12/5,945,4735,-16,33,34,-1,1.004,0.85
2002/12/5,1045,4750,18,24,-1,25,1,1.351
2002/12/5,1145,4760,10,21,-2,23,0.998,2.345
2002/12/5,1245,4743,-17,23,22,1,1.001,1.716
2002/12/5,1345,4763,19,29,3,26,0.997,0.798
2002/12/6,945,4752,14,29,8,21,0.999,0.819
2002/12/6,1045,4755,3,13,1,12,0.998,1.697
2002/12/6,1145,4750,-6,15,12,3,0.999,1.36
2002/12/6,1245,4749,-1,7,6,1,1,3.315
2002/12/6,1345,4744,-5,15,13,2,1,0.853
2002/12/9,945,4813,33,68,35,33,0.987,0.352
2002/12/9,1045,4830,17,27,3,24,0.985,0.713
2002/12/9,1145,4824,-7,21,15,6,0.988,0.888
2002/12/9,1245,4830,5,17,9,8,0.988,1.334
2002/12/9,1345,4790,-42,42,42,0,0.998,0.545
2002/12/10,945,4730,-20,30,17,13,1.011,0.456
2002/12/10,1045,4735,5,17,2,15,1.009,1.476
2002/12/10,1145,4728,-7,11,9,2,1.01,2.212
2002/12/10,1245,4739,10,16,2,14,1.008,1.894
2002/12/10,1345,4755,18,22,0,22,1.004,1.248
2002/12/11,945,4770,40,33,-2,35,1,0.698
2002/12/11,1045,4746,-24,37,37,0,1.004,0.869
2002/12/11,1145,4744,-2,23,14,9,1.003,1.235
2002/12/11,1245,4731,-13,34,16,18,1.004,1.096
2002/12/11,1345,4686,-44,50,45,5,1.011,0.655
2002/12/12,945,4703,13,35,6,29,1.006,0.864
2002/12/12,1045,4686,-15,28,24,4,1.009,1.479
2002/12/12,1145,4662,-26,47,38,9,1.013,1.008
2002/12/12,1245,4646,-15,21,23,-2,1.015,1.199
2002/12/12,1345,4687,41,54,5,49,1.005,0.886
2002/12/13,945,4662,-7,27,11,16,1.009,1.002
2002/12/13,1045,4651,-12,31,15,16,1.009,1.001
2002/12/13,1145,4635,-16,24,19,5,1.01,1.426
2002/12/13,1245,4634,-1,18,7,11,1.008,1.385
2002/12/13,1345,4623,-10,27,19,8,1.008,0.908
2002/12/16,945,4578,-4,23,11,12,1.016,0.813
2002/12/16,1045,4585,7,36,24,12,1.012,1.325
2002/12/16,1145,4579,-5,26,13,13,1.011,2.095
2002/12/16,1245,4585,6,16,4,12,1.008,2.596
2002/12/16,1345,4600,15,22,5,17,1.003,1.071
2002/12/17,945,4598,-41,54,46,8,1.003,0.957
2002/12/17,1045,4595,-2,26,19,7,1.002,2.174
2002/12/17,1145,4586,-9,19,12,7,1.003,2.002
2002/12/17,1245,4586,0,13,11,2,1.002,2.441
2002/12/17,1345,4576,-10,19,11,8,1.003,0.844
2002/12/18,945,4581,30,42,14,28,1.001,1.04
2002/12/18,1045,4566,-15,24,25,-1,1.004,2.275
2002/12/18,1145,4555,-11,29,17,12,1.006,1.358
2002/12/18,1245,4553,-2,16,5,11,1.006,1.405
2002/12/18,1345,4550,0,14,10,4,1.006,0.727
2002/12/19,945,4533,24,46,4,42,1.007,0.295
2002/12/19,1045,4566,36,42,2,40,0.998,0.505
2002/12/19,1145,4546,-19,25,29,-4,1.002,0.675
2002/12/19,1245,4557,11,23,1,22,0.999,1.156
2002/12/19,1345,4550,-7,20,7,13,1,1.102
2002/12/20,945,4535,-15,52,33,19,1.003,0.606
2002/12/20,1045,4541,5,21,7,14,1.001,0.951
2002/12/20,1145,4532,-10,27,16,11,1.002,1.289
2002/12/20,1245,4549,17,56,11,45,0.998,0.75
2002/12/20,1345,4573,25,43,20,23,0.993,0.606
2002/12/23,945,4565,-4,18,4,14,0.996,1.283
2002/12/23,1045,4555,-11,28,25,3,0.999,1.722
2002/12/23,1145,4551,-4,20,9,11,0.999,1.435
2002/12/23,1245,4547,-4,11,8,3,1,3.945
2002/12/23,1345,4536,-11,20,24,-4,1.002,2.35
2002/12/24,945,4559,9,19,6,13,0.997,1.139
2002/12/24,1045,4533,-26,35,29,6,1.004,0.971
2002/12/24,1145,4531,-2,19,9,10,1.004,1.245
2002/12/24,1245,4540,10,16,7,9,1.002,1.522
2002/12/24,1345,4530,-10,19,12,7,1.004,1.102
2002/12/25,945,4503,-17,35,25,10,1.009,0.555
2002/12/25,1045,4507,4,33,7,26,1.007,0.582
2002/12/25,1145,4488,-19,19,19,0,1.01,1.581
2002/12/25,1245,4490,1,19,15,4,1.008,1.609
2002/12/25,1345,4488,-2,15,8,7,1.007,0.815
2002/12/26,945,4462,-26,46,45,1,1.012,0.654
2002/12/26,1045,4491,27,29,-2,31,1.003,1.159
2002/12/26,1145,4479,-14,20,15,5,1.005,1.657
2002/12/26,1245,4490,11,21,8,13,1.001,1.629
2002/12/26,1345,4531,42,50,4,46,0.991,0.618
2002/12/27,945,4513,-14,16,14,2,0.995,0.95
2002/12/27,1045,4525,11,23,9,14,0.993,1.078
2002/12/27,1145,4505,-22,32,22,10,0.998,1.036
2002/12/27,1245,4514,9,16,2,14,0.996,1.837
2002/12/27,1345,4501,-10,14,14,0,0.999,1.701
2002/12/30,945,4443,-9,31,21,10,1.011,0.537
2002/12/30,1045,4435,-6,23,15,8,1.013,1.107
2002/12/30,1145,4429,-4,18,11,7,1.013,1.401
2002/12/30,1245,4410,-18,22,20,2,1.016,1.64
2002/12/30,1345,4416,5,21,13,8,1.013,0.862
2002/12/31,945,4419,3,25,18,7,1.01,0.776
2002/12/31,1045,4409,-9,28,19,9,1.01,1.101
2002/12/31,1145,4414,6,13,0,13,1.006,2.02
2002/12/31,1245,4418,5,9,0,9,1.003,2.842
2002/12/31,1345,4405,-12,27,27,0,1.004,0.923
2003/1/2,945,4441,30,67,7,60,0.995,0.448
2003/1/2,1045,4442,1,27,15,12,0.994,0.581
2003/1/2,1145,4448,7,17,3,14,0.993,1.388
2003/1/2,1245,4470,21,38,15,23,0.989,0.724
2003/1/2,1345,4452,-18,17,21,-4,0.994,1.09
2003/1/3,945,4549,-2,24,11,13,0.976,0.412
2003/1/3,1045,4551,6,17,3,14,0.978,1.45
2003/1/3,1145,4560,9,19,2,17,0.98,1.753
2003/1/3,1245,4563,3,24,5,19,0.982,1.376
2003/1/3,1345,4571,9,31,23,8,0.984,0.672
2003/1/6,945,4577,4,29,15,14,0.986,1.174
2003/1/6,1045,4601,24,32,6,26,0.984,0.963
2003/1/6,1145,4642,41,36,-4,40,0.978,0.845
2003/1/6,1245,4628,-14,22,17,5,0.985,1.482
2003/1/6,1345,4635,7,23,11,12,0.987,1.063
2003/1/7,945,4688,1,28,12,16,0.979,0.616
2003/1/7,1045,4671,-15,30,19,11,0.986,1.26
2003/1/7,1145,4678,7,25,7,18,0.987,1.396
2003/1/7,1245,4671,-7,27,9,18,0.991,1.76
2003/1/7,1345,4641,-29,35,33,2,1,0.89
2003/1/8,945,4669,19,43,16,27,0.995,0.943
2003/1/8,1045,4715,47,58,10,48,0.987,0.621
2003/1/8,1145,4753,39,55,14,41,0.982,0.693
2003/1/8,1245,4803,49,55,3,52,0.974,0.791
2003/1/8,1345,4771,-33,49,51,-2,0.984,0.782
2003/1/9,945,4763,-2,53,42,11,0.988,0.739
2003/1/9,1045,4786,23,29,6,23,0.984,1.606
2003/1/9,1145,4788,1,24,22,2,0.986,1.295
2003/1/9,1245,4780,-8,23,17,6,0.99,2.527
2003/1/9,1345,4785,5,18,9,9,0.992,1.485
2003/1/10,945,4805,-40,55,42,13,0.992,0.652
2003/1/10,1045,4832,27,35,6,29,0.989,1.4
2003/1/10,1145,4816,-16,34,29,5,0.995,1.491
2003/1/10,1245,4826,9,16,2,14,0.994,2.063
2003/1/10,1345,4828,2,22,0,22,0.994,1.177
2003/1/13,945,4953,85,127,27,100,0.971,0.511
2003/1/13,1045,4957,6,32,7,25,0.974,1.445
2003/1/13,1145,4980,23,31,6,25,0.973,1.283
2003/1/13,1245,4981,-1,28,13,15,0.976,1.384
2003/1/13,1345,5025,42,35,-8,43,0.972,1.006
2003/1/14,945,5000,-25,22,15,7,0.98,1.555
2003/1/14,1045,5015,15,25,5,20,0.981,2.323
2003/1/14,1145,5029,14,62,46,16,0.982,1.482
2003/1/14,1245,5017,-11,34,27,7,0.989,1.708
2003/1/14,1345,5009,-8,32,21,11,0.994,1.423
2003/1/15,945,4985,-103,70,68,2,1.003,1.077
2003/1/15,1045,4988,2,30,2,28,1.004,1.337
2003/1/15,1145,4984,-2,18,16,2,1.005,2.947
2003/1/15,1245,5011,27,37,6,31,1,2.443
2003/1/15,1345,5044,35,34,-6,40,0.994,0.927
2003/1/16,945,4990,0,47,37,10,1.004,0.315
2003/1/16,1045,5007,18,21,2,19,1,0.736
2003/1/16,1145,5000,-7,23,17,6,1.001,1.144
2003/1/16,1245,4989,-11,32,25,7,1.003,1
2003/1/16,1345,4940,-49,61,53,8,1.012,0.461
2003/1/17,945,4947,17,32,2,30,1.008,0.58
2003/1/17,1045,4934,-13,35,25,10,1.009,0.784
2003/1/17,1145,4909,-25,34,28,6,1.014,0.954
2003/1/17,1245,4928,20,42,20,22,1.008,1.102
2003/1/17,1345,4925,-1,30,12,18,1.007,1.252
2003/1/20,945,4892,0,31,21,10,1.012,1.071
2003/1/20,1045,4915,22,34,10,24,1.005,1.494
2003/1/20,1145,4923,6,32,15,17,1.002,1.376
2003/1/20,1245,4920,-3,21,9,12,1.001,1.817
2003/1/20,1345,4968,50,64,8,56,0.99,0.724
2003/1/21,945,4955,-13,25,20,5,0.993,0.729
2003/1/21,1045,4964,9,25,4,21,0.991,1.2
2003/1/21,1145,5017,52,77,18,59,0.981,0.536
2003/1/21,1245,5001,-16,37,28,9,0.987,0.736
2003/1/21,1345,4939,-63,69,61,8,1.001,0.603
2003/1/22,945,4948,38,45,10,35,0.999,0.984
2003/1/22,1045,4921,-26,38,32,6,1.006,1.344
2003/1/22,1145,4936,14,31,7,24,1.003,1.612
2003/1/22,1245,4934,-2,32,20,12,1.004,1.646
2003/1/22,1345,5002,67,73,4,69,0.99,0.609
2003/1/23,945,5050,52,67,15,52,0.981,0.648
2003/1/23,1045,5033,-17,29,15,14,0.987,1.155
2003/1/23,1145,5069,37,54,18,36,0.981,0.753
2003/1/23,1245,5062,-7,28,9,19,0.983,1.511
2003/1/23,1345,5085,22,24,0,24,0.98,1.225
2003/1/24,945,5072,-13,53,38,15,0.986,0.839
2003/1/24,1045,5075,4,25,3,22,0.988,1.41
2003/1/24,1145,5072,0,23,16,7,0.991,1.774
2003/1/24,1245,5088,16,28,8,20,0.991,1.83
2003/1/24,1345,5063,-24,28,22,6,0.999,1.035
2003/1/27,945,4999,-15,51,37,14,1.012,0.752
2003/1/27,1045,4970,-29,43,33,10,1.017,1.053
2003/1/27,1145,4970,0,32,18,14,1.016,1.479
2003/1/27,1245,4951,-20,41,31,10,1.018,1.183
2003/1/27,1345,4956,5,22,12,10,1.014,1.156
2003/1/28,945,4963,6,36,14,22,1.01,0.953
2003/1/28,1045,4969,6,30,6,24,1.007,1.843
2003/1/28,1145,4968,-1,21,14,7,1.005,1.646
2003/1/28,1245,4989,20,21,-1,22,0.999,1.578
2003/1/28,1345,5022,32,40,4,36,0.99,0.683
2003/2/6,945,4919,-88,99,81,18,1.011,0.732
2003/2/6,1045,4890,-29,53,39,14,1.015,0.721
2003/2/6,1145,4882,-8,28,18,10,1.015,1.448
2003/2/6,1245,4833,-49,56,53,3,1.024,1.188
2003/2/6,1345,4775,-58,69,60,9,1.034,0.697
2003/2/7,945,4786,5,43,33,10,1.028,0.671
2003/2/7,1045,4753,-33,54,36,18,1.031,0.867
2003/2/7,1145,4697,-56,78,71,7,1.039,0.998
2003/2/7,1245,4662,-34,76,36,40,1.041,0.706
2003/2/7,1345,4699,35,77,41,36,1.025,0.726
2003/2/10,945,4697,18,53,8,45,1.019,1.052
2003/2/10,1045,4636,-61,61,57,4,1.028,1.317
2003/2/10,1145,4644,6,48,24,24,1.02,1.29
2003/2/10,1245,4678,34,31,-17,48,1.008,1.68
2003/2/10,1345,4640,-38,49,44,5,1.013,1.505
2003/2/11,945,4647,-22,44,43,1,1.009,0.912
2003/2/11,1045,4638,-9,25,17,8,1.008,1.231
2003/2/11,1145,4670,32,55,15,40,0.998,0.941
2003/2/11,1245,4644,-26,37,26,11,1.003,1.242
2003/2/11,1345,4635,-10,31,18,13,1.005,1.036
2003/2/12,945,4654,35,146,22,124,1,0.456
2003/2/12,1045,4656,1,34,10,24,0.998,1.202
2003/2/12,1145,4619,-38,50,37,13,1.007,1.088
2003/2/12,1245,4618,-1,38,32,6,1.006,1.392
2003/2/12,1345,4637,20,41,10,31,1.001,1.197
2003/2/13,945,4565,-45,64,60,4,1.015,0.713
2003/2/13,1045,4565,0,34,20,14,1.014,0.837
2003/2/13,1145,4566,1,37,22,15,1.012,1.274
2003/2/13,1245,4530,-35,54,45,9,1.018,1.054
2003/2/13,1345,4485,-44,46,52,-6,1.025,0.877
2003/2/14,945,4507,-5,48,53,-5,1.018,0.782
2003/2/14,1045,4490,-17,39,30,9,1.018,1.013
2003/2/14,1145,4502,11,45,15,30,1.012,1.233
2003/2/14,1245,4496,-6,38,24,14,1.011,1.97
2003/2/14,1345,4489,-8,42,36,6,1.01,1.064
2003/2/17,945,4635,55,54,2,52,0.977,0.555
2003/2/17,1045,4663,28,36,6,30,0.973,0.954
2003/2/17,1145,4671,9,36,17,19,0.973,1.468
2003/2/17,1245,4674,3,18,11,7,0.975,2.548
2003/2/17,1345,4690,14,31,9,22,0.975,1.304
2003/2/18,945,4636,-46,41,39,2,0.99,1.031
2003/2/18,1045,4620,-16,26,24,2,0.996,2.277
2003/2/18,1145,4626,6,12,7,5,0.997,2.763
2003/2/18,1245,4629,1,17,-2,19,0.999,2.532
2003/2/18,1345,4636,11,17,-1,18,1.001,2.241
2003/2/19,945,4603,-77,88,79,9,1.01,1.386
2003/2/19,1045,4596,-7,39,9,30,1.011,1.63
2003/2/19,1145,4585,-12,26,32,-6,1.012,1.549
2003/2/19,1245,4594,9,20,3,17,1.008,2.251
2003/2/19,1345,4545,-50,52,48,4,1.017,0.793
2003/2/20,945,4565,29,41,-8,49,1.009,0.332
2003/2/20,1045,4542,-23,36,33,3,1.013,0.385
2003/2/20,1145,4525,-19,38,28,10,1.015,0.595
2003/2/20,1245,4540,17,37,4,33,1.009,0.767
2003/2/20,1345,4560,20,27,-1,28,1.003,0.79
2003/2/21,945,4560,-6,51,24,27,1.001,0.646
2003/2/21,1045,4543,-16,25,16,9,1.003,1.453
2003/2/21,1145,4524,-18,43,34,9,1.006,1.105
2003/2/21,1245,4529,5,28,11,17,1.004,1.427
2003/2/21,1345,4540,11,18,-2,20,1,1.587
2003/2/24,945,4529,-46,60,51,9,1.003,0.748
2003/2/24,1045,4528,0,28,14,14,1.003,1.094
2003/2/24,1145,4529,1,17,10,7,1.002,2.228
2003/2/24,1245,4555,22,36,11,25,0.997,0.999
2003/2/24,1345,4601,49,72,24,48,0.987,0.439
2003/2/25,945,4480,-60,69,64,5,1.013,0.382
2003/2/25,1045,4448,-32,46,40,6,1.019,0.831
2003/2/25,1145,4461,13,22,3,19,1.014,1.921
2003/2/25,1245,4451,-9,29,16,13,1.014,1.849
2003/2/25,1345,4450,-2,25,9,16,1.013,1.235
2003/2/26,945,4466,-14,35,11,24,1.007,0.676
2003/2/26,1045,4461,-5,26,17,9,1.007,1.509
2003/2/26,1145,4457,-6,20,8,12,1.006,1.987
2003/2/26,1245,4479,23,29,6,23,1,1.584
2003/2/26,1345,4451,-27,34,28,6,1.004,1.091
2003/2/27,945,4390,-20,43,15,28,1.015,0.551
2003/2/27,1045,4415,22,52,15,37,1.008,0.791
2003/2/27,1145,4419,7,18,5,13,1.006,1.857
2003/2/27,1245,4456,37,52,14,38,0.997,0.815
2003/2/27,1345,4408,-48,48,46,2,1.008,0.982
2003/3/3,945,4462,9,38,11,27,0.995,0.88
2003/3/3,1045,4485,23,33,2,31,0.99,1.284
2003/3/3,1145,4478,-7,20,14,6,0.992,1.497
2003/3/3,1245,4504,27,34,1,33,0.986,1.079
2003/3/3,1345,4515,12,21,10,11,0.984,0.861
2003/3/4,945,4450,-11,34,14,20,1,0.672
2003/3/4,1045,4453,2,16,4,12,1.001,2.023
2003/3/4,1145,4461,8,17,8,9,1,1.648
2003/3/4,1245,4466,3,22,18,4,1,1.293
2003/3/4,1345,4469,3,14,0,14,0.999,1.325
2003/3/5,945,4413,13,58,25,33,1.011,0.6
2003/3/5,1045,4413,1,21,9,12,1.009,1.63
2003/3/5,1145,4399,-14,30,13,17,1.011,1.015
2003/3/5,1245,4389,-11,19,15,4,1.012,1.678
2003/3/5,1345,4389,2,18,14,4,1.009,1.196
2003/3/6,945,4413,3,27,10,17,1.002,0.718
2003/3/6,1045,4395,-18,28,18,10,1.006,0.917
2003/3/6,1145,4398,1,14,7,7,1.004,2.364
2003/3/6,1245,4404,7,20,3,17,1.001,1.835
2003/3/6,1345,4397,-7,16,7,9,1.001,1.203
2003/3/7,945,4340,-8,29,10,19,1.013,0.47
2003/3/7,1045,4360,21,48,25,23,1.007,0.614
2003/3/7,1145,4362,2,20,18,2,1.005,1.153
2003/3/7,1245,4361,3,13,4,9,1.004,1.716
2003/3/7,1345,4355,-6,22,10,12,1.005,0.909
2003/3/10,945,4350,-30,40,40,0,1.005,0.901
2003/3/10,1045,4344,-6,16,12,4,1.005,1.241
2003/3/10,1145,4330,-13,19,14,5,1.007,1.332
2003/3/10,1245,4320,-10,22,22,0,1.008,1.73
2003/3/10,1345,4335,12,26,5,21,1.003,1.021
2003/3/11,945,4280,5,33,17,16,1.014,0.667
2003/3/11,1045,4288,8,25,3,22,1.011,0.883
2003/3/11,1145,4288,2,25,19,6,1.009,0.724
2003/3/11,1245,4257,-30,39,32,7,1.015,0.683
2003/3/11,1345,4250,-7,26,7,19,1.014,0.784
2003/3/12,945,4274,14,34,11,23,1.005,0.753
2003/3/12,1045,4275,1,16,13,3,1.003,1.226
2003/3/12,1145,4270,-5,28,15,13,1.003,1.425
2003/3/12,1245,4275,5,21,10,11,1,1.847
2003/3/12,1345,4305,31,41,4,37,0.992,0.9
2003/3/13,945,4292,19,28,3,25,0.995,0.774
2003/3/13,1045,4308,15,21,6,15,0.992,0.996
2003/3/13,1145,4374,66,70,6,64,0.977,0.496
2003/3/13,1245,4361,-12,21,14,7,0.982,1.068
2003/3/13,1345,4353,-7,27,19,8,0.986,1.048
2003/3/14,945,4500,-20,52,40,12,0.96,0.529
2003/3/14,1045,4508,7,22,6,16,0.963,1.396
2003/3/14,1145,4505,-5,16,13,3,0.969,2.162
2003/3/14,1245,4485,-19,30,21,9,0.979,1.793
2003/3/14,1345,4479,-6,22,19,3,0.985,1.275
2003/3/17,945,4415,-5,33,23,10,1.002,1.202
2003/3/17,1045,4409,-7,15,14,1,1.006,2.755
2003/3/17,1145,4390,-20,33,28,5,1.013,1.997
2003/3/17,1245,4368,-22,24,18,6,1.019,1.627
2003/3/17,1345,4318,-51,58,56,2,1.031,0.761
2003/3/18,945,4561,110,158,52,106,0.974,0.495
2003/3/18,1045,4557,-5,32,18,14,0.976,1.394
2003/3/18,1145,4551,-6,23,17,6,0.979,3.078
2003/3/18,1245,4554,4,26,19,7,0.979,2.247
2003/3/18,1345,4538,-16,26,24,2,0.984,2.296
2003/3/19,945,4514,-17,60,38,22,0.992,1.975
2003/3/19,1045,4506,-6,22,9,13,0.996,3.305
2003/3/19,1145,4537,4537,32,-2,34,0.892,4.348
2003/3/19,1245,4500,-37,40,43,-3,0.902,2.58
2003/3/19,1345,4520,21,34,5,29,0.901,1.419
2003/3/20,945,4572,12,56,36,20,0.893,0.232
2003/3/20,1045,4584,12,37,21,16,0.891,0.364
2003/3/20,1145,4528,-56,117,72,45,0.903,0.292
2003/3/20,1245,4559,31,48,9,39,0.896,0.69
2003/3/20,1345,4588,30,30,-3,33,0.891,0.606
2003/3/21,945,4567,-7,26,13,13,0.896,0.969
2003/3/21,1045,4560,-7,23,23,0,0.898,1.959
2003/3/21,1145,4557,-2,17,7,10,0.999,2.063
2003/3/21,1245,4562,6,20,10,10,0.998,3.703
2003/3/21,1345,4580,17,18,-4,22,0.996,1.872
2003/3/24,945,4576,-54,73,53,20,0.998,0.775
2003/3/24,1045,4563,-13,22,20,2,1.001,2.058
2003/3/24,1145,4552,-11,19,17,2,1.003,1.421
2003/3/24,1245,4556,4,14,0,14,1.003,2.04
2003/3/24,1345,4541,-15,23,22,1,1.006,1.035
2003/3/25,945,4488,35,41,6,35,1.015,0.43
2003/3/25,1045,4488,1,13,8,5,1.013,1.249
2003/3/25,1145,4477,-11,26,16,10,1.014,1.207
2003/3/25,1245,4470,-7,16,10,6,1.014,1.441
2003/3/25,1345,4475,4,16,10,6,1.011,0.988
2003/3/26,945,4488,-12,28,26,2,1.005,0.64
2003/3/26,1045,4487,-1,17,5,12,1.003,1.308
2003/3/26,1145,4485,-2,14,7,7,1.002,2.518
2003/3/26,1245,4468,-17,18,18,0,1.004,2.153
2003/3/26,1345,4470,2,13,5,8,1.002,1.346
2003/3/27,945,4464,8,28,6,22,1.003,0.567
2003/3/27,1045,4471,6,24,16,8,1.001,0.692
2003/3/27,1145,4467,-5,13,7,6,1.002,1.896
2003/3/27,1245,4474,6,17,6,11,1,1.99
2003/3/27,1345,4496,21,27,1,26,0.995,0.721
2003/3/28,945,4475,-21,25,20,5,1,0.854
2003/3/28,1045,4450,-25,23,25,-2,1.005,0.804
2003/3/28,1145,4452,1,16,5,11,1.004,0.863
2003/3/28,1245,4452,0,13,9,4,1.003,1.753
2003/3/28,1345,4453,2,29,21,8,1.002,0.708
2003/3/31,945,4373,-37,42,37,5,1.02,0.426
2003/3/31,1045,4357,-18,25,19,6,1.021,0.883
2003/3/31,1145,4310,-46,61,47,14,1.03,0.8
2003/3/31,1245,4296,-12,24,13,11,1.03,0.982
2003/3/31,1345,4286,-10,32,10,22,1.028,0.938
2003/4/1,945,4292,31,27,8,19,1.021,0.751
2003/4/1,1045,4289,-3,18,2,16,1.017,2.039
2003/4/1,1145,4290,2,15,6,9,1.013,2.452
2003/4/1,1245,4287,-3,12,8,4,1.01,2.39
2003/4/1,1345,4301,14,16,2,14,1.003,1.502
2003/4/2,945,4273,-12,26,21,5,1.007,0.794
2003/4/2,1045,4258,-15,24,16,8,1.008,0.952
2003/4/2,1145,4280,22,21,0,21,1,1.302
2003/4/2,1245,4301,20,57,31,26,0.995,0.425
2003/4/2,1345,4295,-6,24,10,14,0.996,0.941
2003/4/3,945,4361,-22,37,27,10,0.984,0.533
2003/4/3,1045,4343,-18,21,20,1,0.99,1.084
2003/4/3,1145,4333,-10,22,16,6,0.993,1.258
2003/4/3,1245,4335,0,12,5,7,0.994,2.26
2003/4/3,1345,4338,5,25,9,16,0.994,1.329
2003/4/4,945,4316,8,26,7,19,1,1.1
2003/4/4,1045,4353,38,46,9,37,0.992,0.788
2003/4/4,1145,4376,23,45,9,36,0.989,0.662
2003/4/4,1245,4470,94,93,1,92,0.971,0.492
2003/4/4,1345,4469,3,28,12,16,0.975,0.684
2003/4/7,945,4510,9,59,14,45,0.968,0.614
2003/4/7,1045,4526,15,41,24,17,0.968,0.953
2003/4/7,1145,4551,26,43,7,36,0.967,1.149
2003/4/7,1245,4575,23,33,7,26,0.966,1.378
2003/4/7,1345,4572,-3,25,5,20,0.972,1.33
2003/4/8,945,4558,75,67,-3,70,0.979,0.921
2003/4/8,1045,4545,-12,35,27,8,0.987,1.402
2003/4/8,1145,4576,31,57,29,28,0.985,0.976
2003/4/8,1245,4536,-40,40,39,1,0.998,1.404
2003/4/8,1345,4547,11,23,2,21,0.997,1.522
2003/4/9,945,4497,-18,34,28,6,1.009,0.94
2003/4/9,1045,4495,-5,20,18,2,1.009,1.985
2003/4/9,1145,4515,20,21,-1,22,1.004,2.546
2003/4/9,1245,4502,-11,20,20,0,1.006,1.628
2003/4/9,1345,4505,4,20,10,10,1.003,1.432
2003/4/10,945,4533,41,57,7,50,0.997,0.607
2003/4/10,1045,4557,24,52,28,24,0.992,0.599
2003/4/10,1145,4537,-21,26,22,4,0.996,1.007
2003/4/10,1245,4522,-14,39,21,18,0.999,0.776
2003/4/10,1345,4511,-11,26,7,19,1.001,1.032
2003/4/11,945,4540,15,53,6,47,0.995,0.868
2003/4/11,1045,4510,-32,44,45,-1,1.002,0.861
2003/4/11,1145,4518,8,21,10,11,1.001,2.67
2003/4/11,1245,4519,-3,24,21,3,1.001,1.974
2003/4/11,1345,4516,-4,22,9,13,1.002,1.573
2003/4/14,945,4480,-41,74,69,5,1.01,0.735
2003/4/14,1045,4457,-24,25,18,7,1.014,0.893
2003/4/14,1145,4431,-26,29,24,5,1.018,0.914
2003/4/14,1245,4433,4,14,10,4,1.015,1.802
2003/4/14,1345,4449,16,17,3,14,1.01,1.714
2003/4/15,945,4452,-27,43,36,7,1.008,1.309
2003/4/15,1045,4460,7,24,10,14,1.004,2.831
2003/4/15,1145,4453,-8,14,10,4,1.005,3.757
2003/4/15,1245,4465,12,15,0,15,1,3.073
2003/4/15,1345,4475,11,18,6,12,0.997,1.179
2003/4/16,945,4554,44,31,6,25,0.979,0.72
2003/4/16,1045,4580,26,33,1,32,0.975,1.037
2003/4/16,1145,4591,7,18,-1,19,0.976,1.388
2003/4/16,1245,4625,34,34,2,32,0.972,1.21
2003/4/16,1345,4625,0,25,3,22,0.976,0.929
2003/4/17,945,4558,5,34,21,13,0.992,0.278
2003/4/17,1045,4554,-4,17,9,8,0.995,0.875
2003/4/17,1145,4556,2,12,7,5,0.997,2.285
2003/4/17,1245,4555,0,19,4,15,0.999,1.074
2003/4/17,1345,4557,1,17,6,11,1.001,1.052
2003/4/18,945,4655,16,53,20,33,0.983,0.365
2003/4/18,1045,4649,-6,25,16,9,0.986,0.903
2003/4/18,1145,4663,15,18,-2,20,0.985,1.723
2003/4/18,1245,4664,1,13,2,11,0.986,1.816
2003/4/18,1345,4660,-3,26,11,15,0.988,0.955
2003/4/21,945,4622,-28,36,26,10,0.998,0.596
2003/4/21,1045,4627,5,15,2,13,0.998,1.495
2003/4/21,1145,4631,6,17,11,6,0.999,1.539
2003/4/21,1245,4631,0,9,4,5,1,2.791
2003/4/21,1345,4657,26,26,0,26,0.996,0.987
2003/4/22,945,4588,-32,42,29,13,1.011,0.452
2003/4/22,1045,4566,-23,26,24,2,1.014,0.898
2003/4/22,1145,4571,5,12,2,10,1.012,1.5
2003/4/22,1245,4567,-4,18,10,8,1.01,1.443
2003/4/22,1345,4571,5,11,0,11,1.007,1.043
2003/4/23,945,4574,-26,53,45,8,1.006,0.447
2003/4/23,1045,4568,-6,14,16,-2,1.006,1.456
2003/4/23,1145,4563,-5,23,12,11,1.006,1.318
2003/4/23,1245,4583,20,30,5,25,1,1.194
2003/4/23,1345,4570,-13,12,14,-2,1.002,1.595
2003/4/24,945,4432,-148,138,146,-8,1.032,0.331
2003/4/24,1045,4423,-13,34,23,11,1.031,0.623
2003/4/24,1145,4346,-77,100,76,24,1.046,0.688
2003/4/24,1245,4356,10,21,10,11,1.038,1.788
2003/4/24,1345,4356,-1,20,11,9,1.033,1.375
2003/4/25,945,4297,-3,56,21,35,1.04,0.603
2003/4/25,1045,4291,-6,58,55,3,1.035,0.866
2003/4/25,1145,4285,-7,34,24,10,1.03,1.651
2003/4/25,1245,4240,-45,66,52,14,1.035,1.067
2003/4/25,1345,4211,-31,52,54,-2,1.034,1.371
2003/4/28,945,4087,-84,119,92,27,1.055,0.536
2003/4/28,1045,4118,30,53,17,36,1.039,1.1
2003/4/28,1145,4109,-10,46,43,3,1.034,1.416
2003/4/28,1245,4118,8,39,11,28,1.026,1.747
2003/4/28,1345,4125,7,42,40,2,1.018,1.058
2003/4/29,945,4174,-9,41,19,22,1.003,0.765
2003/4/29,1045,4190,16,41,18,23,0.997,1.1
2003/4/29,1145,4159,-30,34,34,0,1.002,1.796
2003/4/29,1245,4125,-34,59,44,15,1.007,1.25
2003/4/29,1345,4195,68,65,-6,71,0.987,0.884
2003/4/30,945,4180,-55,89,75,14,0.992,0.508
2003/4/30,1045,4168,-12,46,29,17,0.997,1.103
2003/4/30,1145,4160,-7,44,35,9,1.001,1.303
2003/4/30,1245,4111,-49,55,49,6,1.014,1.06
2003/4/30,1345,4135,21,29,5,24,1.008,1.19
2003/5/2,945,4133,28,72,45,27,1.006,0.694
2003/5/2,1045,4132,-1,22,25,-3,1.006,2.058
2003/5/2,1145,4147,14,23,6,17,1.001,2.084
2003/5/2,1245,4184,37,41,3,38,0.991,1.399
2003/5/2,1345,4189,5,34,26,8,0.992,0.96
2003/5/5,945,4187,-13,65,11,54,0.991,0.602
2003/5/5,1045,4170,-20,35,28,7,0.995,1.329
2003/5/5,1145,4186,15,44,18,26,0.992,1.582
2003/5/5,1245,4192,7,32,12,20,0.991,1.839
2003/5/5,1345,4190,-3,25,17,8,0.993,1.372
2003/5/6,945,4230,25,57,7,50,0.986,0.673
2003/5/6,1045,4220,-10,36,23,13,0.991,0.924
2003/5/6,1145,4194,-26,32,26,6,0.999,1.298
2003/5/6,1245,4188,-5,19,16,3,1.002,1.779
2003/5/6,1345,4185,-3,17,19,-2,1.002,1.929
2003/5/7,945,4198,-7,42,37,5,1,0.538
2003/5/7,1045,4211,14,20,4,16,0.997,1.241
2003/5/7,1145,4217,8,16,-1,17,0.996,1.917
2003/5/7,1245,4237,19,31,5,26,0.992,0.974
2003/5/7,1345,4245,8,24,7,17,0.991,0.765
2003/5/8,945,4179,-53,69,52,17,1.008,0.486
2003/5/8,1045,4174,-5,17,13,4,1.008,1.19
2003/5/8,1145,4180,6,14,8,6,1.005,2.316
2003/5/8,1245,4173,-7,13,12,1,1.006,2.322
2003/5/8,1345,4165,-8,27,18,9,1.008,1.093
2003/5/9,945,4178,21,29,8,21,1.004,0.752
2003/5/9,1045,4212,33,46,13,33,0.995,0.587
2003/5/9,1145,4235,23,34,0,34,0.99,0.996
2003/5/9,1245,4239,5,31,20,11,0.989,0.878
2003/5/9,1345,4224,-14,33,26,7,0.993,1.105
2003/5/12,945,4285,60,69,-5,74,0.979,0.581
2003/5/12,1045,4267,-18,29,19,10,0.985,1.215
2003/5/12,1145,4273,5,15,2,13,0.986,2.891
2003/5/12,1245,4256,-17,33,21,12,0.992,1.776
2003/5/12,1345,4245,-11,31,19,12,0.997,1.204
2003/5/13,945,4320,22,41,19,22,0.983,0.519
2003/5/13,1045,4332,13,21,10,11,0.983,1.147
2003/5/13,1145,4331,-1,15,5,10,0.986,2.487
2003/5/13,1245,4315,-15,15,15,0,0.992,1.694
2003/5/13,1345,4316,0,15,2,13,0.994,0.939
2003/5/14,945,4306,-11,36,22,14,0.998,0.687
2003/5/14,1045,4320,15,27,14,13,0.995,1.272
2003/5/14,1145,4328,8,13,2,11,0.995,3.01
2003/5/14,1245,4313,-16,22,15,7,0.999,1.821
2003/5/14,1345,4338,24,22,-3,25,0.995,1.34
2003/5/15,945,4280,-34,54,44,10,1.009,0.386
2003/5/15,1045,4284,4,10,4,6,1.007,1.405
2003/5/15,1145,4290,5,15,0,15,1.004,2.082
2003/5/15,1245,4300,10,24,5,19,1.001,1.271
2003/5/15,1345,4324,23,24,1,23,0.995,0.734
2003/5/16,945,4323,-12,58,43,15,0.996,0.514
2003/5/16,1045,4317,-6,23,9,14,0.998,1.742
2003/5/16,1145,4298,-19,32,26,6,1.002,1.346
2003/5/16,1245,4295,-3,15,10,5,1.002,1.631
2003/5/16,1345,4260,-35,43,43,0,1.01,0.863
2003/5/19,945,4225,-10,35,29,6,1.016,0.62
2003/5/19,1045,4214,-13,20,22,-2,1.018,1.52
2003/5/19,1145,4234,19,22,1,21,1.011,2.811
2003/5/19,1245,4237,3,20,8,12,1.009,2.219
2003/5/19,1345,4239,4,18,11,7,1.007,1.631
2003/5/20,945,4214,21,50,5,45,1.01,0.784
2003/5/20,1045,4231,19,25,-1,26,1.003,2.081
2003/5/20,1145,4222,-9,14,9,5,1.003,3.073
2003/5/20,1245,4228,7,8,2,6,1,4.796
2003/5/20,1345,4226,-2,19,17,2,0.999,1.552
2003/5/21,945,4223,-8,34,24,10,0.999,1.119
2003/5/21,1045,4228,5,14,12,2,0.998,2.173
2003/5/21,1145,4221,-8,11,10,1,1,1.942
2003/5/21,1245,4220,0,12,5,7,1,1.111
2003/5/21,1345,4240,21,11,-11,22,0.995,0.587
2003/5/22,945,4208,13,50,7,43,1.003,0.237
2003/5/22,1045,4222,14,30,12,18,0.999,0.325
2003/5/22,1145,4235,13,18,4,14,0.996,0.637
2003/5/22,1245,4227,-8,16,12,4,0.998,1.398
2003/5/22,1345,4241,13,17,4,13,0.995,0.826
2003/5/23,945,4294,19,34,1,33,0.984,0.47
2003/5/23,1045,4317,23,36,3,33,0.98,0.608
2003/5/23,1145,4322,6,30,22,8,0.981,0.917
2003/5/23,1245,4333,10,20,2,18,0.981,2.09
2003/5/23,1345,4340,7,18,0,18,0.982,1.688
2003/5/26,945,4407,49,70,8,62,0.971,0.659
2003/5/26,1045,4403,-4,24,6,18,0.976,1.374
2003/5/26,1145,4411,8,17,8,9,0.978,1.316
2003/5/26,1245,4418,7,21,6,15,0.981,1.761
2003/5/26,1345,4444,26,27,3,24,0.979,0.926
2003/5/27,945,4436,-16,39,24,15,0.985,0.778
2003/5/27,1045,4431,-5,21,12,9,0.989,1.701
2003/5/27,1145,4440,8,17,7,10,0.99,1.747
2003/5/27,1245,4430,-9,24,9,15,0.995,1.538
2003/5/27,1345,4434,4,9,1,8,0.996,1.975
2003/5/28,945,4509,-81,54,50,4,0.985,0.394
2003/5/28,1045,4492,-20,32,23,9,0.991,0.771
2003/5/28,1145,4469,-22,27,31,-4,0.998,1.125
2003/5/28,1245,4487,16,25,3,22,0.995,1.337
2003/5/28,1345,4485,-2,20,3,17,0.997,1.236
2003/5/29,945,4483,13,43,15,28,0.998,0.814
2003/5/29,1045,4475,-8,18,16,2,1.001,1.83
2003/5/29,1145,4475,0,12,5,7,1.002,2.984
2003/5/29,1245,4480,5,14,5,9,1.001,2.903
2003/5/29,1345,4453,-27,40,32,8,1.009,0.58
2003/5/30,945,4525,56,79,10,69,0.99,0.396
2003/5/30,1045,4542,14,36,2,34,0.986,0.702
2003/5/30,1145,4560,15,61,42,19,0.984,0.482
2003/5/30,1245,4519,-41,62,45,17,0.995,0.67
2003/5/30,1345,4510,-10,28,23,5,0.997,0.991
2003/6/2,945,4588,29,36,10,26,0.982,0.749
2003/6/2,1045,4608,20,48,22,26,0.98,0.988
2003/6/2,1145,4627,18,35,11,24,0.979,1.51
2003/6/2,1245,4649,21,40,7,33,0.978,1.306
2003/6/2,1345,4665,18,25,5,20,0.978,1.152
2003/6/3,945,4647,-3,42,11,31,0.986,1.105
2003/6/3,1045,4646,0,24,18,6,0.989,1.819
2003/6/3,1145,4653,6,26,4,22,0.989,3.371
2003/6/3,1245,4641,-14,19,11,8,0.994,2.517
2003/6/3,1345,4658,18,26,0,26,0.993,1.427
2003/6/5,945,4725,19,41,23,18,0.982,0.619
2003/6/5,1045,4706,-20,49,34,15,0.989,0.849
2003/6/5,1145,4710,5,22,9,13,0.99,1.781
2003/6/5,1245,4698,-12,27,24,3,0.994,1.379
2003/6/5,1345,4725,27,31,0,31,0.99,1.11
2003/6/6,945,4700,-35,38,29,9,0.997,0.729
2003/6/6,1045,4685,-15,32,24,8,1.001,0.797
2003/6/6,1145,4700,16,32,16,16,0.999,1.026
2003/6/6,1245,4708,8,23,2,21,0.998,1.741
2003/6/6,1345,4732,24,27,-3,30,0.994,1.166
2003/6/9,945,4702,19,41,14,27,1,0.741
2003/6/9,1045,4768,65,97,9,88,0.986,0.548
2003/6/9,1145,4781,15,40,18,22,0.984,0.67
2003/6/9,1245,4777,-4,40,33,7,0.987,0.965
2003/6/9,1345,4800,23,27,7,20,0.984,1.005
2003/6/10,945,4790,24,35,11,24,0.986,0.876
2003/6/10,1045,4780,-8,23,15,8,0.99,1.529
2003/6/10,1145,4793,13,19,6,13,0.99,2.247
2003/6/10,1245,4812,19,37,12,25,0.988,1.129
2003/6/10,1345,4821,10,23,11,12,0.988,1.335
2003/6/11,945,4824,3,45,21,24,0.99,0.646
2003/6/11,1045,4818,-4,40,3,37,0.994,0.946
2003/6/11,1145,4814,-4,18,10,8,0.996,1.706
2003/6/11,1245,4813,-1,27,10,17,0.997,1.8
2003/6/11,1345,4795,-19,33,25,8,1.001,1.044
2003/6/12,945,4828,8,22,5,17,0.995,0.776
2003/6/12,1045,4863,35,82,42,40,0.989,0.476
2003/6/12,1145,4883,20,30,6,24,0.987,1.453
2003/6/12,1245,4877,-7,22,8,14,0.99,1.806
2003/6/12,1345,4881,2,14,9,5,0.99,1.234
2003/6/13,945,4873,3,41,21,20,0.993,0.87
2003/6/13,1045,4872,-1,17,13,4,0.994,1.75
2003/6/13,1145,4898,25,28,0,28,0.99,1.562
2003/6/13,1245,4890,-8,19,10,9,0.993,1.696
2003/6/13,1345,4890,1,22,5,17,0.995,1.303
2003/6/16,945,4886,17,23,3,20,0.997,1.281
2003/6/16,1045,4898,11,21,5,16,0.996,1.455
2003/6/16,1145,4923,23,38,12,26,0.991,0.805
2003/6/16,1245,4927,5,36,11,25,0.991,1.091
2003/6/16,1345,4903,-22,32,25,7,0.997,0.968
2003/6/17,945,4978,-11,28,11,17,0.984,0.682
2003/6/17,1045,4973,-7,24,15,9,0.987,1.553
2003/6/17,1145,4979,4,22,8,14,0.988,1.519
2003/6/17,1245,4987,8,30,18,12,0.988,1.329
2003/6/17,1345,5037,49,14,-45,59,0.981,1.326
2003/6/18,945,5036,16,28,8,20,0.984,1.354
2003/6/18,1045,5050,15,26,9,17,0.984,2.064
2003/6/18,1145,5070,20,19,2,17,0.983,1.651
2003/6/18,1245,5093,23,56,30,26,0.981,1.008
2003/6/18,1345,5015,-79,96,82,14,1,0.726
2003/6/19,945,5035,5,53,14,39,0.997,0.353
2003/6/19,1045,4995,-40,74,44,30,1.006,0.475
2003/6/19,1145,5018,21,49,4,45,1.002,0.67
2003/6/19,1245,5040,21,36,-1,37,0.998,0.946
2003/6/19,1345,5069,29,39,-3,42,0.994,0.673
2003/6/20,945,5046,21,37,9,28,0.998,0.619
2003/6/20,1045,5013,-33,41,31,10,1.005,0.804
2003/6/20,1145,5031,19,33,11,22,1.001,1.792
2003/6/20,1245,5016,-15,36,26,10,1.003,1.56
2003/6/20,1345,5019,1,30,4,26,1.001,0.998
2003/6/23,945,4990,-5,45,35,10,1.006,0.95
2003/6/23,1045,4987,-3,20,18,2,1.006,1.831
2003/6/23,1145,5000,9,14,-1,15,1.003,2.251
2003/6/23,1245,4950,-50,53,50,3,1.013,0.913
2003/6/23,1345,4925,-27,25,25,0,1.016,0.693
2003/6/24,945,4904,19,29,-4,33,1.017,0.698
2003/6/24,1045,4889,-15,20,17,3,1.018,1.211
2003/6/24,1145,4874,-14,35,16,19,1.018,0.814
2003/6/24,1245,4872,-2,18,12,6,1.015,1.568
2003/6/24,1345,4906,34,42,2,40,1.005,0.863
2003/6/25,945,4900,14,40,15,25,1.004,0.905
2003/6/25,1045,4892,-8,26,18,8,1.004,1.718
2003/6/25,1145,4903,10,21,1,20,1,2.301
2003/6/25,1245,4935,32,45,10,35,0.992,0.63
2003/6/25,1345,4940,7,24,9,15,0.99,1.046
2003/6/26,945,4910,-1,29,15,14,0.997,0.734
2003/6/26,1045,4915,5,21,10,11,0.996,1.635
2003/6/26,1145,4914,-1,14,5,9,0.997,2.02
2003/6/26,1245,4914,1,19,11,8,0.997,1.701
2003/6/26,1345,4885,-30,42,33,9,1.004,0.692
2003/6/27,945,4909,-16,41,33,8,1,0.594
2003/6/27,1045,4913,4,27,7,20,0.999,1.249
2003/6/27,1145,4908,-4,16,7,9,1.001,1.661
2003/6/27,1245,4858,-50,51,51,0,1.011,0.804
2003/6/27,1345,4861,4,42,6,36,1.009,0.611
2003/6/30,945,4865,25,36,4,32,1.007,0.926
2003/6/30,1045,4883,18,31,-1,32,1.002,1.853
2003/6/30,1145,4887,4,23,3,20,1.001,1.079
2003/6/30,1245,4871,-14,18,17,1,1.003,1.569
2003/6/30,1345,4885,15,29,4,25,1,0.898
2003/7/1,945,4932,57,68,9,59,0.989,0.581
2003/7/1,1045,4973,45,54,10,44,0.981,0.551
2003/7/1,1145,4983,10,30,8,22,0.981,1.006
2003/7/1,1245,5011,28,33,2,31,0.977,1.259
2003/7/1,1345,5038,26,35,6,29,0.974,0.768
2003/7/2,945,5077,5,46,29,17,0.971,0.586
2003/7/2,1045,5111,33,58,22,36,0.969,0.981
2003/7/2,1145,5131,20,39,3,36,0.97,1.607
2003/7/2,1245,5140,9,27,9,18,0.973,1.187
2003/7/2,1345,5140,1,33,16,17,0.978,1.099
2003/7/3,945,5180,-14,39,30,9,0.977,0.625
2003/7/3,1045,5165,-14,59,15,44,0.984,0.803
2003/7/3,1145,5172,7,26,1,25,0.987,1.633
2003/7/3,1245,5169,-1,26,17,9,0.991,1.4
2003/7/3,1345,5122,-46,62,51,11,1.003,0.796
2003/7/4,945,5129,-10,48,19,29,1.003,0.794
2003/7/4,1045,5122,-5,31,11,20,1.005,1.637
2003/7/4,1145,5140,19,34,4,30,1.002,1.449
2003/7/4,1245,5175,35,37,-3,40,0.995,1.092
2003/7/4,1345,5191,20,46,5,41,0.993,1.071
2003/7/7,945,5233,15,30,17,13,0.986,0.769
2003/7/7,1045,5260,27,32,5,27,0.981,1.112
2003/7/7,1145,5305,45,53,5,48,0.975,0.89
2003/7/7,1245,5330,25,44,11,33,0.973,0.896
2003/7/7,1345,5370,38,52,-3,55,0.969,0.91
2003/7/8,945,5386,-24,71,46,25,0.971,0.53
2003/7/8,1045,5360,-27,53,37,16,0.98,0.989
2003/7/8,1145,5385,27,32,3,29,0.98,2.007
2003/7/8,1245,5376,-10,49,42,7,0.986,1.033
2003/7/8,1345,5382,6,36,15,21,0.989,1.106
2003/7/9,945,5379,20,36,9,27,0.992,1.046
2003/7/9,1045,5360,-19,28,21,7,0.999,1.408
2003/7/9,1145,5390,30,34,4,30,0.995,1.364
2003/7/9,1245,5390,1,33,5,28,0.996,1.224
2003/7/9,1345,5375,-16,32,28,4,1,1.239
2003/7/10,945,5383,18,34,7,27,0.998,0.911
2003/7/10,1045,5317,-67,92,76,16,1.01,0.658
2003/7/10,1145,5266,-51,61,60,1,1.019,0.65
2003/7/10,1245,5285,19,26,3,23,1.013,1.087
2003/7/10,1345,5250,-35,39,39,0,1.018,1.24
2003/7/11,945,5205,-1,40,15,25,1.024,0.735
2003/7/11,1045,5204,-1,30,12,18,1.021,1.618
2003/7/11,1145,5189,-15,31,16,15,1.021,1.42
2003/7/11,1245,5204,15,16,-2,18,1.014,1.973
2003/7/11,1345,5265,61,66,2,64,0.999,0.891
2003/7/14,945,5297,32,50,23,27,0.991,0.952
2003/7/14,1045,5380,82,80,-5,85,0.974,0.87
2003/7/14,1145,5392,7,41,16,25,0.973,0.885
2003/7/14,1245,5410,18,48,23,25,0.972,0.988
2003/7/14,1345,5412,2,42,0,42,0.974,1.139
2003/7/15,945,5401,-21,52,27,25,0.98,1.302
2003/7/15,1045,5401,1,26,3,23,0.984,2.789
2003/7/15,1145,5385,-17,49,50,-1,0.991,1.401
2003/7/15,1245,5394,9,17,1,16,0.993,2.231
2003/7/15,1345,5328,-66,79,71,8,1.008,0.992
2003/7/16,945,5380,24,47,0,47,1,1.968
2003/7/16,1045,5405,20,45,20,25,0.997,1.299
2003/7/16,1145,5417,13,45,26,19,0.995,1.586
2003/7/16,1245,5417,1,38,6,32,0.996,2.57
2003/7/16,1345,5429,12,52,4,48,0.994,1.326
2003/7/17,945,5342,-18,59,17,42,1.009,0.319
2003/7/17,1045,5355,13,55,33,22,1.005,0.519
2003/7/17,1145,5335,-19,42,31,11,1.008,0.847
2003/7/17,1245,5287,-48,46,49,-3,1.016,0.559
2003/7/17,1345,5251,-36,45,39,6,1.021,0.507
2003/7/18,945,5263,12,61,19,42,1.017,0.717
2003/7/18,1045,5248,-14,53,30,23,1.018,1.007
2003/7/18,1145,5283,36,46,7,39,1.008,1.044
2003/7/18,1245,5284,0,43,14,29,1.005,1.274
2003/7/18,1345,5255,-28,38,29,9,1.008,1.161
2003/7/21,945,5273,-9,50,42,8,1.003,0.909
2003/7/21,1045,5230,-43,82,58,24,1.01,0.877
2003/7/21,1145,5232,3,29,13,16,1.007,1.878
2003/7/21,1245,5212,-21,36,34,2,1.009,1.358
2003/7/21,1345,5239,27,29,-14,43,1.003,1.21
2003/7/22,945,5235,-4,27,14,13,1.003,0.84
2003/7/22,1045,5250,13,36,25,11,1,0.791
2003/7/22,1145,5224,-26,50,41,9,1.005,0.995
2003/7/22,1245,5247,23,30,-2,32,0.999,1.448
2003/7/22,1345,5293,46,50,4,46,0.99,0.725
2003/7/23,945,5304,-6,47,26,21,0.988,0.724
2003/7/23,1045,5332,26,36,12,24,0.984,0.727
2003/7/23,1145,5313,-22,37,31,6,0.989,1.069
2003/7/23,1245,5298,-15,32,27,5,0.994,1.582
2003/7/23,1345,5307,8,29,7,22,0.994,1.502
2003/7/24,945,5357,32,52,10,42,0.986,0.741
2003/7/24,1045,5389,32,32,5,27,0.982,0.775
2003/7/24,1145,5372,-17,35,14,21,0.988,1.202
2003/7/24,1245,5380,8,23,14,9,0.989,1.301
2003/7/24,1345,5415,36,30,-2,32,0.985,1.142
2003/7/25,945,5388,8,45,22,23,0.992,0.982
2003/7/25,1045,5383,-5,22,10,12,0.994,2.145
2003/7/25,1145,5400,17,21,2,19,0.992,1.889
2003/7/25,1245,5408,8,21,7,14,0.992,1.584
2003/7/25,1345,5384,-24,43,30,13,0.998,1.032
2003/7/28,945,5476,22,38,21,17,0.984,0.63
2003/7/28,1045,5479,3,20,5,15,0.986,1.167
2003/7/28,1145,5485,5,18,9,9,0.986,1.56
2003/7/28,1245,5481,-5,14,7,7,0.989,2.171
2003/7/28,1345,5475,-7,29,10,19,0.992,0.985
2003/7/29,945,5383,-84,96,84,12,1.011,0.421
2003/7/29,1045,5366,-17,51,27,24,1.014,0.647
2003/7/29,1145,5347,-18,20,24,-4,1.017,1.041
2003/7/29,1245,5336,-11,26,23,3,1.018,1.907
2003/7/29,1345,5355,19,39,23,16,1.013,1.088
2003/7/30,945,5294,-51,94,80,14,1.023,0.662
2003/7/30,1045,5315,24,40,9,31,1.015,1.02
2003/7/30,1145,5318,3,30,12,18,1.011,1.988
2003/7/30,1245,5309,-10,37,36,1,1.01,1.531
2003/7/30,1345,5308,0,34,19,15,1.007,1.125
2003/7/31,945,5329,17,52,-4,56,1,0.794
2003/7/31,1045,5305,-24,38,30,8,1.004,1.254
2003/7/31,1145,5300,-4,40,5,35,1.003,0.856
2003/7/31,1245,5314,14,45,19,26,1,0.952
2003/7/31,1345,5330,14,44,9,35,0.996,1.082
2003/8/1,945,5392,33,37,0,37,0.985,0.574
2003/8/1,1045,5379,-12,19,15,4,0.99,1.259
2003/8/1,1145,5396,17,25,10,15,0.988,1.046
2003/8/1,1245,5392,-4,32,18,14,0.99,1.526
2003/8/1,1345,5390,-2,31,18,13,0.992,1.097
2003/8/4,945,5362,2,34,12,22,0.998,0.826
2003/8/4,1045,5351,-11,33,19,14,1,1.32
2003/8/4,1145,5359,8,17,8,9,1,3.093
2003/8/4,1245,5365,5,21,7,14,1,1.934
2003/8/4,1345,5370,5,13,8,5,1,1.455
2003/8/5,945,5322,-67,110,88,22,1.009,0.425
2003/8/5,1045,5292,-29,45,26,19,1.014,0.56
2003/8/5,1145,5277,-15,35,28,7,1.015,1.199
2003/8/5,1245,5284,8,18,5,13,1.011,1.966
2003/8/5,1345,5269,-15,37,26,11,1.012,1.098
2003/8/6,945,5233,23,27,2,25,1.016,0.755
2003/8/6,1045,5216,-17,21,19,2,1.017,1.547
2003/8/6,1145,5229,13,17,3,14,1.012,2.721
2003/8/6,1245,5232,3,8,2,6,1.009,3.893
2003/8/6,1345,5242,11,27,-2,29,1.004,1.265
2003/8/7,945,5207,-28,60,60,0,1.008,0.64
2003/8/7,1045,5218,13,28,-2,30,1.004,0.583
2003/8/7,1145,5260,42,52,10,42,0.995,0.586
2003/8/7,1245,5284,24,38,14,24,0.99,0.732
2003/8/7,1345,5281,-3,25,9,16,0.99,1.018
2003/8/8,945,5281,0,32,12,20,0.992,0.923
2003/8/8,1045,5276,-5,18,18,0,0.993,1.279
2003/8/8,1145,5245,-31,37,37,0,1,1.088
2003/8/8,1245,5248,3,20,11,9,1,1.638
2003/8/8,1345,5206,-41,42,46,-4,1.009,0.873
2003/8/11,945,5180,-20,51,35,16,1.013,0.951
2003/8/11,1045,5202,24,39,14,25,1.008,1.159
2003/8/11,1145,5200,-1,22,15,7,1.008,1.957
2003/8/11,1245,5207,8,26,8,18,1.006,2.026
2003/8/11,1345,5251,43,38,-5,43,0.996,0.946
2003/8/12,945,5263,3,30,11,19,0.993,0.79
2003/8/12,1045,5256,-6,30,19,11,0.994,0.985
2003/8/12,1145,5264,8,25,1,24,0.992,1.123
2003/8/12,1245,5263,-1,27,9,18,0.993,1.207
2003/8/12,1345,5265,2,15,10,5,0.993,1.195
2003/8/13,945,5368,53,68,12,56,0.976,0.367
2003/8/13,1045,5394,27,48,9,39,0.975,0.59
2003/8/13,1145,5418,23,18,-8,26,0.974,1.478
2003/8/13,1245,5462,47,53,3,50,0.97,0.884
2003/8/13,1345,5471,7,28,9,19,0.973,0.898
2003/8/14,945,5470,6,46,13,33,0.977,0.789
2003/8/14,1045,5469,-2,22,7,15,0.981,1.908
2003/8/14,1145,5463,-5,37,30,7,0.986,1.164
2003/8/14,1245,5431,-35,49,38,11,0.995,0.959
2003/8/14,1345,5466,35,32,-6,38,0.992,1.329
2003/8/15,945,5540,50,69,20,49,0.982,0.589
2003/8/15,1045,5510,-31,65,30,35,0.991,0.852
2003/8/15,1145,5517,5,33,12,21,0.991,1.627
2003/8/15,1245,5501,-16,33,17,16,0.996,1.627
2003/8/15,1345,5490,-11,31,23,8,0.999,1.304
2003/8/18,945,5498,-33,48,45,3,0.999,0.993
2003/8/18,1045,5501,4,34,3,31,0.998,1.366
2003/8/18,1145,5498,-3,25,19,6,1,2.374
2003/8/18,1245,5534,37,39,-1,40,0.994,2.278
2003/8/18,1345,5539,5,25,-5,30,0.995,1.307
2003/8/19,945,5596,-44,48,37,11,0.987,0.866
2003/8/19,1045,5580,-16,35,28,7,0.991,1.504
2003/8/19,1145,5581,1,21,16,5,0.992,2.148
2003/8/19,1245,5557,-22,44,28,16,0.997,1.238
2003/8/19,1345,5555,-3,38,4,34,0.999,1.318
2003/8/20,945,5542,-1,42,25,17,1.001,1.582
2003/8/20,1045,5548,7,22,5,17,1.001,3.13
2003/8/20,1145,5556,8,10,-1,11,1.001,2.789
2003/8/20,1245,5539,-16,24,23,1,1.005,2.066
2003/8/20,1345,5520,-17,17,34,-17,1.008,1.15
2003/8/21,945,5527,-18,42,18,24,1.005,0.306
2003/8/21,1045,5529,2,23,2,21,1.004,0.654
2003/8/21,1145,5573,43,57,12,45,0.995,0.328
2003/8/21,1245,5623,48,57,2,55,0.986,0.49
2003/8/21,1345,5611,-12,40,25,15,0.989,0.514
2003/8/22,945,5655,31,76,33,43,0.983,0.503
2003/8/22,1045,5653,-2,24,14,10,0.985,1.36
2003/8/22,1145,5641,-14,35,31,4,0.989,1.354
2003/8/22,1245,5641,0,35,7,28,0.991,1.2
2003/8/22,1345,5613,-27,26,35,-9,0.997,1.571
2003/8/25,945,5630,21,55,30,25,0.996,0.849
2003/8/25,1045,5620,-8,54,27,27,0.999,1.002
2003/8/25,1145,5635,14,21,3,18,0.998,2.176
2003/8/25,1245,5653,19,30,2,28,0.996,1.243
2003/8/25,1345,5665,12,39,9,30,0.994,0.92
2003/8/26,945,5585,-45,52,53,-1,1.009,0.582
2003/8/26,1045,5580,-4,25,5,20,1.008,0.88
2003/8/26,1145,5570,-8,29,14,15,1.009,0.89
2003/8/26,1245,5560,-10,14,17,-3,1.009,2.533
2003/8/26,1345,5580,19,32,-6,38,1.004,1.007
2003/8/27,945,5566,-14,28,24,4,1.006,1.04
2003/8/27,1045,5585,19,22,-3,25,1.002,1.62
2003/8/27,1145,5583,-2,26,23,3,1.001,0.922
2003/8/27,1245,5583,0,18,6,12,1.001,1.82
2003/8/27,1345,5548,-35,37,36,1,1.006,1.109
2003/8/28,945,5586,27,36,2,34,0.998,0.784
2003/8/28,1045,5560,-26,39,34,5,1.002,1.085
2003/8/28,1145,5533,-27,42,34,8,1.007,0.982
2003/8/28,1245,5541,7,20,10,10,1.005,1.898
2003/8/28,1345,5548,6,40,12,28,1.003,0.728
2003/8/29,945,5594,4,32,11,21,0.995,0.566
2003/8/29,1045,5608,14,30,9,21,0.993,0.686
2003/8/29,1145,5654,48,47,-1,48,0.985,0.658
2003/8/29,1245,5646,-9,27,12,15,0.988,1.4
2003/8/29,1345,5668,22,33,10,23,0.985,0.899
2003/9/1,945,5682,-8,41,41,0,0.985,0.779
2003/9/1,1045,5687,7,35,16,19,0.986,1.77
2003/9/1,1145,5695,8,34,23,11,0.987,1.703
2003/9/1,1245,5725,30,42,7,35,0.984,1.556
2003/9/1,1345,5717,-10,25,6,19,0.989,1.228
2003/9/2,945,5689,-46,57,49,8,0.996,0.922
2003/9/2,1045,5709,19,29,11,18,0.995,1.594
2003/9/2,1145,5708,-1,26,16,10,0.997,1.607
2003/9/2,1245,5721,13,24,1,23,0.995,1.216
2003/9/2,1345,5755,35,39,0,39,0.991,0.667
2003/9/3,945,5755,-25,43,30,13,0.992,0.577
2003/9/3,1045,5753,-2,19,17,2,0.994,1.686
2003/9/3,1145,5756,3,15,4,11,0.994,1.788
2003/9/3,1245,5756,1,23,-1,24,0.996,1.238
2003/9/3,1345,5675,-81,87,82,5,1.01,0.486
2003/9/4,945,5685,10,27,14,13,1.007,0.9
2003/9/4,1045,5680,-5,32,5,27,1.008,1.008
2003/9/4,1145,5651,-29,43,39,4,1.013,1.001
2003/9/4,1245,5661,10,24,1,23,1.01,1.174
2003/9/4,1345,5654,-7,29,8,21,1.01,1.015
2003/9/5,945,5688,8,37,30,7,1.003,0.539
2003/9/5,1045,5680,-7,33,25,8,1.003,1.127
2003/9/5,1145,5659,-21,39,26,13,1.005,0.953
2003/9/5,1245,5667,8,45,13,32,1.002,0.97
2003/9/5,1345,5683,16,28,-3,31,0.998,1.271
2003/9/8,945,5661,-8,31,6,25,1.001,1.017
2003/9/8,1045,5732,71,81,4,77,0.989,0.568
2003/9/8,1145,5758,25,42,17,25,0.985,0.671
2003/9/8,1245,5757,-1,30,8,22,0.987,1.512
2003/9/8,1345,5753,-5,26,13,13,0.989,1.554
2003/9/9,945,5779,-9,40,29,11,0.987,0.797
2003/9/9,1045,5776,-4,20,9,11,0.989,1.544
2003/9/9,1145,5771,-6,24,19,5,0.992,1.71
2003/9/9,1245,5767,-3,21,8,13,0.994,1.67
2003/9/9,1345,5709,-57,89,60,29,1.006,0.662
2003/9/10,945,5625,-53,68,60,8,1.021,0.695
2003/9/10,1045,5635,10,26,19,7,1.019,1.098
2003/9/10,1145,5643,7,17,11,6,1.016,2.062
2003/9/10,1245,5645,0,20,0,20,1.013,1.557
2003/9/10,1345,5652,5,19,11,8,1.01,1.161
2003/9/12,945,5643,-1,37,16,21,1.009,1.001
2003/9/12,1045,5646,2,19,3,16,1.006,2.75
2003/9/12,1145,5636,-10,34,34,0,1.006,1.327
2003/9/12,1245,5656,20,18,3,15,1,2.42
2003/9/12,1345,5666,11,32,20,12,0.996,0.61
2003/9/15,945,5645,-25,44,34,10,0.999,0.803
2003/9/15,1045,5641,-4,15,9,6,1.001,1.318
2003/9/15,1145,5655,14,25,11,14,0.998,1.986
2003/9/15,1245,5668,12,29,16,13,0.996,1.435
2003/9/15,1345,5652,-15,21,20,1,0.999,1.441
2003/9/16,945,5696,61,75,14,61,0.991,0.505
2003/9/16,1045,5693,-3,26,9,17,0.993,1.222
2003/9/16,1145,5706,12,22,7,15,0.991,1.17
2003/9/16,1245,5706,0,27,6,21,0.993,1.728
2003/9/16,1345,5716,10,23,7,16,0.992,1.03
2003/9/17,945,5747,-11,32,22,10,0.988,1.319
2003/9/17,1045,5749,3,19,17,2,0.989,1.966
2003/9/17,1145,5750,2,11,4,7,0.991,3.225
2003/9/17,1245,5756,5,16,10,6,0.992,2.551
2003/9/17,1345,5761,5,14,4,10,0.992,1.106
2003/9/18,945,5741,-9,24,13,11,0.998,0.491
2003/9/18,1045,5727,-16,27,20,7,1.001,0.699
2003/9/18,1145,5711,-15,36,16,20,1.004,0.4
2003/9/18,1245,5713,3,20,2,18,1.004,0.891
2003/9/18,1345,5759,46,59,6,53,0.996,0.486
2003/9/19,945,5769,-13,40,28,12,0.995,0.537
2003/9/19,1045,5777,8,25,8,17,0.994,1.129
2003/9/19,1145,5791,14,20,-4,24,0.992,1.801
2003/9/19,1245,5735,-56,52,57,-5,1.002,0.997
2003/9/19,1345,5749,10,37,11,26,1,0.813
2003/9/22,945,5708,-9,24,8,16,1.006,0.731
2003/9/22,1045,5725,17,31,4,27,1.003,2.002
2003/9/22,1145,5704,-21,25,23,2,1.006,1.498
2003/9/22,1245,5705,2,22,5,17,1.006,1.07
2003/9/22,1345,5695,-10,19,14,5,1.008,1.29
2003/9/23,945,5689,8,26,12,14,1.007,0.794
2003/9/23,1045,5693,3,13,7,6,1.005,1.605
2003/9/23,1145,5695,2,10,3,7,1.003,2.999
2003/9/23,1245,5702,8,27,18,9,1,1.184
2003/9/23,1345,5714,13,25,1,24,0.997,0.98
2003/9/24,945,5710,-13,17,13,4,0.998,0.755
2003/9/24,1045,5718,7,20,5,15,0.997,1.02
2003/9/24,1145,5708,-10,19,11,8,0.998,1.023
2003/9/24,1245,5694,-13,20,8,12,1.001,0.867
2003/9/24,1345,5745,52,57,-1,58,0.992,0.648
2003/9/25,945,5660,0,31,15,16,1.006,0.614
2003/9/25,1045,5664,5,15,10,5,1.005,1.728
2003/9/25,1145,5675,9,14,0,14,1.003,1.497
2003/9/25,1245,5683,8,23,12,11,1.001,1.175
2003/9/25,1345,5688,6,20,15,5,1,0.921
2003/9/26,945,5704,36,45,11,34,0.996,0.661
2003/9/26,1045,5703,-1,11,4,7,0.996,1.847
2003/9/26,1145,5698,-5,24,17,7,0.997,1.413
2003/9/26,1245,5688,-9,22,16,6,0.998,1.159
2003/9/26,1345,5687,-1,26,21,5,0.998,0.923
2003/9/29,945,5675,5,19,9,10,1.001,1.09
2003/9/29,1045,5673,-2,17,4,13,1.001,1.527
2003/9/29,1145,5670,-3,10,4,6,1.002,2.369
2003/9/29,1245,5673,4,11,2,9,1.001,2.504
2003/9/29,1345,5665,-7,20,24,-4,1.002,0.774
2003/9/30,945,5670,-11,29,19,10,1.002,0.668
2003/9/30,1045,5680,11,17,4,13,0.999,1.36
2003/9/30,1145,5679,0,13,6,7,0.999,1.814
2003/9/30,1245,5679,0,7,4,3,0.999,3.347
2003/9/30,1345,5641,-39,38,39,-1,1.005,0.525
2003/10/1,945,5632,7,22,11,11,1.006,0.552
2003/10/1,1045,5633,1,14,8,6,1.005,1.441
2003/10/1,1145,5626,-7,14,10,4,1.006,1.812
2003/10/1,1245,5606,-19,20,19,1,1.009,0.823
2003/10/1,1345,5630,24,31,-3,34,1.003,0.649
2003/10/2,945,5675,12,29,10,19,0.995,0.431
2003/10/2,1045,5674,0,11,4,7,0.995,1.647
2003/10/2,1145,5684,10,12,1,11,0.993,1.067
2003/10/2,1245,5705,18,21,0,21,0.99,0.738
2003/10/2,1345,5720,16,26,10,16,0.988,0.726
2003/10/3,945,5714,4,21,15,6,0.99,0.948
2003/10/3,1045,5720,5,15,6,9,0.991,1.82
2003/10/3,1145,5735,15,19,3,16,0.99,1.117
2003/10/3,1245,5734,-2,17,13,4,0.992,1.109
2003/10/3,1345,5742,8,11,3,8,0.992,1.53
2003/10/6,945,5788,13,18,10,8,0.987,0.609
2003/10/6,1045,5796,8,14,-1,15,0.987,1.442
2003/10/6,1145,5832,35,36,3,33,0.983,0.674
2003/10/6,1245,5840,8,30,5,25,0.984,1.179
2003/10/6,1345,5829,-11,22,21,1,0.988,0.918
2003/10/7,945,5836,-7,22,12,10,0.99,0.922
2003/10/7,1045,5836,0,15,6,9,0.992,2.113
2003/10/7,1145,5845,9,18,9,9,0.992,1.782
2003/10/7,1245,5845,0,13,2,11,0.994,2.169
2003/10/7,1345,5855,10,20,0,20,0.994,1.085
2003/10/8,945,5825,-25,25,28,-3,1.001,0.828
2003/10/8,1045,5840,15,25,7,18,0.999,1.247
2003/10/8,1145,5848,9,17,7,10,0.998,1.554
2003/10/8,1245,5853,5,16,6,10,0.997,1.715
2003/10/8,1345,5834,-19,37,18,19,1.001,0.643
2003/10/9,945,5842,12,22,8,14,0.999,0.881
2003/10/9,1045,5846,4,10,3,7,0.999,1.808
2003/10/9,1145,5862,16,23,6,17,0.996,0.787
2003/10/9,1245,5868,6,19,3,16,0.995,1.027
2003/10/9,1345,5894,26,30,-2,32,0.991,0.648
2003/10/13,945,5928,-12,35,8,27,0.987,0.74
2003/10/13,1045,5953,26,32,1,31,0.985,1.003
2003/10/13,1145,5954,2,18,5,13,0.987,1.717
2003/10/13,1245,5982,28,26,-2,28,0.984,1.324
2003/10/13,1345,6028,46,29,-24,53,0.978,0.82
2003/10/14,945,6028,-4,24,12,12,0.982,0.943
2003/10/14,1045,6011,-17,28,20,8,0.988,1.28
2003/10/14,1145,6018,7,24,2,22,0.989,1.856
2003/10/14,1245,6005,-14,21,16,5,0.994,1.817
2003/10/14,1345,5979,-25,51,27,24,1,0.886
2003/10/15,945,5962,-38,38,37,1,1.004,1.896
2003/10/15,1045,5958,-6,14,12,2,1.006,1.532
2003/10/15,1145,5967,8,31,8,23,1.004,2.025
2003/10/15,1245,5967,0,11,5,6,1.004,2.979
2003/10/15,1345,5950,-18,18,18,0,1.007,0.735
2003/10/16,945,6026,61,87,13,74,0.993,0.364
2003/10/16,1045,6060,33,49,4,45,0.988,0.413
2003/10/16,1145,6075,15,33,9,24,0.986,0.666
2003/10/16,1245,6065,-11,23,12,11,0.989,1.032
2003/10/16,1345,6060,-5,20,20,0,0.99,0.916
2003/10/17,945,6068,-6,37,20,17,0.99,0.938
2003/10/17,1045,6066,-3,13,6,7,0.992,2.396
2003/10/17,1145,6074,8,22,9,13,0.993,1.432
2003/10/17,1245,6066,-8,15,9,6,0.996,2.07
2003/10/17,1345,6080,14,21,-4,25,0.995,1.596
2003/10/20,945,6066,6,31,7,24,0.999,0.614
2003/10/20,1045,6075,9,22,4,18,0.998,1.551
2003/10/20,1145,6083,8,24,12,12,0.997,1.051
2003/10/20,1245,6102,19,20,-1,21,0.994,1.322
2003/10/20,1345,6072,-31,18,43,-25,1,0.777
2003/10/21,945,6077,-21,37,32,5,0.999,0.48
2003/10/21,1045,6037,-41,77,41,36,1.006,0.443
2003/10/21,1145,6036,-1,24,13,11,1.006,1.254
2003/10/21,1245,6034,-2,13,7,6,1.005,2.616
2003/10/21,1345,6074,39,43,4,39,0.998,0.839
2003/10/22,945,6035,-20,37,23,14,1.005,0.757
2003/10/22,1045,6045,11,23,10,13,1.003,1.341
2003/10/22,1145,6068,23,38,12,26,0.998,1.399
2003/10/22,1245,6074,6,16,2,14,0.997,1.921
2003/10/22,1345,6051,-23,29,24,5,1,1.249
2003/10/23,945,5992,12,22,6,16,1.008,0.607
2003/10/23,1045,5985,-8,22,7,15,1.008,0.932
2003/10/23,1145,5979,-6,15,12,3,1.008,1.944
2003/10/23,1245,5977,-1,12,5,7,1.007,1.68
2003/10/23,1345,5945,-33,36,36,0,1.012,0.536
2003/10/24,945,5958,-7,19,17,2,1.008,2.539
2003/10/24,1045,5960,1,17,7,10,1.007,1.717
2003/10/24,1145,5946,-14,13,14,-1,1.008,1.62
2003/10/24,1245,5957,12,25,4,21,1.004,1.002
2003/10/24,1345,5958,2,26,12,14,1.001,1.076
2003/10/27,945,5988,13,30,5,25,0.996,0.822
2003/10/27,1045,5980,-7,12,9,3,0.998,1.982
2003/10/27,1145,5978,-2,12,14,-2,0.998,2.166
2003/10/27,1245,5998,20,28,6,22,0.995,0.974
2003/10/27,1345,6000,4,13,-1,14,0.995,1.11
2003/10/28,945,6070,66,79,0,79,0.984,0.384
2003/10/28,1045,6097,28,35,0,35,0.981,0.486
2003/10/28,1145,6122,24,45,15,30,0.979,0.75
2003/10/28,1245,6130,9,19,3,16,0.981,1.109
2003/10/28,1345,6130,0,30,-4,34,0.984,0.858
2003/10/29,945,6169,1,29,25,4,0.981,0.626
2003/10/29,1045,6153,-16,25,15,10,0.986,0.996
2003/10/29,1145,6155,0,15,10,5,0.989,2.167
2003/10/29,1245,6151,-3,19,4,15,0.992,1.838
2003/10/29,1345,6160,9,25,-1,26,0.993,1.33
2003/10/30,945,6136,-14,29,29,0,1,1.292
2003/10/30,1045,6137,1,40,8,32,1.001,0.869
2003/10/30,1145,6150,14,27,12,15,0.999,0.985
2003/10/30,1245,6148,-2,14,6,8,1,2.181
2003/10/30,1345,6134,-13,26,18,8,1.002,0.895
2003/10/31,945,6111,-14,49,28,21,1.005,0.532
2003/10/31,1045,6090,-21,37,23,14,1.008,0.725
2003/10/31,1145,6083,-7,14,12,2,1.008,2.014
2003/10/31,1245,6077,-6,29,16,13,1.008,1.422
2003/10/31,1345,6068,-9,24,8,16,1.008,0.711
2003/11/3,945,6088,20,36,2,34,1.003,0.956
2003/11/3,1045,6092,3,18,6,12,1.002,1.237
2003/11/3,1145,6089,-3,22,21,1,1.002,1.094
2003/11/3,1245,6118,29,43,9,34,0.996,0.837
2003/11/3,1345,6150,32,36,-8,44,0.99,0.775
2003/11/4,945,6162,-8,25,26,-1,0.989,0.693
2003/11/4,1045,6159,-3,15,6,9,0.991,1.267
2003/11/4,1145,6161,1,18,14,4,0.991,1.932
2003/11/4,1245,6163,2,14,2,12,0.992,2.696
2003/11/4,1345,6144,-19,39,19,20,0.997,0.786
2003/11/5,945,6135,6,25,20,5,0.999,0.958
2003/11/5,1045,6134,-1,24,2,22,1,1.139
2003/11/5,1145,6138,4,11,0,11,1,2.413
2003/11/5,1245,6186,48,50,4,46,0.993,0.636
2003/11/5,1345,6165,-20,24,20,4,0.998,0.815
2003/11/6,945,6167,-14,30,18,12,0.998,0.752
2003/11/6,1045,6155,-11,22,10,12,1,1.043
2003/11/6,1145,6145,-10,31,29,2,1.001,1.419
2003/11/6,1245,6076,-69,69,77,-8,1.012,0.685
2003/11/6,1345,5975,-107,350,109,241,1.028,0.371
2003/11/7,945,5999,-36,41,50,-9,1.022,0.782
2003/11/7,1045,6029,29,47,10,37,1.015,1.216
2003/11/7,1145,6028,-1,22,14,8,1.013,2.351
2003/11/7,1245,6035,8,23,4,19,1.01,2.715
2003/11/7,1345,6059,22,32,5,27,1.004,1.119
2003/11/10,945,6057,25,49,2,47,1.002,1.005
2003/11/10,1045,6072,15,38,15,23,0.998,1.155
2003/11/10,1145,6048,-24,37,24,13,1,1.439
2003/11/10,1245,6045,-2,32,19,13,0.999,1.859
2003/11/10,1345,6049,4,33,4,29,0.998,1.072
2003/11/11,945,6028,7,23,6,17,1.001,0.908
2003/11/11,1045,6018,-8,37,12,25,1.003,0.874
2003/11/11,1145,6015,-3,20,15,5,1.003,1.24
2003/11/11,1245,5999,-16,21,20,1,1.006,1.086
2003/11/11,1345,6040,39,47,6,41,0.998,0.719
2003/11/12,945,6050,20,32,10,22,0.997,1.046
2003/11/12,1045,6030,-19,21,24,-3,1,1.321
2003/11/12,1145,6030,2,15,11,4,0.999,1.741
2003/11/12,1245,6027,-3,27,8,19,0.999,1.006
2003/11/12,1345,6009,-17,25,21,4,1.002,1.052
2003/11/13,945,6053,-17,33,27,6,0.996,0.624
2003/11/13,1045,6056,3,13,8,5,0.996,1.751
2003/11/13,1145,6063,7,14,1,13,0.995,1.87
2003/11/13,1245,6080,17,26,5,21,0.993,0.833
2003/11/13,1345,6072,-8,20,16,4,0.996,1.042
2003/11/14,945,6049,-19,35,29,6,1,0.66
2003/11/14,1045,6046,-3,22,9,13,1.001,1.081
2003/11/14,1145,6045,-1,9,5,4,1.001,2.529
2003/11/14,1245,6053,7,25,12,13,1,1.098
2003/11/14,1345,6058,3,16,12,4,1,1.237
2003/11/17,945,5980,-38,41,37,4,1.012,0.504
2003/11/17,1045,5974,-5,18,5,13,1.012,1.064
2003/11/17,1145,5965,-9,18,14,4,1.012,1.613
2003/11/17,1245,5975,10,17,7,10,1.008,2.659
2003/11/17,1345,5978,3,16,-2,18,1.006,1.168
2003/11/18,945,5980,2,21,14,7,1.004,0.918
2003/11/18,1045,5968,-13,18,15,3,1.005,1.328
2003/11/18,1145,5951,-17,24,17,7,1.007,0.96
2003/11/18,1245,5975,25,31,2,29,1.001,1.157
2003/11/18,1345,5985,9,16,3,13,0.998,1.175
2003/11/19,945,5900,0,32,20,12,1.01,0.786
2003/11/19,1045,5907,8,11,3,8,1.008,1.989
2003/11/19,1145,5885,-23,26,23,3,1.011,1.149
2003/11/19,1245,5863,-23,25,29,-4,1.013,1.093
2003/11/19,1345,5865,2,55,31,24,1.011,0.654
2003/11/20,945,5925,10,40,0,40,0.999,0.411
2003/11/20,1045,5907,-21,28,25,3,1.002,0.861
2003/11/20,1145,5902,-5,23,15,8,1.001,1.239
2003/11/20,1245,5905,2,21,10,11,1,1.821
2003/11/20,1345,5898,-7,24,9,15,1,0.808
2003/11/21,945,5821,-31,53,43,10,1.012,0.513
2003/11/21,1045,5827,4,14,3,11,1.01,1.183
2003/11/21,1145,5842,15,21,5,16,1.006,1.476
2003/11/21,1245,5863,21,38,4,34,1.002,1.179
2003/11/21,1345,5862,0,25,13,12,1.002,1.185
2003/11/24,945,5851,6,33,17,16,1.003,1.049
2003/11/24,1045,5849,-2,20,7,13,1.002,1.637
2003/11/24,1145,5850,1,14,8,6,1.001,2.145
2003/11/24,1245,5855,5,16,11,5,0.999,2.54
2003/11/24,1345,5850,-5,19,19,0,0.999,1.275
2003/11/25,945,5920,-4,20,3,17,0.988,0.471
2003/11/25,1045,5917,-2,21,17,4,0.99,0.754
2003/11/25,1145,5912,-4,10,8,2,0.993,1.772
2003/11/25,1245,5897,-16,28,21,7,0.996,1.301
2003/11/25,1345,5888,-10,17,11,6,0.998,0.714
2003/11/26,945,5889,-8,20,16,4,0.999,0.898
2003/11/26,1045,5898,9,20,9,11,0.998,1.622
2003/11/26,1145,5899,2,13,4,9,0.999,2.117
2003/11/26,1245,5900,1,10,3,7,1,2.475
2003/11/26,1345,5904,4,20,11,9,1,1.064
2003/11/27,945,5842,-53,65,53,12,1.01,0.358
2003/11/27,1045,5839,-3,24,17,7,1.009,0.757
2003/11/27,1145,5836,-2,22,11,11,1.008,1.409
2003/11/27,1245,5839,4,13,9,4,1.006,2.112
2003/11/27,1345,5818,-22,39,21,18,1.009,0.548
2003/11/28,945,5845,17,32,9,23,1.003,0.721
2003/11/28,1045,5847,2,17,11,6,1.002,1.13
2003/11/28,1145,5837,-11,9,12,-3,1.003,2.319
2003/11/28,1245,5829,-9,14,11,3,1.003,1.412
2003/11/28,1345,5808,-21,42,27,15,1.006,0.851
2003/12/1,945,5830,49,53,-2,55,1,0.769
2003/12/1,1045,5883,54,68,16,52,0.991,0.443
2003/12/1,1145,5893,10,24,4,20,0.99,0.907
2003/12/1,1245,5895,1,10,0,10,0.99,2.819
2003/12/1,1345,5914,20,25,2,23,0.988,0.847
2003/12/2,945,5924,-14,31,23,8,0.988,0.755
2003/12/2,1045,5912,-13,23,23,0,0.992,1.742
2003/12/2,1145,5911,-1,19,12,7,0.993,1.861
2003/12/2,1245,5926,15,20,7,13,0.992,1.897
2003/12/2,1345,5930,5,21,0,21,0.993,1.355
2003/12/3,945,5923,1,36,17,19,0.996,0.966
2003/12/3,1045,5910,-13,22,16,6,1,1.102
2003/12/3,1145,5907,-4,13,11,2,1.001,2.211
2003/12/3,1245,5911,3,15,12,3,1,1.911
2003/12/3,1345,5908,-3,20,2,18,1.001,0.791
2003/12/4,945,5893,-7,19,19,0,1.003,0.736
2003/12/4,1045,5903,10,20,5,15,1.001,1.527
2003/12/4,1145,5920,17,26,10,16,0.998,0.638
2003/12/4,1245,5917,-3,12,10,2,0.999,1.202
2003/12/4,1345,5934,17,34,1,33,0.996,0.67
2003/12/5,945,5926,-2,14,6,8,0.997,0.755
2003/12/5,1045,5905,-21,30,21,9,1.001,0.725
2003/12/5,1145,5903,-2,9,7,2,1.001,2.202
2003/12/5,1245,5909,5,12,4,8,1,2.999
2003/12/5,1345,5904,-5,21,9,12,1.001,0.829
2003/12/8,945,5843,-21,31,24,7,1.01,0.569
2003/12/8,1045,5849,6,12,3,9,1.009,2.326
2003/12/8,1145,5846,-3,7,5,2,1.008,3.235
2003/12/8,1245,5848,2,9,5,4,1.007,2.996
2003/12/8,1345,5847,-2,21,12,9,1.006,1.003
2003/12/9,945,5849,-18,20,18,2,1.004,0.927
2003/12/9,1045,5857,9,17,0,17,1.001,1.271
2003/12/9,1145,5874,18,25,6,19,0.998,0.592
2003/12/9,1245,5870,-4,12,14,-2,0.998,1.31
2003/12/9,1345,5873,3,15,6,9,0.997,0.999
2003/12/10,945,5820,0,25,10,15,1.005,0.51
2003/12/10,1045,5825,5,18,10,8,1.004,1.569
2003/12/10,1145,5820,-5,12,11,1,1.004,2.22
2003/12/10,1245,5815,-6,30,15,15,1.005,0.725
2003/12/10,1345,5830,13,18,0,18,1.002,1.029
2003/12/11,945,5837,-3,16,12,4,1,1.045
2003/12/11,1045,5840,3,6,2,4,0.999,2.689
2003/12/11,1145,5857,17,26,8,18,0.996,0.684
2003/12/11,1245,5864,8,12,0,12,0.994,1.59
2003/12/11,1345,5890,25,27,0,27,0.99,0.593
2003/12/12,945,5931,-7,15,2,13,0.985,0.475
2003/12/12,1045,5919,-12,13,13,0,0.989,1.761
2003/12/12,1145,5911,-8,13,9,4,0.992,1.319
2003/12/12,1245,5909,-2,10,9,1,0.994,2.005
2003/12/12,1345,5885,-25,28,24,4,0.999,0.585
2003/12/15,945,5913,-17,25,22,3,0.996,0.72
2003/12/15,1045,5914,0,18,6,12,0.997,1.452
2003/12/15,1145,5920,7,15,1,14,0.998,2.238
2003/12/15,1245,5923,4,23,5,18,0.998,1.57
2003/12/15,1345,5968,45,47,-2,49,0.992,0.602
2003/12/16,945,5909,17,28,7,21,1.001,0.657
2003/12/16,1045,5920,10,23,-5,28,0.999,1.362
2003/12/16,1145,5908,-11,12,11,1,1.001,2.82
2003/12/16,1245,5902,-8,13,11,2,1.002,2.196
2003/12/16,1345,5901,-3,11,12,-1,1.002,1.757
2003/12/17,945,5885,-20,50,35,15,1.004,1.061
2003/12/17,1045,5828,-58,80,62,18,1.013,0.767
2003/12/17,1145,5784,-46,96,47,49,1.02,0.979
2003/12/17,1245,5780,-4,36,16,20,1.018,1.745
2003/12/17,1345,5750,-32,39,45,-6,1.021,0.709
2003/12/18,945,5794,9,39,6,33,1.011,0.455
2003/12/18,1045,5804,8,15,5,10,1.007,0.872
2003/12/18,1145,5790,-14,20,20,0,1.008,1.186
2003/12/18,1245,5790,0,10,8,2,1.006,2.951
2003/12/18,1345,5780,-10,17,17,0,1.006,1.143
2003/12/19,945,5807,-4,36,20,16,0.999,0.553
2003/12/19,1045,5799,-8,13,11,2,0.999,1.831
2003/12/19,1145,5783,-15,27,19,8,1.002,0.975
2003/12/19,1245,5784,1,37,5,32,1.001,0.751
2003/12/19,1345,5800,16,16,-12,28,0.999,0.988
2003/12/22,945,5843,33,59,12,47,0.992,0.454
2003/12/22,1045,5848,5,24,16,8,0.992,0.661
2003/12/22,1145,5855,6,12,5,7,0.991,1.936
2003/12/22,1245,5846,-9,17,14,3,0.994,1.542
2003/12/22,1345,5838,-8,22,18,4,0.996,0.988
2003/12/23,945,5839,-11,19,11,8,0.997,1.282
2003/12/23,1045,5838,-1,11,6,5,0.997,3.112
2003/12/23,1145,5833,-5,12,4,8,0.999,1.979
2003/12/23,1245,5841,8,21,13,8,0.998,1.377
2003/12/23,1345,5838,-2,18,15,3,1,1.132
2003/12/24,945,5851,6,18,8,10,0.998,0.969
2003/12/24,1045,5891,40,51,9,42,0.992,0.368
2003/12/24,1145,5893,1,14,5,9,0.992,1.118
2003/12/24,1245,5879,-14,19,16,3,0.995,1.435
2003/12/24,1345,5864,-16,27,23,4,0.998,0.627
2003/12/25,945,5881,21,33,10,23,0.995,0.848
2003/12/25,1045,5874,-7,16,8,8,0.997,1.488
2003/12/25,1145,5870,-3,14,4,10,0.999,1.94
2003/12/25,1245,5869,-2,9,7,2,0.999,3.182
2003/12/25,1345,5860,-9,24,9,15,1.001,0.806
2003/12/26,945,5844,-26,46,38,8,1.005,0.709
2003/12/26,1045,5852,8,14,6,8,1.003,1.373
2003/12/26,1145,5852,0,6,4,2,1.002,4.486
2003/12/26,1245,5845,-7,13,9,4,1.003,1.826
2003/12/26,1345,5867,21,30,7,23,0.999,0.706
2003/12/29,945,5855,-15,40,33,7,1.001,0.614
2003/12/29,1045,5836,-20,29,20,9,1.004,0.587
2003/12/29,1145,5839,3,9,3,6,1.003,2.422
2003/12/29,1245,5835,-5,11,9,2,1.003,2.792
2003/12/29,1345,5836,1,16,7,9,1.002,1.102
2003/12/30,945,5854,-16,23,21,2,0.999,0.659
2003/12/30,1045,5887,33,43,3,40,0.993,0.515
2003/12/30,1145,5890,3,21,15,6,0.993,0.54
2003/12/30,1245,5900,9,12,2,10,0.992,1.745
2003/12/30,1345,5890,-10,24,19,5,0.995,0.712
2003/12/31,945,5913,14,34,4,30,0.992,0.987
2003/12/31,1045,5908,-4,11,5,6,0.993,1.53
2003/12/31,1145,5904,-5,17,9,8,0.995,1.696
2003/12/31,1245,5902,-1,15,7,8,0.997,2.068
2003/12/31,1345,5903,1,10,5,5,0.998,1.756
2004/1/2,945,5955,55,61,3,58,0.99,0.511
2004/1/2,1045,5990,36,35,4,31,0.985,0.568
2004/1/2,1145,6033,43,61,15,46,0.98,0.668
2004/1/2,1245,6049,16,25,9,16,0.98,1.239
2004/1/2,1345,6056,6,24,16,8,0.981,0.724
2004/1/5,945,6078,4,56,41,15,0.981,0.658
2004/1/5,1045,6122,44,52,6,46,0.976,0.901
2004/1/5,1145,6124,0,20,4,16,0.979,1.597
2004/1/5,1245,6135,10,34,4,30,0.981,1.395
2004/1/5,1345,6144,7,27,10,17,0.984,1.06
2004/1/6,945,6137,-35,50,41,9,0.989,0.671
2004/1/6,1045,6161,26,40,14,26,0.988,1.297
2004/1/6,1145,6165,4,14,1,13,0.99,2.231
2004/1/6,1245,6150,-14,23,15,8,0.995,2.097
2004/1/6,1345,6160,10,24,1,23,0.995,1.212
2004/1/7,945,6213,50,48,-5,53,0.988,0.612
2004/1/7,1045,6233,20,30,13,17,0.987,0.666
2004/1/7,1145,6191,-43,79,61,18,0.995,0.576
2004/1/7,1245,6194,2,24,11,13,0.996,1.259
2004/1/7,1345,6174,-20,34,22,12,1,0.973
2004/1/8,945,6184,-4,42,33,9,0.999,0.822
2004/1/8,1045,6220,36,43,5,38,0.994,1.203
2004/1/8,1145,6208,-13,20,13,7,0.997,1.858
2004/1/8,1245,6204,-4,15,5,10,0.998,1.714
2004/1/8,1345,6211,7,14,5,9,0.998,1.508
2004/1/9,945,6271,-7,30,21,9,0.99,0.613
2004/1/9,1045,6274,3,17,10,7,0.99,1.855
2004/1/9,1145,6273,-2,12,5,7,0.991,2.347
2004/1/9,1245,6290,17,15,-2,17,0.99,1.969
2004/1/9,1345,6270,-17,57,29,28,0.995,0.491
2004/1/12,945,6258,0,27,10,17,0.998,1.014
2004/1/12,1045,6262,6,12,3,9,0.998,3.465
2004/1/12,1145,6270,8,22,10,12,0.997,1.653
2004/1/12,1245,6267,-3,13,8,5,0.999,1.989
2004/1/12,1345,6275,10,19,-1,20,0.999,1.472
2004/1/13,945,6260,-28,27,25,2,1.001,0.634
2004/1/13,1045,6271,9,12,2,10,0.999,1.8
2004/1/13,1145,6265,-6,12,10,2,1,2.676
2004/1/13,1245,6239,-26,45,27,18,1.004,0.541
2004/1/13,1345,6254,15,26,0,26,1.001,0.902
2004/1/14,945,6256,16,34,3,31,1,0.854
2004/1/14,1045,6304,49,57,6,51,0.993,0.433
2004/1/14,1145,6312,9,22,5,17,0.992,0.796
2004/1/14,1245,6343,28,33,1,32,0.988,1.169
2004/1/14,1345,6325,-18,31,19,12,0.992,0.932
2004/1/15,945,6305,-7,26,22,4,0.996,0.983
2004/1/15,1045,6312,7,32,8,24,0.995,1.357
2004/1/15,1145,6313,2,24,21,3,0.996,1.845
2004/1/15,1245,6311,-2,13,8,5,0.997,2.945
2004/1/15,1345,6300,-13,19,14,5,1,1.468
2004/1/16,945,6319,-10,31,25,6,0.998,1.058
2004/1/16,1045,6320,0,20,10,10,0.999,2.024
2004/1/16,1145,6319,0,13,10,3,0.999,1.649
2004/1/16,1245,6298,-21,31,25,6,1.003,1.376
2004/1/16,1345,6285,-14,22,24,-2,1.004,0.754
2004/1/27,945,6350,25,32,12,20,0.994,0.586
2004/1/27,1045,6361,11,16,0,16,0.993,1.133
2004/1/27,1145,6380,19,25,7,18,0.991,1.507
2004/1/27,1245,6378,-2,11,4,7,0.992,2.027
2004/1/27,1345,6370,-8,8,15,-7,0.994,1.199
2004/1/28,945,6362,-8,19,8,11,0.996,0.547
2004/1/28,1045,6372,9,23,2,21,0.995,0.722
2004/1/28,1145,6397,25,29,-3,32,0.992,0.77
2004/1/28,1245,6385,-11,17,13,4,0.995,1.253
2004/1/28,1345,6367,-19,23,21,2,1,0.891
2004/1/29,945,6340,8,42,4,38,1.004,0.417
2004/1/29,1045,6321,-19,34,21,13,1.007,0.79
2004/1/29,1145,6330,6,17,6,11,1.005,1.694
2004/1/29,1245,6325,-5,21,12,9,1.005,1.536
2004/1/29,1345,6331,7,21,-2,23,1.003,0.763
2004/1/30,945,6344,14,13,-4,17,1,1.489
2004/1/30,1045,6347,3,11,2,9,1,1.377
2004/1/30,1145,6373,26,33,5,28,0.995,0.648
2004/1/30,1245,6363,-10,16,11,5,0.996,1.943
2004/1/30,1345,6381,18,32,6,26,0.993,0.861
2004/2/2,945,6355,-20,39,26,13,0.998,0.737
2004/2/2,1045,6370,12,23,3,20,0.996,1.289
2004/2/2,1145,6357,-13,25,19,6,0.999,1.631
2004/2/2,1245,6348,-9,19,21,-2,1,1.952
2004/2/2,1345,6330,-16,34,27,7,1.004,0.568
2004/2/3,945,6257,-43,58,31,27,1.015,0.405
2004/2/3,1045,6245,-11,13,9,4,1.015,1.697
2004/2/3,1145,6247,2,16,3,13,1.013,1.574
2004/2/3,1245,6249,1,12,5,7,1.011,2.197
2004/2/3,1345,6259,10,14,3,11,1.008,1.134
2004/2/4,945,6250,5,25,20,5,1.007,1.066
2004/2/4,1045,6264,13,28,4,24,1.003,1.436
2004/2/4,1145,6262,-2,13,6,7,1.002,2.481
2004/2/4,1245,6263,1,18,17,1,1,1.144
2004/2/4,1345,6235,-29,30,32,-2,1.003,0.972
2004/2/5,945,6268,56,58,10,48,0.997,0.428
2004/2/5,1045,6295,26,47,18,29,0.992,0.581
2004/2/5,1145,6296,1,10,6,4,0.993,1.616
2004/2/5,1245,6278,-19,30,27,3,0.997,1.058
2004/2/5,1345,6285,7,20,5,15,0.996,0.851
2004/2/6,945,6338,58,70,12,58,0.988,0.468
2004/2/6,1045,6362,24,24,-2,26,0.986,0.857
2004/2/6,1145,6359,-2,15,8,7,0.988,1.529
2004/2/6,1245,6376,17,21,4,17,0.987,1.256
2004/2/6,1345,6365,-12,27,19,8,0.99,0.939
2004/2/9,945,6445,37,47,12,35,0.981,0.592
2004/2/9,1045,6444,0,16,3,13,0.984,1.843
2004/2/9,1145,6441,-2,12,4,8,0.987,2.282
2004/2/9,1245,6446,7,13,6,7,0.988,2.533
2004/2/9,1345,6470,25,34,2,32,0.987,0.981
2004/2/10,945,6447,-19,23,26,-3,0.993,0.928
2004/2/10,1045,6453,6,22,4,18,0.994,1.141
2004/2/10,1145,6469,16,20,1,19,0.993,1.616
2004/2/10,1245,6466,-3,30,22,8,0.995,0.869
2004/2/10,1345,6475,8,21,11,10,0.995,0.997
2004/2/11,945,6470,-17,40,15,25,0.997,0.575
2004/2/11,1045,6457,-13,34,14,20,1,0.782
2004/2/11,1145,6456,0,17,14,3,1,1.888
2004/2/11,1245,6465,9,19,10,9,0.999,2.012
2004/2/11,1345,6458,-4,23,5,18,1,0.75
2004/2/12,945,6536,48,69,3,66,0.989,0.499
2004/2/12,1045,6573,38,58,23,35,0.984,0.486
2004/2/12,1145,6552,-21,39,22,17,0.989,0.785
2004/2/12,1245,6469,-83,111,82,29,1.003,0.546
2004/2/12,1345,6440,-30,97,29,68,1.008,0.562
2004/2/13,945,6460,25,61,23,38,1.004,1.033
2004/2/13,1045,6518,58,74,15,59,0.995,0.845
2004/2/13,1145,6518,0,45,20,25,0.996,1.443
2004/2/13,1245,6544,25,37,4,33,0.993,2.373
2004/2/13,1345,6565,21,32,4,28,0.991,1.624
2004/2/16,945,6528,-22,66,48,18,0.998,1.355
2004/2/16,1045,6534,6,37,28,9,0.997,2.7
2004/2/16,1145,6572,38,53,18,35,0.99,2.482
2004/2/16,1245,6549,-23,52,29,23,0.994,2.481
2004/2/16,1345,6571,23,45,-1,46,0.992,1.786
2004/2/17,945,6582,2,44,13,31,0.992,1.172
2004/2/17,1045,6567,-16,25,25,0,0.997,1.739
2004/2/17,1145,6577,10,25,11,14,0.996,1.236
2004/2/17,1245,6579,3,17,13,4,0.996,1.595
2004/2/17,1345,6615,36,42,5,37,0.991,0.99
2004/2/18,945,6647,29,34,7,27,0.988,1.198
2004/2/18,1045,6630,-17,40,20,20,0.992,1.05
2004/2/18,1145,6597,-33,42,35,7,0.998,2.252
2004/2/18,1245,6615,17,21,5,16,0.996,2.692
2004/2/18,1345,6615,0,17,3,14,0.997,0.989
2004/2/19,945,6645,-5,30,21,9,0.994,0.427
2004/2/19,1045,6654,10,23,10,13,0.993,0.814
2004/2/19,1145,6695,41,46,3,43,0.988,0.45
2004/2/19,1245,6694,-1,40,19,21,0.99,0.77
2004/2/19,1345,6716,21,34,3,31,0.989,0.633
2004/2/20,945,6703,18,35,4,31,0.992,0.65
2004/2/20,1045,6691,-13,31,20,11,0.994,1.209
2004/2/20,1145,6708,17,20,2,18,0.993,1.89
2004/2/20,1245,6703,-4,22,10,12,0.995,1.904
2004/2/20,1345,6696,-7,17,9,8,0.998,1.686
2004/2/23,945,6684,-14,28,24,4,1,1.168
2004/2/23,1045,6659,-25,47,19,28,1.004,0.516
2004/2/23,1145,6677,18,32,3,29,1.002,1.451
2004/2/23,1245,6688,11,24,5,19,1,1.575
2004/2/23,1345,6703,15,28,1,27,0.998,0.921
2004/2/24,945,6674,-1,43,19,24,1.002,0.605
2004/2/24,1045,6670,-4,25,8,17,1.002,1.083
2004/2/24,1145,6656,-16,30,14,16,1.004,0.697
2004/2/24,1245,6655,-1,25,17,8,1.003,1.277
2004/2/24,1345,6643,-11,27,19,8,1.004,0.956
2004/2/25,945,6659,14,26,12,14,1.001,0.95
2004/2/25,1045,6699,39,55,9,46,0.995,0.707
2004/2/25,1145,6688,-10,20,17,3,0.997,1.097
2004/2/25,1245,6687,-2,10,8,2,0.997,2.394
2004/2/25,1345,6685,-1,17,13,4,0.997,1.753
2004/2/26,945,6723,16,38,19,19,0.992,0.575
2004/2/26,1045,6733,10,23,13,10,0.991,0.95
2004/2/26,1145,6735,0,16,3,13,0.992,1.489
2004/2/26,1245,6719,-16,28,16,12,0.996,1.386
2004/2/26,1345,6735,15,27,-1,28,0.994,1.06
2004/2/27,945,6758,9,40,9,31,0.992,0.722
2004/2/27,1045,6758,0,18,8,10,0.994,1.25
2004/2/27,1145,6759,1,11,3,8,0.995,2.187
2004/2/27,1245,6776,18,20,0,20,0.993,1.147
2004/2/27,1345,6802,26,30,3,27,0.991,0.676
2004/3/1,945,6893,63,72,7,65,0.979,0.654
2004/3/1,1045,6919,27,27,3,24,0.978,0.717
2004/3/1,1145,6963,45,46,-5,51,0.975,0.861
2004/3/1,1245,6945,-17,59,29,30,0.98,0.841
2004/3/1,1345,6968,23,33,10,23,0.98,0.904
2004/3/2,945,7000,1,40,25,15,0.979,0.576
2004/3/2,1045,6987,-12,31,17,14,0.985,0.952
2004/3/2,1145,7012,25,36,13,23,0.984,1.55
2004/3/2,1245,7025,14,36,20,16,0.986,1.029
2004/3/2,1345,7055,27,47,18,29,0.986,0.907
2004/3/3,945,7057,14,37,3,34,0.988,0.927
2004/3/3,1045,7038,-17,26,20,6,0.993,1.629
2004/3/3,1145,7054,16,25,4,21,0.993,2.376
2004/3/3,1245,7029,-23,48,30,18,0.998,0.706
2004/3/3,1345,7012,-16,20,23,-3,1.001,1.628
2004/3/4,945,7091,71,290,221,69,0.99,0.584
2004/3/4,1045,7091,-1,58,29,29,0.992,0.719
2004/3/4,1145,7115,26,43,13,30,0.99,0.959
2004/3/4,1245,7129,14,34,8,26,0.989,1.433
2004/3/4,1345,7150,21,23,-1,24,0.988,1.013
2004/3/5,945,7194,9,49,23,26,0.984,0.648
2004/3/5,1045,7195,4,20,13,7,0.985,1.486
2004/3/5,1145,7217,22,50,28,22,0.985,0.795
2004/3/5,1245,7136,-81,128,78,50,0.998,0.493
2004/3/5,1345,7075,-61,113,89,24,1.008,0.677
2004/3/8,945,7080,-30,65,55,10,1.009,1.002
2004/3/8,1045,7071,-9,38,28,10,1.01,1.411
2004/3/8,1145,7083,11,28,12,16,1.008,2.188
2004/3/8,1245,7028,-55,64,59,5,1.015,1.315
2004/3/8,1345,6979,-51,77,54,23,1.021,0.816
2004/3/9,945,6948,8,63,30,33,1.022,1.008
2004/3/9,1045,6964,16,35,12,23,1.016,2.877
2004/3/9,1145,7010,46,68,15,53,1.006,1.695
2004/3/9,1245,7005,-5,35,20,15,1.004,1.135
2004/3/9,1345,7051,47,50,5,45,0.996,0.914
2004/3/10,945,7041,21,46,8,38,0.996,0.922
2004/3/10,1045,6995,-46,64,49,15,1.002,0.835
2004/3/10,1145,6958,-37,63,35,28,1.006,0.714
2004/3/10,1245,6938,-20,53,35,18,1.007,1.123
2004/3/10,1345,6930,-8,37,11,26,1.007,0.869
2004/3/11,945,6885,2,41,12,29,1.013,0.973
2004/3/11,1045,6861,-23,50,24,26,1.015,1.145
2004/3/11,1145,6900,39,69,24,45,1.008,1.285
2004/3/11,1245,6942,42,56,6,50,1,1.206
2004/3/11,1345,6922,-20,46,45,1,1.002,1.08
2004/3/12,945,6834,34,70,16,54,1.012,0.762
2004/3/12,1045,6829,-4,46,12,34,1.01,1.347
2004/3/12,1145,6830,1,18,4,14,1.007,2.402
2004/3/12,1245,6836,6,50,26,24,1.004,1.43
2004/3/12,1345,6807,-29,41,38,3,1.007,1.168
2004/3/15,945,6897,32,42,20,22,0.994,0.849
2004/3/15,1045,6861,-34,57,41,16,0.999,0.971
2004/3/15,1145,6860,-2,25,15,10,0.999,1.773
2004/3/15,1245,6766,-95,80,98,-18,1.013,0.929
2004/3/15,1345,6563,-212,209,206,3,1.041,0.428
2004/3/16,945,6568,62,86,38,48,1.036,0.652
2004/3/16,1045,6557,-13,47,33,14,1.034,1.115
2004/3/16,1145,6589,32,52,20,32,1.025,1.178
2004/3/16,1245,6595,8,54,42,12,1.02,1.133
2004/3/16,1345,6555,-38,43,38,5,1.023,1.228
2004/3/17,945,6620,55,57,20,37,1.008,1.627
2004/3/17,1045,6614,-8,28,24,4,1.005,2.574
2004/3/17,1145,6586,-29,61,37,24,1.005,2.106
2004/3/17,1245,6608,23,46,11,35,0.998,2.317
2004/3/17,1345,6565,-40,43,44,-1,1.002,1.731
2004/3/18,945,6725,49,115,42,73,0.981,0.318
2004/3/18,1045,6728,1,53,30,23,0.982,0.789
2004/3/18,1145,6786,60,75,-1,76,0.977,0.679
2004/3/18,1245,6793,7,25,4,21,0.978,1.253
2004/3/18,1345,6845,53,46,-5,51,0.974,0.701
2004/3/19,945,6810,-18,57,55,2,0.983,0.746
2004/3/19,1045,6805,-4,48,29,19,0.986,0.858
2004/3/19,1145,6806,1,32,21,11,0.989,2.581
2004/3/19,1245,6846,40,43,3,40,0.986,1.632
2004/3/19,1345,6830,-15,47,35,12,0.992,0.994
2004/3/22,945,6352,0,0,0,0,1.062,3.074
2004/3/23,945,5939,31,444,413,31,1.122,0.374
2004/3/23,1045,6020,81,140,28,112,1.094,0.579
2004/3/23,1145,6125,102,130,22,108,1.062,0.8
2004/3/23,1245,6055,-71,210,165,45,1.064,0.699
2004/3/23,1345,6055,7,89,85,4,1.051,0.928
2004/3/24,945,6173,46,95,42,53,1.02,0.754
2004/3/24,1045,6156,-18,56,23,33,1.012,1.64
2004/3/24,1145,6097,-59,93,63,30,1.011,1.165
2004/3/24,1245,6119,21,40,6,34,0.996,1.64
2004/3/24,1345,6180,61,58,-1,59,0.982,1.407
2004/3/25,945,6181,1,47,21,26,0.986,1.14
2004/3/25,1045,6181,0,36,4,32,0.99,1.898
2004/3/25,1145,6169,-11,38,26,12,0.995,1.607
2004/3/25,1245,6139,-31,42,34,8,1,1.656
2004/3/25,1345,6135,-4,39,14,25,1.002,1.054
2004/3/26,945,6162,-38,55,48,7,0.999,0.693
2004/3/26,1045,6096,-68,71,76,-5,1.01,1.137
2004/3/26,1145,6139,43,73,5,68,1.002,1.021
2004/3/26,1245,6121,-17,50,33,17,1.005,1.258
2004/3/26,1345,6125,4,49,4,45,1.005,1.041
2004/3/29,945,6371,-28,110,14,96,0.969,0.498
2004/3/29,1045,6408,37,55,20,35,0.967,0.958
2004/3/29,1145,6407,0,23,12,11,0.97,2.764
2004/3/29,1245,6412,4,30,13,17,0.973,2.132
2004/3/29,1345,6471,57,76,17,59,0.969,1.01
2004/3/30,945,6456,21,42,24,18,0.975,0.862
2004/3/30,1045,6473,15,40,25,15,0.977,1.239
2004/3/30,1145,6481,9,30,12,18,0.981,1.452
2004/3/30,1245,6464,-16,37,17,20,0.989,1.194
2004/3/30,1345,6487,23,44,8,36,0.991,1.185
2004/3/31,945,6521,14,48,18,30,0.987,0.645
2004/3/31,1045,6458,-62,74,61,13,0.999,0.672
2004/3/31,1145,6468,10,28,11,17,0.999,1.377
2004/3/31,1245,6428,-40,63,57,6,1.006,0.896
2004/3/31,1345,6480,52,50,0,50,0.998,1.044
2004/4/1,945,6433,-40,57,45,12,1.006,0.839
2004/4/1,1045,6433,1,34,11,23,1.005,1.093
2004/4/1,1145,6449,16,23,1,22,1.002,2.227
2004/4/1,1245,6458,11,31,8,23,1,1.837
2004/4/1,1345,6471,13,35,14,21,0.998,1.089
2004/4/2,945,6490,9,49,35,14,0.995,0.661
2004/4/2,1045,6494,3,26,19,7,0.994,1.418
2004/4/2,1145,6489,-5,29,14,15,0.995,1.511
2004/4/2,1245,6484,-7,27,15,12,0.996,1.698
2004/4/2,1345,6493,11,26,11,15,0.996,1.139
2004/4/5,945,6553,-7,52,32,20,0.988,0.479
2004/4/5,1045,6572,19,29,3,26,0.987,1.122
2004/4/5,1145,6639,67,72,7,65,0.979,0.531
2004/4/5,1245,6679,41,48,7,41,0.976,0.84
2004/4/5,1345,6692,15,30,11,19,0.977,0.934
2004/4/6,945,6700,-28,49,30,19,0.98,0.648
2004/4/6,1045,6680,-20,38,23,15,0.986,1.212
2004/4/6,1145,6673,-7,18,15,3,0.99,2.719
2004/4/6,1245,6675,3,50,32,18,0.992,1.302
2004/4/6,1345,6660,-15,26,17,9,0.997,1.197
2004/4/7,945,6634,-17,29,33,-4,1.003,1.13
2004/4/7,1045,6653,18,23,5,18,1.001,2.159
2004/4/7,1145,6649,-5,18,15,3,1.003,2.291
2004/4/7,1245,6649,-1,20,11,9,1.003,2.706
2004/4/7,1345,6665,15,30,9,21,1,1.076
2004/4/8,945,6662,-7,26,22,4,1,0.761
2004/4/8,1045,6665,3,14,2,12,0.999,1.362
2004/4/8,1145,6673,7,16,-1,17,0.997,1.817
2004/4/8,1245,6670,-3,13,10,3,0.998,1.685
2004/4/8,1345,6681,11,22,9,13,0.996,0.951
2004/4/9,945,6622,-39,53,32,21,1.005,0.43
2004/4/9,1045,6604,-17,39,17,22,1.008,0.594
2004/4/9,1145,6610,5,20,8,12,1.006,1.934
2004/4/9,1245,6601,-10,20,9,11,1.007,1.498
2004/4/9,1345,6625,25,20,-7,27,1.002,1.181
2004/4/12,945,6761,113,132,22,110,0.982,0.329
2004/4/12,1045,6806,45,51,9,42,0.977,0.721
2004/4/12,1145,6802,-4,28,14,14,0.979,1.306
2004/4/12,1245,6809,7,19,4,15,0.98,2.17
2004/4/12,1345,6800,-8,21,17,4,0.984,1.254
2004/4/13,945,6809,-1,24,6,18,0.985,1.093
2004/4/13,1045,6822,13,28,11,17,0.985,1.002
2004/4/13,1145,6796,-25,32,32,0,0.992,1.417
2004/4/13,1245,6788,-8,28,12,16,0.996,1.188
2004/4/13,1345,6823,35,42,1,41,0.994,1.312
2004/4/14,945,6801,30,30,2,28,0.999,0.792
2004/4/14,1045,6842,41,62,13,49,0.994,0.832
2004/4/14,1145,6827,-14,31,27,4,0.996,0.836
2004/4/14,1245,6812,-16,36,14,22,0.999,0.855
2004/4/14,1345,6920,109,112,5,107,0.983,0.494
2004/4/15,945,6871,-26,73,53,20,0.992,0.608
2004/4/15,1045,6840,-31,52,42,10,0.997,0.809
2004/4/15,1145,6865,25,34,4,30,0.994,1.418
2004/4/15,1245,6785,-80,72,78,-6,1.006,0.879
2004/4/15,1345,6749,-44,66,40,26,1.012,0.691
2004/4/16,945,6768,32,32,7,25,1.008,1.232
2004/4/16,1045,6818,52,73,11,62,1,1.278
2004/4/16,1145,6810,-7,68,46,22,1.001,0.915
2004/4/16,1245,6850,39,58,15,43,0.995,1.309
2004/4/16,1345,6828,-24,33,30,3,0.999,1.419
2004/4/19,945,6813,-15,66,41,25,1,1.23
2004/4/19,1045,6780,-33,77,57,20,1.004,1.121
2004/4/19,1145,6785,6,40,5,35,1.003,1.703
2004/4/19,1245,6797,11,36,11,25,1,2.081
2004/4/19,1345,6809,11,43,-6,49,0.998,1.271
2004/4/20,945,6871,47,68,28,40,0.99,0.77
2004/4/20,1045,6825,-45,67,48,19,0.998,1.324
2004/4/20,1145,6840,14,40,12,28,0.996,1.934
2004/4/20,1245,6832,-8,27,16,11,0.998,2.628
2004/4/20,1345,6839,4,25,5,20,0.997,1.665
2004/4/21,945,6838,23,37,6,31,0.997,1.585
2004/4/21,1045,6830,-8,17,9,8,0.998,2.961
2004/4/21,1145,6840,10,13,2,11,0.997,2.775
2004/4/21,1245,6830,-10,28,18,10,1,1.643
2004/4/21,1345,6824,-7,18,13,5,1.001,1.161
2004/4/22,945,6902,42,69,13,56,0.99,0.233
2004/4/22,1045,6905,1,22,-3,25,0.99,0.795
2004/4/22,1145,6877,-28,59,43,16,0.996,0.455
2004/4/22,1245,6755,-120,222,128,94,1.014,0.426
2004/4/22,1345,6718,-52,90,52,38,1.019,0.406
2004/4/23,945,6750,-25,51,34,17,1.013,0.759
2004/4/23,1045,6750,0,59,15,44,1.012,1.218
2004/4/23,1145,6744,-6,29,20,9,1.012,2.81
2004/4/23,1245,6734,-10,26,32,-6,1.012,2.573
2004/4/23,1345,6750,16,27,9,18,1.008,2.33
2004/4/26,945,6737,-14,43,18,25,1.008,1.398
2004/4/26,1045,6753,14,31,15,16,1.003,1.561
2004/4/26,1145,6743,-9,19,9,10,1.003,2.376
2004/4/26,1245,6728,-17,31,25,6,1.003,2.368
2004/4/26,1345,6720,-9,18,16,2,1.004,1.158
2004/4/27,945,6684,-28,50,46,4,1.008,0.573
2004/4/27,1045,6656,-27,32,18,14,1.011,0.491
2004/4/27,1145,6646,-9,22,24,-2,1.011,1.318
2004/4/27,1245,6644,-3,41,5,36,1.01,0.636
2004/4/27,1345,6680,36,35,-5,40,1.003,0.843
2004/4/28,945,6669,10,37,15,22,1.004,0.812
2004/4/28,1045,6641,-25,31,25,6,1.007,1.164
2004/4/28,1145,6641,0,26,16,10,1.005,1.732
2004/4/28,1245,6612,-28,49,31,18,1.008,0.766
2004/4/28,1345,6605,-5,40,35,5,1.007,1.05
2004/4/29,945,6538,-17,39,14,25,1.015,0.629
2004/4/29,1045,6493,-44,64,45,19,1.02,0.775
2004/4/29,1145,6476,-17,26,32,-6,1.02,1.698
2004/4/29,1245,6339,-137,147,138,9,1.039,0.53
2004/4/29,1345,6399,59,88,16,72,1.025,0.697
2004/4/30,945,6283,-78,88,63,25,1.039,0.623
2004/4/30,1045,6135,-146,173,160,13,1.058,0.691
2004/4/30,1145,6009,-125,164,116,48,1.072,0.617
2004/4/30,1245,6080,72,139,22,117,1.049,1.085
2004/4/30,1345,6020,-60,106,140,-34,1.05,0.969
2004/5/3,945,6082,32,140,28,112,1.031,0.935
2004/5/3,1045,6083,0,55,37,18,1.024,1.748
2004/5/3,1145,6074,-8,50,12,38,1.019,1.919
2004/5/3,1245,6070,-4,51,19,32,1.013,2.485
2004/5/3,1345,6017,-51,78,51,27,1.017,1.41
2004/5/4,945,6065,-16,30,30,0,1.004,1.263
2004/5/4,1045,6079,16,40,14,26,0.998,1.562
2004/5/4,1145,6093,13,44,23,21,0.995,1.354
2004/5/4,1245,6150,59,56,-6,62,0.987,1.047
2004/5/4,1345,6133,-17,38,35,3,0.991,0.9
2004/5/5,945,6021,-114,139,128,11,1.011,0.701
2004/5/5,1045,5941,-80,159,68,91,1.024,0.474
2004/5/5,1145,5935,-6,89,29,60,1.022,0.983
2004/5/5,1245,5871,-64,97,77,20,1.031,1.011
2004/5/5,1345,5725,-145,135,140,-5,1.054,0.617
2004/5/6,945,5858,61,149,92,57,1.025,0.699
2004/5/6,1045,5814,-44,150,86,64,1.029,0.956
2004/5/6,1145,5888,74,118,42,76,1.012,1.001
2004/5/6,1245,5918,30,57,27,30,1.003,1.164
2004/5/6,1345,5849,-67,123,116,7,1.011,1.123
2004/5/7,945,5875,75,128,44,84,1.001,1.064
2004/5/7,1045,5888,13,56,41,15,0.996,1.422
2004/5/7,1145,5938,52,71,20,51,0.987,1.42
2004/5/7,1245,5947,11,52,40,12,0.986,1.45
2004/5/7,1345,5979,33,44,16,28,0.982,1.421
2004/5/10,945,5798,-129,197,100,97,1.014,0.562
2004/5/10,1045,5769,-29,64,46,18,1.018,1.733
2004/5/10,1145,5775,9,40,20,20,1.017,2.559
2004/5/10,1245,5770,-4,45,5,40,1.016,1.606
2004/5/10,1345,5751,-17,44,29,15,1.016,1.471
2004/5/11,945,5786,-30,88,64,24,1.01,0.707
2004/5/11,1045,5761,-29,143,38,105,1.013,0.576
2004/5/11,1145,5793,32,77,17,60,1.006,1.031
2004/5/11,1245,5835,41,62,9,53,0.996,1.134
2004/5/11,1345,5858,27,63,20,43,0.99,0.881
2004/5/12,945,5948,20,49,11,38,0.975,0.784
2004/5/12,1045,5973,25,33,15,18,0.973,1.254
2004/5/12,1145,5981,9,38,14,24,0.976,1.833
2004/5/12,1245,5963,-17,49,41,8,0.982,1.637
2004/5/12,1345,5942,-24,40,29,11,0.989,1.04
2004/5/13,945,5945,25,90,-5,95,0.99,0.766
2004/5/13,1045,5896,-50,55,49,6,1.001,1.322
2004/5/13,1145,5882,-13,43,37,6,1.006,1.543
2004/5/13,1245,5878,-4,37,9,28,1.008,1.079
2004/5/13,1345,5890,7,45,10,35,1.007,1.13
2004/5/14,945,5862,-46,80,83,-3,1.011,0.779
2004/5/14,1045,5764,-103,145,103,42,1.027,0.519
2004/5/14,1145,5774,10,49,21,28,1.022,1.27
2004/5/14,1245,5752,-23,70,53,17,1.022,1.223
2004/5/14,1345,5745,-7,53,28,25,1.019,1.218
2004/5/17,945,5541,-154,169,129,40,1.053,0.601
2004/5/17,1045,5450,-91,119,104,15,1.063,1.074
2004/5/17,1145,5372,-80,122,93,29,1.07,0.83
2004/5/17,1245,5386,14,56,33,23,1.058,1.582
2004/5/17,1345,5358,-28,39,37,2,1.054,1.401
2004/5/18,945,5555,126,164,-5,169,1.008,0.727
2004/5/18,1045,5542,-13,54,14,40,1.005,1.557
2004/5/18,1145,5493,-49,52,49,3,1.01,2.079
2004/5/18,1245,5476,-17,50,49,1,1.008,2.017
2004/5/18,1345,5523,47,64,7,57,0.994,1.763
2004/5/19,945,5752,160,158,16,142,0.953,0.937
2004/5/19,1045,5818,66,96,20,76,0.946,1.78
2004/5/19,1145,5828,13,50,37,13,0.95,2.486
2004/5/19,1245,5840,12,15,0,15,0.956,5.022
2004/5/19,1345,5891,47,74,18,56,0.956,1.611
2004/5/20,945,5781,6,145,44,101,0.98,0.327
2004/5/20,1045,5793,12,57,15,42,0.982,0.864
2004/5/20,1145,5812,18,120,63,57,0.983,0.428
2004/5/20,1245,5654,-156,262,196,66,1.016,0.402
2004/5/20,1345,5685,37,85,12,73,1.013,0.774
2004/5/21,945,5762,28,110,18,92,1.002,0.666
2004/5/21,1045,5834,72,94,16,78,0.99,0.713
2004/5/21,1145,5868,34,86,22,64,0.985,1.066
2004/5/21,1245,5893,25,35,17,18,0.981,1.469
2004/5/21,1345,5840,-52,69,75,-6,0.991,1.403
2004/5/24,945,5801,-77,114,69,45,0.999,1.01
2004/5/24,1045,5940,136,174,25,149,0.976,0.864
2004/5/24,1145,5905,-31,55,30,25,0.985,1.536
2004/5/24,1245,5900,-5,53,18,35,0.987,1.816
2004/5/24,1345,5871,-29,82,52,30,0.996,1.241
2004/5/25,945,5902,112,133,11,122,0.992,0.733
2004/5/25,1045,5895,-4,52,30,22,0.995,1.219
2004/5/25,1145,5877,-18,47,13,34,0.999,1.412
2004/5/25,1245,5864,-13,50,21,29,1.002,1.358
2004/5/25,1345,5841,-24,27,27,0,1.005,2.04
2004/5/26,945,6036,36,88,34,54,0.975,0.616
2004/5/26,1045,6022,-12,27,17,10,0.981,1.433
2004/5/26,1145,5989,-34,60,42,18,0.988,1.016
2004/5/26,1245,5988,-1,24,9,15,0.989,2.187
2004/5/26,1345,5990,2,34,19,15,0.99,1.058
2004/5/27,945,5963,-47,80,62,18,0.999,0.644
2004/5/27,1045,5969,5,25,16,9,0.999,1.889
2004/5/27,1145,5957,-12,23,21,2,1.002,2.865
2004/5/27,1245,5969,9,24,6,18,1.001,2.31
2004/5/27,1345,6001,31,41,3,38,0.998,1.084
2004/5/28,945,6013,-40,59,49,10,0.997,0.62
2004/5/28,1045,6018,6,35,7,28,0.995,1.236
2004/5/28,1145,6025,8,31,13,18,0.994,1.444
2004/5/28,1245,6040,15,27,3,24,0.992,1.592
2004/5/28,1345,6043,3,39,23,16,0.993,0.791
2004/5/31,945,5988,-49,39,43,-4,1.002,0.677
2004/5/31,1045,5957,-28,46,29,17,1.008,0.613
2004/5/31,1145,5907,-49,67,55,12,1.016,1.054
2004/5/31,1245,5917,11,31,5,26,1.014,1.323
2004/5/31,1345,5928,13,37,-6,43,1.011,0.986
2004/6/1,945,5825,-105,142,127,15,1.027,0.448
2004/6/1,1045,5836,8,25,12,13,1.021,1.39
2004/6/1,1145,5880,42,72,28,44,1.011,0.815
2004/6/1,1245,5880,3,65,40,25,1.008,1.194
2004/6/1,1345,5906,26,44,19,25,1.001,1.151
2004/6/2,945,5833,-18,98,15,83,1.01,0.584
2004/6/2,1045,5811,-22,42,24,18,1.012,1.391
2004/6/2,1145,5803,-9,40,22,18,1.011,2.119
2004/6/2,1245,5809,6,35,21,14,1.008,2.103
2004/6/2,1345,5790,-18,25,25,0,1.009,1.479
2004/6/3,945,5824,10,50,21,29,1.001,0.755
2004/6/3,1045,5800,-24,38,23,15,1.005,1.208
2004/6/3,1145,5777,-27,25,40,-15,1.009,1.58
2004/6/3,1245,5668,-112,155,120,35,1.026,0.46
2004/6/3,1345,5580,-88,119,93,26,1.039,0.611
2004/6/4,945,5553,-62,92,69,23,1.04,0.577
2004/6/4,1045,5585,33,53,13,40,1.029,1.161
2004/6/4,1145,5610,26,58,30,28,1.02,0.951
2004/6/4,1245,5600,-10,39,35,4,1.018,1.6
2004/6/4,1345,5607,4,41,30,11,1.013,1.935
2004/6/7,945,5796,109,117,16,101,0.978,0.527
2004/6/7,1045,5825,30,46,9,37,0.973,1.191
2004/6/7,1145,5827,5,31,13,18,0.973,2.035
2004/6/7,1245,5833,5,32,15,17,0.973,2.247
2004/6/7,1345,5890,55,76,19,57,0.966,0.893
2004/6/8,945,5936,-14,53,38,15,0.964,0.813
2004/6/8,1045,5953,17,44,2,42,0.968,1.669
2004/6/8,1145,5910,-42,104,58,46,0.981,0.749
2004/6/8,1245,5968,58,55,-3,58,0.977,1.69
2004/6/8,1345,5981,13,48,5,43,0.981,1.021
2004/6/9,945,5958,-1,39,22,17,0.989,1.119
2004/6/9,1045,5968,10,41,27,14,0.99,1.273
2004/6/9,1145,5960,-7,21,16,5,0.994,2.145
2004/6/9,1245,5956,-3,38,28,10,0.997,1.554
2004/6/9,1345,5960,4,38,0,38,0.998,1.06
2004/6/10,945,5901,-5,47,18,29,1.007,0.62
2004/6/10,1045,5816,-84,119,83,36,1.021,0.538
2004/6/10,1145,5796,-21,51,18,33,1.023,0.935
2004/6/10,1245,5821,25,41,12,29,1.016,1.316
2004/6/10,1345,5840,19,34,9,25,1.01,0.893
2004/6/11,945,5735,-45,67,35,32,1.026,0.718
2004/6/11,1045,5710,-25,71,29,42,1.026,0.772
2004/6/11,1145,5720,10,34,16,18,1.02,2.182
2004/6/11,1245,5699,-21,38,30,8,1.02,2.225
2004/6/11,1345,5715,17,33,-6,39,1.012,1.291
2004/6/14,945,5753,61,109,42,67,1.002,0.891
2004/6/14,1045,5723,-29,48,48,0,1.005,1.513
2004/6/14,1145,5682,-41,55,66,-11,1.01,1.626
2004/6/14,1245,5561,-124,137,117,20,1.03,0.599
2004/6/14,1345,5540,-25,60,35,25,1.029,0.755
2004/6/15,945,5484,-56,109,85,24,1.036,0.809
2004/6/15,1045,5541,60,124,37,87,1.02,0.865
2004/6/15,1145,5611,69,101,15,86,1.005,1.142
2004/6/15,1245,5623,10,55,23,32,1.001,1.531
2004/6/15,1345,5604,-18,45,24,21,1.003,1.905
2004/6/16,945,5642,-18,124,98,26,0.995,0.931
2004/6/16,1045,5626,-17,114,44,70,0.996,1.907
2004/6/16,1145,5545,-75,99,77,22,1.009,2.375
2004/6/16,1245,5549,4,60,11,49,1.006,2.59
2004/6/16,1345,5560,12,34,20,14,1.003,2.022
2004/6/17,945,5628,178,180,-8,188,0.99,0.304
2004/6/17,1045,5604,-32,76,64,12,0.997,0.478
2004/6/17,1145,5557,-47,98,53,45,1.006,0.544
2004/6/17,1245,5598,39,95,12,83,0.998,0.86
2004/6/17,1345,5607,9,39,7,32,0.996,1.099
2004/6/18,945,5488,-84,135,82,53,1.016,0.498
2004/6/18,1045,5468,-18,75,42,33,1.017,0.945
2004/6/18,1145,5460,-9,47,33,14,1.015,2.272
2004/6/18,1245,5457,-3,45,18,27,1.014,1.732
2004/6/18,1345,5463,6,53,36,17,1.012,1.691
2004/6/21,945,5507,-93,151,132,19,1.006,0.639
2004/6/21,1045,5522,15,63,36,27,1.001,1.363
2004/6/21,1145,5492,-30,76,65,11,1.005,1.5
2004/6/21,1245,5475,-20,56,33,23,1.007,1.33
2004/6/21,1345,5538,63,62,-6,68,0.993,1.47
2004/6/23,945,5701,126,151,2,149,0.965,0.411
2004/6/23,1045,5699,-2,38,9,29,0.969,1.084
2004/6/23,1145,5696,-3,42,18,24,0.974,1.927
2004/6/23,1245,5680,-18,50,25,25,0.981,1.721
2004/6/23,1345,5660,-21,32,27,5,0.988,1.761
2004/6/24,945,5671,-49,75,64,11,0.988,0.734
2004/6/24,1045,5703,31,36,1,35,0.986,1.668
2004/6/24,1145,5713,9,35,17,18,0.987,1.191
2004/6/24,1245,5724,11,34,2,32,0.989,1.545
2004/6/24,1345,5712,-12,29,22,7,0.995,1.523
2004/6/25,945,5713,25,53,12,41,0.997,0.742
2004/6/25,1045,5706,-7,23,18,5,0.999,1.402
2004/6/25,1145,5760,54,62,9,53,0.989,0.722
2004/6/25,1245,5746,-12,34,27,7,0.993,1.079
2004/6/25,1345,5735,-11,27,7,20,0.996,0.986
2004/6/28,945,5616,-118,151,130,21,1.017,0.419
2004/6/28,1045,5602,-14,41,28,13,1.019,1.42
2004/6/28,1145,5619,19,28,6,22,1.014,1.618
2004/6/28,1245,5625,7,22,13,9,1.011,2.593
2004/6/28,1345,5615,-9,30,33,-3,1.011,1.354
2004/6/29,945,5615,23,75,15,60,1.009,0.732
2004/6/29,1045,5609,-7,33,16,17,1.009,1.399
2004/6/29,1145,5618,9,22,4,18,1.005,2.278
2004/6/29,1245,5632,14,28,13,15,1,1.559
2004/6/29,1345,5644,11,23,10,13,0.996,1.021
2004/6/30,945,5767,100,116,29,87,0.974,0.345
2004/6/30,1045,5757,-13,30,24,6,0.978,1.128
2004/6/30,1145,5757,0,30,8,22,0.981,1.211
2004/6/30,1245,5766,8,26,11,15,0.982,1.876
2004/6/30,1345,5750,-17,35,30,5,0.987,1.146
2004/7/1,945,5756,-38,71,35,36,0.99,0.617
2004/7/1,1045,5758,1,41,17,24,0.992,1.368
2004/7/1,1145,5756,-5,17,16,1,0.995,2.456
2004/7/1,1245,5757,0,24,23,1,0.997,2.017
2004/7/1,1345,5765,8,21,0,21,0.998,1.834
2004/7/2,945,5635,15,67,16,51,1.02,0.475
2004/7/2,1045,5644,7,24,13,11,1.016,1.424
2004/7/2,1145,5644,1,19,14,5,1.014,2.269
2004/7/2,1245,5641,-3,22,14,8,1.012,2.547
2004/7/2,1345,5655,14,12,-3,15,1.008,1.435
2004/7/5,945,5575,-7,56,35,21,1.018,0.52
2004/7/5,1045,5561,-14,42,23,19,1.018,1.097
2004/7/5,1145,5566,5,18,7,11,1.013,1.869
2004/7/5,1245,5589,24,32,9,23,1.005,1.592
2004/7/5,1345,5597,8,23,12,11,1.001,1.052
2004/7/6,945,5609,-13,47,24,23,0.999,0.609
2004/7/6,1045,5582,-27,38,24,14,1.003,0.793
2004/7/6,1145,5600,17,25,5,20,0.999,1.804
2004/7/6,1245,5613,12,19,5,14,0.996,1.421
2004/7/6,1345,5667,54,70,9,61,0.986,0.571
2004/7/7,945,5578,28,55,9,46,1.001,0.61
2004/7/7,1045,5630,53,56,5,51,0.992,0.643
2004/7/7,1145,5640,10,21,8,13,0.991,1.041
2004/7/7,1245,5666,26,41,22,19,0.988,0.748
2004/7/7,1345,5650,-16,32,28,4,0.992,1.167
2004/7/7,945,5703,5703,174,101,73,0.884,1.551
2004/7/8,1045,5650,-54,74,57,17,0.894,0.913
2004/7/8,1145,5648,-1,61,9,52,0.896,0.834
2004/7/8,1245,5638,-11,30,17,13,0.898,1.88
2004/7/8,1345,5634,-4,26,12,14,0.899,1.598
2004/7/9,945,5625,-16,81,71,10,0.903,0.644
2004/7/9,1045,5630,6,54,10,44,0.903,0.757
2004/7/9,1145,5645,14,36,11,25,0.9,1.639
2004/7/9,1245,5682,37,49,13,36,0.894,0.742
2004/7/9,1345,5707,25,43,17,26,0.891,0.786
2004/7/12,945,5706,-27,68,55,13,0.991,0.739
2004/7/12,1045,5706,0,33,28,5,0.991,1.717
2004/7/12,1145,5711,5,21,6,15,0.992,1.915
2004/7/12,1245,5715,4,25,12,13,0.992,2.915
2004/7/12,1345,5707,-9,26,13,13,0.995,1.904
2004/7/13,945,5658,-28,40,36,4,1.004,0.725
2004/7/13,1045,5665,9,18,9,9,1.003,1.674
2004/7/13,1145,5678,13,24,7,17,1.002,2.105
2004/7/13,1245,5682,4,16,3,13,1.002,2.677
2004/7/13,1345,5661,-21,27,22,5,1.005,1.155
2004/7/14,945,5659,16,50,23,27,1.004,0.471
2004/7/14,1045,5621,-38,52,36,16,1.01,0.466
2004/7/14,1145,5635,14,17,4,13,1.006,1.878
2004/7/14,1245,5624,-11,45,33,12,1.007,0.992
2004/7/14,1345,5608,-14,28,17,11,1.008,0.761
2004/7/15,945,5552,-50,84,68,16,1.016,0.452
2004/7/15,1045,5526,-26,79,35,44,1.019,0.731
2004/7/15,1145,5526,1,21,8,13,1.017,1.917
2004/7/15,1245,5509,-17,33,19,14,1.017,1.668
2004/7/15,1345,5550,42,52,-5,57,1.007,1.076
2004/7/16,945,5542,41,71,25,46,1.005,0.716
2004/7/16,1045,5542,-1,20,11,9,1.003,1.84
2004/7/16,1145,5567,25,41,15,26,0.997,1.175
2004/7/16,1245,5547,-20,35,28,7,1,1.727
2004/7/16,1345,5505,-44,54,49,5,1.006,0.923
2004/7/19,945,5500,9,83,45,38,1.005,0.746
2004/7/19,1045,5471,-29,80,31,49,1.009,0.701
2004/7/19,1145,5448,-23,40,32,8,1.013,1.606
2004/7/19,1245,5470,22,26,7,19,1.007,1.854
2004/7/19,1345,5511,41,44,4,40,0.999,1.109
2004/7/20,945,5473,13,40,12,28,1.005,1.028
2004/7/20,1045,5455,-18,33,12,21,1.007,1.397
2004/7/20,1145,5376,-79,78,78,0,1.02,0.992
2004/7/20,1245,5357,-19,42,37,5,1.02,1.283
2004/7/20,1345,5300,-57,76,57,19,1.028,0.745
2004/7/21,945,5404,47,76,26,50,1.006,1.119
2004/7/21,1045,5395,-9,39,35,4,1.005,1.831
2004/7/21,1145,5369,-25,49,36,13,1.009,1.744
2004/7/21,1245,5406,36,37,0,37,1.001,2.742
2004/7/21,1345,5418,11,22,2,20,0.997,1.309
2004/7/22,945,5253,4,48,2,46,1.024,0.408
2004/7/22,1045,5263,10,33,7,26,1.018,0.77
2004/7/22,1145,5272,10,30,15,15,1.013,0.817
2004/7/22,1245,5276,5,40,9,31,1.01,1.021
2004/7/22,1345,5291,14,37,17,20,1.006,0.699
2004/7/23,945,5325,34,57,5,52,0.998,0.52
2004/7/23,1045,5311,-14,37,28,9,0.999,0.877
2004/7/23,1145,5299,-11,29,11,18,1,1.016
2004/7/23,1245,5293,-6,24,12,12,1,2.229
2004/7/23,1345,5285,-9,20,17,3,0.999,1.735
2004/7/26,945,5253,23,35,7,28,1.005,0.78
2004/7/26,1045,5252,-2,28,11,17,1.005,2.119
2004/7/26,1145,5245,-6,18,10,8,1.006,2.801
2004/7/26,1245,5260,15,34,19,15,1.003,1.488
2004/7/26,1345,5275,12,17,0,17,1,1.738
2004/7/27,945,5250,-20,43,39,4,1.004,0.633
2004/7/27,1045,5256,6,41,4,37,1.002,0.6
2004/7/27,1145,5331,75,82,14,68,0.986,0.402
2004/7/27,1245,5362,31,61,32,29,0.981,0.567
2004/7/27,1345,5353,-9,31,24,7,0.984,1.165
2004/7/28,945,5356,-42,37,41,-4,0.987,0.696
2004/7/28,1045,5351,-7,35,24,11,0.99,1.229
2004/7/28,1145,5366,15,37,13,24,0.989,1.438
2004/7/28,1245,5357,-10,18,11,7,0.993,2.066
2004/7/28,1345,5360,-4,18,5,13,0.994,1.9
2004/7/29,945,5323,-32,49,32,17,1.003,0.852
2004/7/29,1045,5321,-2,39,31,8,1.004,1.216
2004/7/29,1145,5324,3,24,10,14,1.005,1.589
2004/7/29,1245,5325,1,20,13,7,1.005,2.119
2004/7/29,1345,5297,-28,52,36,16,1.009,0.667
2004/7/30,945,5384,47,65,23,42,0.992,0.408
2004/7/30,1045,5377,-8,35,26,9,0.994,0.94
2004/7/30,1145,5381,6,18,8,10,0.993,1.964
2004/7/30,1245,5380,-1,25,17,8,0.994,1.839
2004/7/30,1345,5356,-24,26,27,-1,0.998,1.215
2004/8/2,945,5291,-32,43,24,19,1.01,0.626
2004/8/2,1045,5283,-10,27,9,18,1.011,1.274
2004/8/2,1145,5285,2,20,5,15,1.01,2.693
2004/8/2,1245,5268,-17,29,20,9,1.013,2.231
2004/8/2,1345,5280,14,29,4,25,1.009,1.292
2004/8/3,945,5290,-15,51,26,25,1.007,0.622
2004/8/3,1045,5287,-4,23,13,10,1.005,1.637
2004/8/3,1145,5307,19,46,12,34,1,0.97
2004/8/3,1245,5298,-10,19,9,10,1,1.324
2004/8/3,1345,5282,-16,16,22,-6,1.002,1.505
2004/8/4,945,5234,-16,42,32,10,1.01,0.522
2004/8/4,1045,5226,-6,32,18,14,1.01,0.786
2004/8/4,1145,5233,6,15,5,10,1.008,1.551
2004/8/4,1245,5224,-8,18,10,8,1.008,1.849
2004/8/4,1345,5254,30,26,-4,30,1.002,1.077
2004/8/5,945,5250,-9,59,44,15,1.002,0.484
2004/8/5,1045,5228,-22,30,27,3,1.005,1.134
2004/8/5,1145,5305,78,75,-16,91,0.989,0.631
2004/8/5,1245,5377,72,106,16,90,0.976,0.415
2004/8/5,1345,5399,23,37,11,26,0.973,0.78
2004/8/6,945,5352,17,33,16,17,0.984,0.91
2004/8/6,1045,5393,39,56,15,41,0.978,0.962
2004/8/6,1145,5376,-16,39,24,15,0.985,1.66
2004/8/6,1245,5371,-6,22,22,0,0.988,2.313
2004/8/6,1345,5369,-2,25,11,14,0.991,1.482
2004/8/9,945,5312,12,53,12,41,1.003,0.791
2004/8/9,1045,5322,7,32,20,12,1.002,1.916
2004/8/9,1145,5331,9,21,4,17,1.002,3.473
2004/8/9,1245,5347,15,28,11,17,1,1.387
2004/8/9,1345,5380,34,45,10,35,0.993,0.846
2004/8/10,945,5366,-19,42,24,18,0.996,0.805
2004/8/10,1045,5360,-5,29,25,4,0.998,1.442
2004/8/10,1145,5354,-4,20,8,12,0.998,1.052
2004/8/10,1245,5376,23,38,4,34,0.994,1.212
2004/8/10,1345,5364,-13,21,13,8,0.996,1.497
2004/8/11,945,5387,-13,35,22,13,0.994,0.526
2004/8/11,1045,5377,-10,20,8,12,0.997,1.332
2004/8/11,1145,5368,-8,19,17,2,0.999,2.017
2004/8/11,1245,5336,-32,50,40,10,1.006,0.713
2004/8/11,1345,5325,-11,45,12,33,1.008,0.54
2004/8/12,945,5321,11,37,19,18,1.007,0.839
2004/8/12,1045,5325,4,25,8,17,1.006,1.431
2004/8/12,1145,5327,3,14,8,6,1.005,2.047
2004/8/12,1245,5331,4,19,14,5,1.004,1.762
2004/8/12,1345,5348,17,22,-2,24,1,1.819
2004/8/13,945,5322,22,37,8,29,1.003,0.602
2004/8/13,1045,5328,4,20,12,8,1,1.158
2004/8/13,1145,5388,60,68,8,60,0.988,0.627
2004/8/13,1245,5374,-14,27,19,8,0.991,0.906
2004/8/13,1345,5356,-16,19,13,6,0.995,1.018
2004/8/16,945,5338,-1,31,7,24,0.999,0.962
2004/8/16,1045,5335,-1,19,5,14,1,2.353
2004/8/16,1145,5333,-4,15,15,0,1,2.758
2004/8/16,1245,5340,7,20,10,10,0.999,2.325
2004/8/16,1345,5331,-9,16,15,1,1.001,1.658
2004/8/17,945,5342,-20,39,30,9,1,0.881
2004/8/17,1045,5339,-3,30,7,23,1.001,1.019
2004/8/17,1145,5355,14,25,5,20,0.998,1.248
2004/8/17,1245,5346,-9,13,8,5,0.999,1.839
2004/8/17,1345,5339,-7,20,9,11,1,0.931
2004/8/18,945,5315,-13,54,34,20,1.005,0.789
2004/8/18,1045,5385,73,90,13,77,0.991,0.64
2004/8/18,1145,5404,19,35,18,17,0.988,0.975
2004/8/18,1245,5399,-6,21,20,1,0.991,1.917
2004/8/18,1345,5423,24,25,0,25,0.987,1.125
2004/8/19,945,5475,48,57,3,54,0.979,0.307
2004/8/19,1045,5476,1,24,18,6,0.981,0.672
2004/8/19,1145,5502,25,32,1,31,0.979,1.005
2004/8/19,1245,5505,3,19,0,19,0.981,1.257
2004/8/19,1345,5528,23,43,20,23,0.98,0.712
2004/8/20,945,5553,11,39,12,27,0.98,0.684
2004/8/20,1045,5580,27,45,8,37,0.979,0.971
2004/8/20,1145,5593,14,45,32,13,0.98,0.719
2004/8/20,1245,5578,-13,31,18,13,0.986,1.209
2004/8/20,1345,5583,3,23,6,17,0.989,1.657
2004/8/23,945,5583,-30,44,37,7,0.992,0.916
2004/8/23,1045,5604,20,39,11,28,0.99,1.391
2004/8/23,1145,5599,-5,27,29,-2,0.993,1.468
2004/8/23,1245,5609,11,15,3,12,0.993,3.673
2004/8/23,1345,5606,-4,26,12,14,0.996,1.553
2004/8/26,945,5758,36,94,36,58,0.973,0.457
2004/8/26,1045,5775,17,30,10,20,0.973,1.18
2004/8/26,1145,5789,13,25,11,14,0.974,1.01
2004/8/26,1245,5802,13,27,8,19,0.976,1.62
2004/8/26,1345,5783,-20,33,30,3,0.983,0.839
2004/8/27,945,5774,-26,32,16,16,0.987,0.879
2004/8/27,1045,5788,15,22,7,15,0.988,1.53
2004/8/27,1145,5803,16,20,4,16,0.989,1.45
2004/8/27,1245,5784,-18,43,34,9,0.996,0.973
2004/8/27,1345,5810,26,21,-6,27,0.994,1.649
2004/8/30,945,5790,-20,38,29,9,0.999,0.809
2004/8/30,1045,5788,-3,19,8,11,1,1.279
2004/8/30,1145,5786,-3,9,6,3,1.001,3.101
2004/8/30,1245,5788,2,19,15,4,1,1.575
2004/8/30,1345,5785,-4,19,14,5,1.001,1.176
2004/8/31,945,5836,70,77,-4,81,0.991,0.392
2004/8/31,1045,5848,11,39,27,12,0.99,0.461
2004/8/31,1145,5843,-6,28,25,3,0.992,1.27
2004/8/31,1245,5758,-85,111,87,24,1.008,0.385
2004/8/31,1345,5763,5,28,8,20,1.006,1.045
2004/9/1,945,5844,44,74,23,51,0.992,0.545
2004/9/1,1045,5827,-15,39,25,14,0.996,1.163
2004/9/1,1145,5840,14,32,12,20,0.994,1.665
2004/9/1,1245,5845,5,25,6,19,0.994,2.841
2004/9/1,1345,5856,10,24,3,21,0.993,1.648
2004/9/2,945,5805,-45,64,53,11,1.004,0.73
2004/9/2,1045,5823,17,33,12,21,1,1.484
2004/9/2,1145,5831,9,23,2,21,0.998,2.516
2004/9/2,1245,5828,-3,16,8,8,0.998,2.88
2004/9/2,1345,5840,13,35,10,25,0.998,1.458
2004/9/3,945,5845,-5,50,25,25,0.998,0.527
2004/9/3,1045,5807,-41,64,42,22,1.004,0.561
2004/9/3,1145,5762,-45,39,43,-4,1.012,0.706
2004/9/3,1245,5766,3,29,9,20,1.01,1.042
2004/9/3,1345,5762,-4,22,13,9,1.009,1.102
2004/9/6,945,5730,-23,44,38,6,1.013,0.851
2004/9/6,1045,5727,-2,27,15,12,1.012,1.268
2004/9/6,1145,5735,7,15,4,11,1.009,3.062
2004/9/6,1245,5782,45,47,6,41,0.999,0.875
2004/9/6,1345,5780,-2,24,5,19,0.999,1.474
2004/9/7,945,5822,51,74,15,59,0.99,0.591
2004/9/7,1045,5798,-24,41,29,12,0.994,0.935
2004/9/7,1145,5807,7,30,11,19,0.992,1.813
2004/9/7,1245,5806,-1,29,14,15,0.993,1.749
2004/9/7,1345,5840,34,39,2,37,0.988,0.956
2004/9/8,945,5840,-10,53,39,14,0.99,0.583
2004/9/8,1045,5855,16,35,0,35,0.989,1.038
2004/9/8,1145,5850,-6,19,14,5,0.992,1.853
2004/9/8,1245,5837,-13,23,13,10,0.996,1.613
2004/9/8,1345,5828,-10,32,14,18,0.999,1.191
2004/9/9,945,5835,23,57,7,50,0.998,0.689
2004/9/9,1045,5832,-5,30,22,8,0.999,1.203
2004/9/9,1145,5822,-11,24,14,10,1.001,1.966
2004/9/9,1245,5834,12,20,4,16,1,2.505
2004/9/9,1345,5843,8,19,4,15,0.999,1.344
2004/9/10,945,5847,2,38,28,10,0.998,0.57
2004/9/10,1045,5825,-21,40,30,10,1.002,0.743
2004/9/10,1145,5833,8,24,9,15,1,1.384
2004/9/10,1245,5837,4,18,-3,21,0.999,1.739
2004/9/10,1345,5841,3,24,8,16,0.998,1.004
2004/9/13,945,5922,22,34,16,18,0.986,0.531
2004/9/13,1045,5916,-7,22,7,15,0.988,1.29
2004/9/13,1145,5928,11,20,-3,23,0.988,1.67
2004/9/13,1245,5929,1,17,6,11,0.989,1.569
2004/9/13,1345,5930,1,12,6,6,0.991,1.236
2004/9/14,945,5941,-8,24,9,15,0.991,0.778
2004/9/14,1045,5944,5,18,5,13,0.992,1.424
2004/9/14,1145,5932,-13,22,11,11,0.996,1.237
2004/9/14,1245,5936,6,17,2,15,0.997,1.745
2004/9/14,1345,5935,-1,15,9,6,0.999,1.4
2004/9/15,945,5930,7,26,3,23,1,1.154
2004/9/15,1045,5922,-8,11,9,2,1.001,2.582
2004/9/15,1145,5905,-17,16,19,-3,1.004,1.652
2004/9/15,1245,5873,-32,41,38,3,1.009,1.135
2004/9/15,1345,5879,6,12,9,3,1.007,0.951
2004/9/16,945,5832,-18,31,13,18,1.014,0.387
2004/9/16,1045,5853,21,30,9,21,1.008,0.634
2004/9/16,1145,5859,6,17,3,14,1.006,1.297
2004/9/16,1245,5875,15,28,9,19,1.002,0.805
2004/9/16,1345,5868,-8,19,20,-1,1.002,0.795
2004/9/17,945,5838,-22,40,33,7,1.006,0.655
2004/9/17,1045,5823,-14,44,21,23,1.007,0.582
2004/9/17,1145,5832,10,33,10,23,1.004,1.263
2004/9/17,1245,5830,-3,24,9,15,1.003,1.99
2004/9/17,1345,5797,-33,34,37,-3,1.008,1.204
2004/9/20,945,5828,15,25,9,16,1.002,0.766
2004/9/20,1045,5865,38,47,10,37,0.995,0.552
2004/9/20,1145,5861,-2,19,8,11,0.996,1.783
2004/9/20,1245,5853,-8,23,15,8,0.998,1.878
2004/9/20,1345,5840,-13,30,15,15,0.999,1.096
2004/9/21,945,5922,56,63,-2,65,0.986,0.454
2004/9/21,1045,5900,-20,49,34,15,0.991,0.664
2004/9/21,1145,5913,13,16,2,14,0.99,1.996
2004/9/21,1245,5913,0,22,12,10,0.991,2.097
2004/9/21,1345,5945,32,34,0,34,0.987,0.799
2004/9/22,945,5928,-27,41,31,10,0.993,0.761
2004/9/22,1045,5937,9,20,7,13,0.993,1.562
2004/9/22,1145,5935,-3,16,3,13,0.994,3.421
2004/9/22,1245,5935,0,14,7,7,0.996,3.494
2004/9/22,1345,5936,1,12,10,2,0.997,1.803
2004/9/23,945,5900,10,29,18,11,1.003,0.679
2004/9/23,1045,5905,5,14,5,9,1.002,1.78
2004/9/23,1145,5909,3,17,13,4,1.002,1.666
2004/9/23,1245,5916,7,10,1,9,1,2.359
2004/9/23,1345,5917,1,18,16,2,1,0.722
2004/9/24,945,5867,-48,60,63,-3,1.008,0.394
2004/9/24,1045,5882,15,20,5,15,1.004,1.039
2004/9/24,1145,5899,17,29,10,19,1.001,0.911
2004/9/24,1245,5890,-9,26,19,7,1.002,1.23
2004/9/24,1345,5888,-3,22,7,15,1.001,1.005
2004/9/27,945,5859,-20,33,25,8,1.006,0.799
2004/9/27,1045,5855,-3,29,17,12,1.006,1.02
2004/9/27,1145,5861,5,13,2,11,1.004,1.876
2004/9/27,1245,5859,-1,10,5,5,1.003,3.528
2004/9/27,1345,5870,10,12,1,11,1.001,1.895
2004/9/29,945,5860,-15,52,40,12,1.002,0.572
2004/9/29,1045,5860,0,32,17,15,1.002,0.85
2004/9/29,1145,5879,19,28,7,21,0.998,1.306
2004/9/29,1245,5868,-11,18,16,2,0.999,1.81
2004/9/29,1345,5857,-12,28,19,9,1.001,0.797
2004/9/30,945,5911,23,36,7,29,0.992,0.444
2004/9/30,1045,5900,-11,17,14,3,0.995,1.311
2004/9/30,1145,5873,-28,34,30,4,1,0.696
2004/9/30,1245,5874,2,14,10,4,1,1.379
2004/9/30,1345,5889,16,29,1,28,0.998,0.977
2004/10/1,945,5896,-5,27,19,8,0.997,0.702
2004/10/1,1045,5902,7,29,-2,31,0.997,0.954
2004/10/1,1145,5925,24,34,5,29,0.993,0.681
2004/10/1,1245,5922,-3,15,6,9,0.995,1.604
2004/10/1,1345,5947,25,35,10,25,0.991,0.624
2004/10/4,945,6045,5,29,20,9,0.978,0.55
2004/10/4,1045,6054,8,15,7,8,0.979,1.811
2004/10/4,1145,6083,29,33,-3,36,0.976,1.689
2004/10/4,1245,6103,20,38,12,26,0.977,0.902
2004/10/4,1345,6105,2,17,9,8,0.98,1.11
2004/10/5,945,6105,2,36,19,17,0.983,1.029
2004/10/5,1045,6101,-3,15,13,2,0.988,2.579
2004/10/5,1145,6110,10,22,4,18,0.989,2.316
2004/10/5,1245,6104,-5,10,6,4,0.993,3.372
2004/10/5,1345,6123,18,20,1,19,0.993,1.533
2004/10/6,945,6119,9,23,15,8,0.995,0.896
2004/10/6,1045,6152,32,61,28,33,0.991,0.438
2004/10/6,1145,6144,-7,28,4,24,0.994,0.693
2004/10/6,1245,6149,6,27,11,16,0.994,1.25
2004/10/6,1345,6088,-61,84,68,16,1.005,0.398
2004/10/7,945,6125,2,32,19,13,0.999,0.726
2004/10/7,1045,6118,-6,34,17,17,1,1.027
2004/10/7,1145,6113,-5,14,10,4,1.001,2.917
2004/10/7,1245,6114,1,25,4,21,1.001,1.571
2004/10/7,1345,6134,20,34,1,33,0.998,1.188
2004/10/8,945,6113,3,18,6,12,1.002,1.348
2004/10/8,1045,6125,11,25,8,17,1,1.643
2004/10/8,1145,6130,5,17,8,9,0.998,2.577
2004/10/8,1245,6115,-15,24,24,0,1.001,1.632
2004/10/8,1345,6135,20,20,0,20,0.997,1.111
2004/10/11,945,6078,-30,46,30,16,1.006,0.433
2004/10/11,1045,6085,7,18,10,8,1.004,1.683
2004/10/11,1145,6084,-1,20,6,14,1.004,1.59
2004/10/11,1245,6090,5,13,3,10,1.002,2.493
2004/10/11,1345,6118,30,46,17,29,0.997,0.523
2004/10/12,945,6069,-11,29,25,4,1.005,0.577
2004/10/12,1045,6082,12,16,6,10,1.002,1.756
2004/10/12,1145,6056,-24,26,27,-1,1.005,1.132
2004/10/12,1245,6056,0,23,9,14,1.004,0.773
2004/10/12,1345,5991,-66,74,65,9,1.014,0.531
2004/10/13,945,6014,-6,32,14,18,1.009,0.713
2004/10/13,1045,6018,3,51,18,33,1.007,0.848
2004/10/13,1145,6009,-8,16,10,6,1.007,2.324
2004/10/13,1245,6004,-5,19,13,6,1.007,2.38
2004/10/13,1345,5994,-10,23,21,2,1.007,1.349
2004/10/14,945,5892,-58,73,47,26,1.023,0.429
2004/10/14,1045,5862,-31,62,32,30,1.025,0.634
2004/10/14,1145,5854,-8,25,10,15,1.022,1.678
2004/10/14,1245,5863,9,19,8,11,1.017,1.823
2004/10/14,1345,5850,-13,31,14,17,1.016,0.95
2004/10/15,945,5838,32,59,10,49,1.015,0.699
2004/10/15,1045,5835,-4,45,33,12,1.012,1.026
2004/10/15,1145,5843,8,21,9,12,1.008,1.973
2004/10/15,1245,5838,-7,42,2,40,1.006,1.226
2004/10/15,1345,5816,-22,42,42,0,1.007,1.473
2004/10/18,945,5814,4,52,41,11,1.005,0.952
2004/10/18,1045,5819,6,18,7,11,1.003,1.358
2004/10/18,1145,5827,9,17,1,16,1,2.814
2004/10/18,1245,5818,-9,10,8,2,1.001,3.538
2004/10/18,1345,5779,-40,43,49,-6,1.007,1.238
2004/10/19,945,5818,-37,58,31,27,1.002,0.575
2004/10/19,1045,5810,-8,28,13,15,1.003,0.963
2004/10/19,1145,5811,0,18,8,10,1.002,1.851
2004/10/19,1245,5810,-2,16,3,13,1.002,1.073
2004/10/19,1345,5837,27,31,0,31,0.996,0.869
2004/10/20,945,5786,-6,32,24,8,1.005,1.054
2004/10/20,1045,5782,-5,17,8,9,1.005,1.565
2004/10/20,1145,5778,-4,16,15,1,1.005,2.412
2004/10/20,1245,5763,-15,20,20,0,1.007,1.504
2004/10/20,1345,5775,12,44,29,15,1.004,0.795
2004/10/21,945,5827,17,69,16,53,0.994,0.315
2004/10/21,1045,5829,2,15,8,7,0.994,0.873
2004/10/21,1145,5828,-1,14,2,12,0.995,1.64
2004/10/21,1245,5801,-27,35,34,1,0.999,0.997
2004/10/21,1345,5779,-23,36,36,0,1.003,0.672
2004/10/22,945,5798,-22,30,33,-3,1,0.658
2004/10/22,1045,5810,12,24,14,10,0.998,1.369
2004/10/22,1145,5791,-20,26,23,3,1.002,1.474
2004/10/22,1245,5784,-9,17,9,8,1.004,1.331
2004/10/22,1345,5796,12,20,9,11,1.002,1.396
2004/10/26,945,5685,-23,47,34,13,1.02,0.515
2004/10/26,1045,5683,-4,16,10,6,1.018,1.541
2004/10/26,1145,5667,-17,13,19,-6,1.018,2.047
2004/10/26,1245,5648,-18,32,25,7,1.018,1.265
2004/10/26,1345,5660,12,25,0,25,1.014,1.043
2004/10/27,945,5653,-29,51,39,12,1.012,0.787
2004/10/27,1045,5612,-41,48,37,11,1.017,0.676
2004/10/27,1145,5628,16,35,5,30,1.011,1.142
2004/10/27,1245,5640,10,38,26,12,1.006,0.966
2004/10/27,1345,5616,-24,50,59,-9,1.008,0.934
2004/10/28,945,5688,-12,29,25,4,0.995,0.587
2004/10/28,1045,5695,7,28,10,18,0.993,1.064
2004/10/28,1145,5689,-7,13,7,6,0.995,2.752
2004/10/28,1245,5718,28,35,7,28,0.99,0.829
2004/10/28,1345,5729,11,26,5,21,0.989,0.845
2004/10/29,945,5705,16,39,22,17,0.994,0.758
2004/10/29,1045,5707,4,25,10,15,0.994,1.789
2004/10/29,1145,5693,-14,23,15,8,0.998,1.876
2004/10/29,1245,5695,1,14,7,7,0.999,2.762
2004/10/29,1345,5691,-4,18,22,-4,1.001,1.062
2004/11/1,945,5706,5,31,20,11,0.998,0.842
2004/11/1,1045,5685,-21,35,25,10,1.002,1.206
2004/11/1,1145,5693,7,23,11,12,1.001,2.44
2004/11/1,1245,5688,-6,16,7,9,1.001,2.384
2004/11/1,1345,5617,-71,80,73,7,1.014,0.412
2004/11/2,945,5668,11,39,4,35,1.004,0.595
2004/11/2,1045,5670,1,25,12,13,1.003,1.069
2004/11/2,1145,5671,0,15,7,8,1.002,1.658
2004/11/2,1245,5723,50,47,-4,51,0.993,0.674
2004/11/2,1345,5751,30,52,13,39,0.988,0.659
2004/11/3,945,5769,33,40,3,37,0.986,0.821
2004/11/3,1045,5823,53,60,0,60,0.978,0.669
2004/11/3,1145,5831,7,40,24,16,0.979,0.657
2004/11/3,1245,5814,-16,37,29,8,0.984,1.185
2004/11/3,1345,5830,17,56,22,34,0.983,0.824
2004/11/4,945,5836,8,25,4,21,0.985,1.151
2004/11/4,1045,5836,0,27,14,13,0.988,1.421
2004/11/4,1145,5847,11,11,0,11,0.989,2.6
2004/11/4,1245,5838,-9,35,27,8,0.994,0.956
2004/11/4,1345,5836,-1,20,9,11,0.996,1.427
2004/11/5,945,5938,37,47,29,18,0.982,0.615
2004/11/5,1045,5928,-10,29,13,16,0.986,1.381
2004/11/5,1145,5926,-2,17,12,5,0.988,2.165
2004/11/5,1245,5919,-6,20,8,12,0.991,1.396
2004/11/5,1345,5920,1,23,18,5,0.993,1.063
2004/11/8,945,5915,-10,23,19,4,0.995,0.997
2004/11/8,1045,5907,-8,22,17,5,0.998,1.52
2004/11/8,1145,5915,7,14,5,9,0.998,2.415
2004/11/8,1245,5926,11,12,-1,13,0.997,2.048
2004/11/8,1345,5909,-17,17,19,-2,1.001,1.38
2004/11/9,945,5919,-2,50,41,9,1,0.488
2004/11/9,1045,5897,-22,37,26,11,1.003,0.692
2004/11/9,1145,5915,18,24,8,16,1,1.244
2004/11/9,1245,5911,-4,23,14,9,1,1.387
2004/11/9,1345,5943,33,38,3,35,0.995,0.835
2004/11/10,945,5930,-40,70,61,9,0.998,0.489
2004/11/10,1045,5927,-2,29,5,24,0.998,0.762
2004/11/10,1145,5935,8,11,0,11,0.997,2.031
2004/11/10,1245,5953,20,23,2,21,0.995,1.59
2004/11/10,1345,5960,9,35,15,20,0.994,0.709
2004/11/11,945,5914,-34,40,36,4,1.002,0.72
2004/11/11,1045,5912,-2,29,8,21,1.002,0.728
2004/11/11,1145,5904,-9,18,10,8,1.004,2.501
2004/11/11,1245,5908,5,18,11,7,1.003,2.234
2004/11/11,1345,5868,-41,48,48,0,1.01,0.753
2004/11/12,945,5909,-11,26,19,7,1.002,0.75
2004/11/12,1045,5942,33,34,-2,36,0.996,0.915
2004/11/12,1145,5941,-1,16,6,10,0.997,1.602
2004/11/12,1245,5966,24,26,-1,27,0.993,1.287
2004/11/12,1345,5935,-31,42,32,10,0.998,0.904
2004/11/15,945,5973,-5,51,33,18,0.992,0.672
2004/11/15,1045,5978,6,19,7,12,0.992,1.915
2004/11/15,1145,5965,-13,21,12,9,0.996,1.74
2004/11/15,1245,5951,-14,23,22,1,0.999,2.077
2004/11/15,1345,5941,-14,27,13,14,1.001,0.725
2004/11/16,945,5940,-5,39,10,29,1.002,1.005
2004/11/16,1045,5951,11,25,9,16,1.001,1.225
2004/11/16,1145,5940,-11,26,18,8,1.003,1.493
2004/11/16,1245,5932,-7,18,12,6,1.004,1.434
2004/11/16,1345,5929,-3,13,6,7,1.004,1.051
2004/11/17,945,6000,100,96,10,86,0.991,0.599
2004/11/17,1045,6000,1,26,9,17,0.991,1.086
2004/11/17,1145,6013,13,24,12,12,0.989,1.54
2004/11/17,1245,6014,2,22,11,11,0.99,2.601
2004/11/17,1345,6040,27,28,3,25,0.987,1.26
2004/11/18,945,6071,-9,37,26,11,0.984,0.389
2004/11/18,1045,6083,13,36,24,12,0.984,0.668
2004/11/18,1145,6092,9,17,6,11,0.985,1.644
2004/11/18,1245,6075,-17,19,17,2,0.99,1.256
2004/11/18,1345,6072,-3,15,17,-2,0.993,1.138
2004/11/19,945,6075,-11,23,18,5,0.996,0.9
2004/11/19,1045,6088,13,19,2,17,0.995,1.555
2004/11/19,1145,6087,-1,14,2,12,0.996,1.958
2004/11/19,1245,6047,-40,39,40,-1,1.004,0.757
2004/11/19,1345,6056,8,18,7,11,1.003,0.995
2004/11/22,945,5954,-32,39,35,4,1.019,0.413
2004/11/22,1045,5932,-22,30,18,12,1.021,0.677
2004/11/22,1145,5907,-25,39,31,8,1.022,0.964
2004/11/22,1245,5850,-57,63,69,-6,1.029,0.748
2004/11/22,1345,5835,-15,39,37,2,1.028,0.708
2004/11/23,945,5813,-36,54,59,-5,1.028,0.73
2004/11/23,1045,5850,36,68,8,60,1.017,0.696
2004/11/23,1145,5851,1,28,14,14,1.013,1.515
2004/11/23,1245,5850,0,31,18,13,1.009,2.375
2004/11/23,1345,5842,-8,18,16,2,1.007,2.235
2004/11/24,945,5908,72,74,11,63,0.993,0.65
2004/11/24,1045,5890,-18,26,22,4,0.995,1.298
2004/11/24,1145,5880,-10,32,24,8,0.996,1.693
2004/11/24,1245,5905,23,32,5,27,0.992,1.672
2004/11/24,1345,5905,2,20,11,9,0.992,1.025
2004/11/25,945,5888,-26,48,35,13,0.996,0.695
2004/11/25,1045,5877,-11,36,20,16,1,1.228
2004/11/25,1145,5860,-16,29,16,13,1.003,0.809
2004/11/25,1245,5863,3,14,6,8,1.003,2.063
2004/11/25,1345,5870,7,12,5,7,1.002,1.498
2004/11/26,945,5942,47,73,22,51,0.99,0.433
2004/11/26,1045,5927,-14,29,20,9,0.993,1.022
2004/11/26,1145,5930,4,25,5,20,0.994,1.619
2004/11/26,1245,5880,-49,73,55,18,1.003,0.849
2004/11/26,1345,5740,-139,127,137,-10,1.027,0.383
2004/11/29,945,5784,0,46,22,24,1.017,0.81
2004/11/29,1045,5801,18,39,12,27,1.012,1.894
2004/11/29,1145,5792,-8,26,18,8,1.012,2.665
2004/11/29,1245,5778,-14,26,18,8,1.014,2.279
2004/11/29,1345,5810,31,29,-3,32,1.007,1.885
2004/11/30,945,5735,-38,78,45,33,1.018,0.635
2004/11/30,1045,5759,24,41,7,34,1.01,1.413
2004/11/30,1145,5810,51,66,10,56,0.998,0.818
2004/11/30,1245,5798,-11,34,27,7,0.998,1.503
2004/11/30,1345,5809,12,92,16,76,0.995,0.577
2004/12/1,945,5784,61,118,4,114,0.998,0.552
2004/12/1,1045,5765,-16,51,30,21,1.001,1.291
2004/12/1,1145,5765,0,21,7,14,1.001,2.277
2004/12/1,1245,5780,16,26,3,23,0.998,2.577
2004/12/1,1345,5770,-9,37,32,5,0.999,1.247
2004/12/2,945,5843,-15,45,35,10,0.988,0.658
2004/12/2,1045,5850,6,18,12,6,0.989,1.673
2004/12/2,1145,5830,-21,36,28,8,0.994,1.636
2004/12/2,1245,5832,-2,16,13,3,0.994,2.868
2004/12/2,1345,5855,23,30,9,21,0.991,1.072
2004/12/3,945,5856,-29,55,49,6,0.993,0.548
2004/12/3,1045,5859,4,21,10,11,0.994,1.598
2004/12/3,1145,5850,-10,19,10,9,0.997,1.492
2004/12/3,1245,5865,15,22,5,17,0.996,1.813
2004/12/3,1345,5880,12,26,6,20,0.995,0.996
2004/12/6,945,5868,33,55,22,33,0.997,0.645
2004/12/6,1045,5901,33,44,8,36,0.992,0.73
2004/12/6,1145,5897,-4,17,3,14,0.993,1.736
2004/12/6,1245,5881,-16,22,15,7,0.997,1.606
2004/12/6,1345,5883,3,18,10,8,0.997,1.16
2004/12/7,945,5881,1,24,9,15,0.998,1.054
2004/12/7,1045,5880,-2,14,7,7,0.998,1.731
2004/12/7,1145,5889,10,22,11,11,0.997,1.493
2004/12/7,1245,5890,1,14,4,10,0.997,2.818
2004/12/7,1345,5890,-2,23,18,5,0.998,0.979
2004/12/8,945,5867,2,19,18,1,1.002,0.755
2004/12/8,1045,5881,14,19,1,18,1,1.613
2004/12/8,1145,5883,2,14,11,3,0.999,1.056
2004/12/8,1245,5890,6,11,2,9,0.998,1.778
2004/12/8,1345,5880,-11,27,22,5,1,0.715
2004/12/9,945,5898,14,32,9,23,0.997,0.717
2004/12/9,1045,5899,7,14,6,8,0.997,1.118
2004/12/9,1145,5891,-8,14,9,5,0.998,1.602
2004/12/9,1245,5881,-10,19,11,8,1,0.917
2004/12/9,1345,5880,-1,15,5,10,1,0.876
2004/12/10,945,5885,-15,18,10,8,1,1.089
2004/12/10,1045,5884,0,8,4,4,1,2.173
2004/12/10,1145,5882,0,7,1,6,1.001,1.92
2004/12/10,1245,5853,-28,48,28,20,1.006,0.595
2004/12/10,1345,5850,-4,24,23,1,1.005,0.65
2004/12/13,945,5980,90,127,39,88,0.984,0.271
2004/12/13,1045,5977,-3,20,10,10,0.986,0.976
2004/12/13,1145,5945,-32,36,33,3,0.992,1.056
2004/12/13,1245,5839,-106,132,111,21,1.011,0.399
2004/12/13,1345,5871,33,81,-3,84,1.005,0.686
2004/12/14,945,5892,-6,48,24,24,1.001,1.388
2004/12/14,1045,5886,-4,20,14,6,1.002,3.287
2004/12/14,1145,5880,-8,16,14,2,1.004,3.3
2004/12/14,1245,5879,-1,12,4,8,1.004,4.88
2004/12/14,1345,5901,21,35,9,26,1,2.082
2004/12/15,945,5947,-4,35,9,26,0.994,1.39
2004/12/15,1045,5982,36,34,-2,36,0.987,1.641
2004/12/15,1145,5976,-4,23,19,4,0.988,2.025
2004/12/15,1245,6010,34,39,5,34,0.983,1.996
2004/12/15,1345,6017,6,30,13,17,0.985,0.867
2004/12/16,945,6009,4,25,21,4,0.988,0.379
2004/12/16,1045,6003,-7,22,15,7,0.991,0.76
2004/12/16,1145,6020,17,27,8,19,0.99,1.087
2004/12/16,1245,6019,-2,18,9,9,0.993,1.328
2004/12/16,1345,6020,1,12,7,5,0.995,1.295
2004/12/17,945,6019,8,28,10,18,0.996,0.743
2004/12/17,1045,6022,3,12,1,11,0.997,2.13
2004/12/17,1145,6017,-5,10,8,2,0.998,1.955
2004/12/17,1245,6022,6,8,3,5,0.998,3.337
2004/12/17,1345,6019,-2,14,5,9,0.999,1.025
2004/12/20,945,5958,37,41,12,29,1.008,0.363
2004/12/20,1045,5986,28,35,6,29,1.002,0.739
2004/12/20,1145,5965,-21,31,26,5,1.005,1.319
2004/12/20,1245,5979,14,19,5,14,1.002,1.929
2004/12/20,1345,5962,-18,30,18,12,1.004,0.722
2004/12/21,945,5972,-4,22,11,11,1.002,0.797
2004/12/21,1045,5969,-3,18,16,2,1.002,1.527
2004/12/21,1145,5978,9,12,1,11,0.999,2.944
2004/12/21,1245,5987,10,19,2,17,0.997,1.459
2004/12/21,1345,5978,-8,9,9,0,0.998,1.834
2004/12/22,945,6059,44,57,10,47,0.986,0.32
2004/12/22,1045,6047,-12,20,15,5,0.99,0.806
2004/12/22,1145,6044,-2,15,8,7,0.991,1.453
2004/12/22,1245,6017,-28,42,31,11,0.997,0.793
2004/12/22,1345,6025,7,22,8,14,0.996,0.933
2004/12/23,945,5989,-45,61,45,16,1.003,0.579
2004/12/23,1045,5991,3,27,4,23,1.003,0.981
2004/12/23,1145,5981,-8,20,14,6,1.005,1.585
2004/12/23,1245,5990,8,16,2,14,1.004,2.731
2004/12/23,1345,6002,12,24,3,21,1.002,1.341
2004/12/24,945,6016,8,58,29,29,0.999,0.578
2004/12/24,1045,6016,0,19,8,11,0.999,1.642
2004/12/24,1145,6022,6,22,8,14,0.997,1.329
2004/12/24,1245,6032,10,14,2,12,0.995,1.617
2004/12/24,1345,6032,1,30,26,4,0.995,0.701
2004/12/27,945,6007,-28,44,35,9,1,0.667
2004/12/27,1045,6009,2,19,2,17,1,1.042
2004/12/27,1145,6010,2,10,0,10,1,3.643
2004/12/27,1245,6015,5,12,5,7,0.999,2.116
2004/12/27,1345,6016,1,14,6,8,1,1.659
2004/12/28,945,6034,26,34,11,23,0.997,0.617
2004/12/28,1045,6032,-2,10,3,7,0.997,2.166
2004/12/28,1145,6024,-7,17,11,6,0.999,1.558
2004/12/28,1245,6028,4,9,1,8,0.998,3.073
2004/12/28,1345,6020,-8,13,12,1,1,1.242
2004/12/29,945,6091,36,49,15,34,0.988,0.27
2004/12/29,1045,6097,3,13,3,10,0.989,1.364
2004/12/29,1145,6105,8,21,13,8,0.989,0.78
2004/12/29,1245,6113,9,16,4,12,0.989,1.766
2004/12/29,1345,6118,4,15,2,13,0.99,0.835
2004/12/30,945,6120,-6,20,8,12,0.991,0.84
2004/12/30,1045,6116,-4,11,6,5,0.993,2.484
2004/12/30,1145,6120,4,12,7,5,0.994,2.234
2004/12/30,1245,6120,-1,9,2,7,0.996,3.246
2004/12/30,1345,6115,-5,14,13,1,0.998,1.418
2004/12/31,945,6122,2,15,6,9,0.998,0.912
2004/12/31,1045,6108,-14,19,16,3,1.001,0.85
2004/12/31,1145,6143,34,49,12,37,0.995,0.599
2004/12/31,1245,6165,22,36,13,23,0.992,0.46
2004/12/31,1345,6188,23,23,-2,25,0.99,0.532
2005/1/3,945,6166,-19,39,27,12,0.994,0.525
2005/1/3,1045,6164,0,13,12,1,0.995,1.814
2005/1/3,1145,6167,3,18,8,10,0.995,1.584
2005/1/3,1245,6175,6,9,3,6,0.995,2.477
2005/1/3,1345,6174,-2,20,16,4,0.996,1.184
2005/1/4,945,6115,-30,46,37,9,1.006,0.486
2005/1/4,1045,6116,1,32,11,21,1.006,0.776
2005/1/4,1145,6108,-9,14,10,4,1.007,1.989
2005/1/4,1245,6082,-25,26,27,-1,1.011,0.978
2005/1/4,1345,6080,-1,26,8,18,1.01,0.667
2005/1/5,945,6018,7,27,5,22,1.017,0.521
2005/1/5,1045,6021,2,12,6,6,1.014,2.268
2005/1/5,1145,6019,-2,9,1,8,1.012,1.933
2005/1/5,1245,6018,0,9,8,1,1.01,3.182
2005/1/5,1345,6013,-6,11,5,6,1.008,1.082
2005/1/6,945,6008,0,25,12,13,1.007,0.921
2005/1/6,1045,6015,5,10,3,7,1.004,2.61
2005/1/6,1145,6015,0,12,3,9,1.002,2.656
2005/1/6,1245,6018,3,10,5,5,1,2.614
2005/1/6,1345,6017,0,5,1,4,0.999,1.59
2005/1/7,945,5998,-20,44,37,7,1.003,0.447
2005/1/7,1045,5969,-30,44,26,18,1.007,0.39
2005/1/7,1145,5999,30,35,5,30,1.001,0.804
2005/1/7,1245,5960,-39,39,40,-1,1.007,0.869
2005/1/7,1345,5965,5,24,14,10,1.006,0.874
2005/1/10,945,5985,15,31,7,24,1.002,0.753
2005/1/10,1045,5972,-12,24,17,7,1.003,1.827
2005/1/10,1145,5977,5,12,5,7,1.002,4.015
2005/1/10,1245,5980,2,12,9,3,1.001,3.325
2005/1/10,1345,5987,7,10,2,8,0.999,2.333
2005/1/11,945,5984,-2,19,8,11,0.999,1.024
2005/1/11,1045,5979,-4,19,5,14,0.999,1.745
2005/1/11,1145,6014,34,46,12,34,0.994,0.464
2005/1/11,1245,6015,3,12,6,6,0.994,1.636
2005/1/11,1345,6003,-11,17,13,4,0.997,0.812
2005/1/12,945,5979,-1,26,16,10,1.001,0.629
2005/1/12,1045,5944,-34,55,35,20,1.007,0.404
2005/1/12,1145,5920,-24,29,25,4,1.01,1.068
2005/1/12,1245,5903,-17,34,26,8,1.012,0.742
2005/1/12,1345,5901,-1,32,6,26,1.011,0.725
2005/1/13,945,5908,-12,31,16,15,1.009,0.928
2005/1/13,1045,5916,8,28,14,14,1.006,1.281
2005/1/13,1145,5890,-27,45,26,19,1.01,0.91
2005/1/13,1245,5854,-35,45,37,8,1.014,0.931
2005/1/13,1345,5880,27,50,0,50,1.006,0.895
2005/1/14,945,5868,22,59,12,47,1.006,0.678
2005/1/14,1045,5888,21,34,6,28,1.001,1.606
2005/1/14,1145,5913,25,34,5,29,0.996,1.003
2005/1/14,1245,5893,-20,35,27,8,0.999,1.417
2005/1/14,1345,5893,0,17,13,4,0.999,1.756
2005/1/17,945,5960,27,37,20,17,0.988,0.671
2005/1/17,1045,5971,9,21,6,15,0.987,2.088
2005/1/17,1145,5969,-3,23,16,7,0.988,1.442
2005/1/17,1245,5971,2,13,11,2,0.989,1.58
2005/1/17,1345,5954,-15,20,21,-1,0.994,1.695
2005/1/18,945,5954,-1,22,13,9,0.996,1.083
2005/1/18,1045,5947,-8,21,9,12,0.998,1.438
2005/1/18,1145,5951,4,18,2,16,0.999,1.667
2005/1/18,1245,5951,0,15,4,11,0.999,1.586
2005/1/18,1345,5945,-5,10,8,2,1.001,1.479
2005/1/19,945,5912,-53,74,65,9,1.008,0.737
2005/1/19,1045,5917,5,32,6,26,1.006,1.022
2005/1/19,1145,5910,-8,18,18,0,1.006,1.496
2005/1/19,1245,5904,-6,16,13,3,1.006,1.579
2005/1/19,1345,5885,-19,14,24,-10,1.008,0.555
2005/1/20,945,5874,5,25,4,21,1.009,0.299
2005/1/20,1045,5912,38,48,13,35,1.001,0.55
2005/1/20,1145,5893,-19,20,20,0,1.003,1.12
2005/1/20,1245,5911,19,23,6,17,0.999,1.989
2005/1/20,1345,5879,-32,43,32,11,1.004,0.827
2005/1/21,945,5855,-16,45,42,3,1.007,0.91
2005/1/21,1045,5851,-5,33,22,11,1.006,0.992
2005/1/21,1145,5848,-3,25,10,15,1.006,1.59
2005/1/21,1245,5872,23,34,13,21,1.001,1.154
2005/1/21,1345,5869,-4,27,13,14,1.001,1.385
2005/1/24,945,5847,-22,48,27,21,1.004,0.79
2005/1/24,1045,5844,-3,18,10,8,1.004,1.863
2005/1/24,1145,5809,-35,54,39,15,1.009,0.773
2005/1/24,1245,5792,-16,27,23,4,1.011,0.947
2005/1/24,1345,5805,13,38,2,36,1.007,0.742
2005/1/25,945,5787,4,49,28,21,1.008,0.68
2005/1/25,1045,5801,14,27,12,15,1.005,1.439
2005/1/25,1145,5775,-26,40,26,14,1.008,1.073
2005/1/25,1245,5779,3,37,4,33,1.006,0.903
2005/1/25,1345,5810,31,44,4,40,0.999,0.835
2005/1/26,945,5817,-21,37,36,1,0.998,0.756
2005/1/26,1045,5825,9,24,13,11,0.996,1.833
2005/1/26,1145,5834,9,21,10,11,0.994,1.811
2005/1/26,1245,5840,5,26,17,9,0.993,1.172
2005/1/26,1345,5840,0,15,6,9,0.994,1.673
2005/1/27,945,5831,-19,24,19,5,0.997,0.857
2005/1/27,1045,5828,-5,16,6,10,0.998,1.786
2005/1/27,1145,5836,9,14,9,5,0.997,1.515
2005/1/27,1245,5833,-3,11,6,5,0.999,3.211
2005/1/27,1345,5834,3,18,4,14,0.999,1.274
2005/1/28,945,5828,6,20,10,10,1,0.907
2005/1/28,1045,5849,20,29,4,25,0.997,0.819
2005/1/28,1145,5879,30,41,14,27,0.992,0.376
2005/1/28,1245,5871,-7,22,21,1,0.994,1.151
2005/1/28,1345,5874,3,22,9,13,0.994,0.882
2005/1/31,945,5908,15,27,3,24,0.989,0.692
2005/1/31,1045,5940,32,48,10,38,0.985,0.487
2005/1/31,1145,5962,23,25,3,22,0.983,1.021
2005/1/31,1245,5988,26,34,6,28,0.981,0.832
2005/1/31,1345,5982,-5,26,22,4,0.985,0.915
2005/2/1,945,5986,5,22,11,11,0.987,1.1
2005/2/1,1045,6001,14,20,-1,21,0.987,2.419
2005/2/1,1145,5989,-12,21,17,4,0.991,2.082
2005/2/1,1245,5991,5,10,6,4,0.993,5.258
2005/2/1,1345,5980,-11,16,13,3,0.997,1.732
2005/2/2,945,6041,41,64,19,45,0.988,0.512
2005/2/2,1045,6050,9,19,7,12,0.989,1.219
2005/2/2,1145,6037,-12,41,33,8,0.993,0.818
2005/2/2,1245,6030,-6,20,10,10,0.996,1.02
2005/2/2,1345,6023,-8,25,17,8,0.997,0.993
2005/2/3,945,6030,-18,30,17,13,0.997,1.118
2005/2/3,1045,6033,3,10,1,9,0.998,3.783
2005/2/3,1145,6045,13,16,1,15,0.996,2.43
2005/2/3,1245,6033,-12,14,12,2,0.999,3.022
2005/2/3,1345,6045,11,17,-2,19,0.998,1.119
2005/2/14,945,6141,-69,75,49,26,0.986,0.471
2005/2/14,1045,6136,-5,25,12,13,0.988,1.139
2005/2/14,1145,6142,6,13,1,12,0.988,1.726
2005/2/14,1245,6135,-7,21,17,4,0.991,1.557
2005/2/14,1345,6129,-6,11,7,4,0.994,1.154
2005/2/15,945,6131,20,29,18,11,0.995,0.742
2005/2/15,1045,6126,-5,9,4,5,0.997,1.44
2005/2/15,1145,6128,2,6,2,4,0.998,2.742
2005/2/15,1245,6126,-2,10,5,5,1,3.109
2005/2/15,1345,6123,-2,5,5,0,1.002,1.98
2005/2/16,945,6074,-66,107,75,32,1.009,0.596
2005/2/16,1045,6098,24,30,5,25,1.004,1.077
2005/2/16,1145,6127,29,41,12,29,0.999,1.061
2005/2/16,1245,6130,2,13,6,7,0.998,1.62
2005/2/16,1345,6128,-2,17,17,0,0.998,0.808
2005/2/17,945,6114,-1,31,21,10,1,0.401
2005/2/17,1045,6081,-34,57,38,19,1.006,0.334
2005/2/17,1145,6099,17,32,12,20,1.002,0.691
2005/2/17,1245,6087,-10,16,12,4,1.003,1.666
2005/2/17,1345,6078,-10,26,12,14,1.004,0.826
2005/2/18,945,6088,16,35,5,30,1.001,0.689
2005/2/18,1045,6080,-7,12,14,-2,1.003,1.705
2005/2/18,1145,6098,17,26,11,15,1,1.288
2005/2/18,1245,6112,14,30,15,15,0.997,0.974
2005/2/18,1345,6120,9,16,4,12,0.995,1.207
2005/2/21,945,6154,27,35,16,19,0.99,0.611
2005/2/21,1045,6155,0,21,2,19,0.991,1.321
2005/2/21,1145,6150,-5,17,14,3,0.993,1.695
2005/2/21,1245,6155,5,8,3,5,0.993,3.235
2005/2/21,1345,6144,-12,22,16,6,0.995,1.213
2005/2/22,945,6112,-27,49,37,12,1.002,0.62
2005/2/22,1045,6118,5,35,7,28,1.001,0.769
2005/2/22,1145,6106,-12,21,13,8,1.004,1.832
2005/2/22,1245,6110,3,19,8,11,1.003,2.265
2005/2/22,1345,6097,-14,15,14,1,1.005,1.077
2005/2/23,945,6061,7,35,13,22,1.01,0.466
2005/2/23,1045,6059,-3,22,5,17,1.009,0.839
2005/2/23,1145,6068,9,14,4,10,1.006,1.847
2005/2/23,1245,6090,22,25,-2,27,1.001,1.346
2005/2/23,1345,6114,25,39,14,25,0.996,0.594
2005/2/24,945,6139,25,56,10,46,0.991,0.689
2005/2/24,1045,6147,8,36,17,19,0.991,0.736
2005/2/24,1145,6118,-31,55,36,19,0.996,0.799
2005/2/24,1245,6119,1,18,11,7,0.996,1.834
2005/2/24,1345,6120,1,22,17,5,0.996,1.077
2005/2/25,945,6212,50,42,10,32,0.983,0.439
2005/2/25,1045,6220,9,28,7,21,0.984,0.916
2005/2/25,1145,6217,-3,11,5,6,0.987,2.288
2005/2/25,1245,6218,1,14,1,13,0.989,2.505
2005/2/25,1345,6219,1,10,5,5,0.991,1.242
2005/3/1,945,6218,-15,28,22,6,0.993,1.24
2005/3/1,1045,6237,19,37,9,28,0.991,1.019
2005/3/1,1145,6236,-1,18,4,14,0.993,1.854
2005/3/1,1245,6243,7,21,3,18,0.994,2.069
2005/3/1,1345,6250,6,13,0,13,0.995,1.407
2005/3/2,945,6243,-16,35,12,23,0.997,0.671
2005/3/2,1045,6238,-6,18,12,6,0.999,1.044
2005/3/2,1145,6235,-3,15,10,5,0.999,1.826
2005/3/2,1245,6208,-27,29,32,-3,1.004,0.958
2005/3/2,1345,6200,-8,20,11,9,1.005,0.549
2005/3/3,945,6170,-30,46,40,6,1.01,0.564
2005/3/3,1045,6174,4,25,7,18,1.008,0.806
2005/3/3,1145,6183,9,30,8,22,1.006,1.246
2005/3/3,1245,6207,25,30,8,22,1.001,0.798
2005/3/3,1345,6204,-4,19,19,0,1.001,0.981
2005/3/4,945,6183,-8,31,23,8,1.003,0.979
2005/3/4,1045,6207,25,36,12,24,0.998,1.232
2005/3/4,1145,6202,-5,20,15,5,0.998,1.557
2005/3/4,1245,6195,-5,17,10,7,0.999,2.218
2005/3/4,1345,6198,4,15,3,12,0.998,1.521
2005/3/7,945,6246,1,29,10,19,0.991,0.599
2005/3/7,1045,6243,-3,17,4,13,0.993,1.724
2005/3/7,1145,6233,-10,19,17,2,0.996,1.497
2005/3/7,1245,6231,-3,17,8,9,0.997,1.746
2005/3/7,1345,6231,1,18,7,11,0.997,1.022
2005/3/8,945,6232,-8,30,11,19,0.998,0.773
2005/3/8,1045,6242,9,25,11,14,0.997,0.9
2005/3/8,1145,6236,-7,13,8,5,0.999,1.658
2005/3/8,1245,6178,-58,63,58,5,1.009,0.399
2005/3/8,1345,6155,-24,50,33,17,1.012,0.458
2005/3/9,945,6173,24,28,5,23,1.008,0.923
2005/3/9,1045,6177,5,18,2,16,1.006,1.808
2005/3/9,1145,6177,0,12,5,7,1.005,2.088
2005/3/9,1245,6193,16,24,6,18,1.001,1.283
2005/3/9,1345,6198,5,16,5,11,1,1.27
2005/3/10,945,6181,1,23,5,18,1.002,1.06
2005/3/10,1045,6145,-36,35,36,-1,1.007,1.001
2005/3/10,1145,6163,18,24,3,21,1.002,1.273
2005/3/10,1245,6171,8,26,6,20,1,1.489
2005/3/10,1345,6167,-4,22,21,1,1,0.853
2005/3/11,945,6217,22,35,18,17,0.993,0.488
2005/3/11,1045,6196,-22,25,22,3,0.997,1.272
2005/3/11,1145,6193,-2,25,5,20,0.998,1.044
2005/3/11,1245,6192,-2,17,10,7,0.998,2.557
2005/3/11,1345,6207,15,22,-2,24,0.996,1.461
2005/3/14,945,6161,-15,29,18,11,1.003,0.764
2005/3/14,1045,6190,27,42,13,29,0.998,0.989
2005/3/14,1145,6186,-4,19,10,9,0.999,2.357
2005/3/14,1245,6172,-13,28,28,0,1.002,2.016
2005/3/14,1345,6160,-12,25,19,6,1.004,1.012
2005/3/15,945,6131,-28,50,37,13,1.008,0.627
2005/3/15,1045,6107,-24,45,26,19,1.011,0.541
2005/3/15,1145,6079,-28,39,32,7,1.014,0.96
2005/3/15,1245,6043,-36,45,45,0,1.018,1.039
2005/3/15,1345,6076,32,41,1,40,1.01,0.967
2005/3/16,945,6066,7,35,13,22,1.01,2.038
2005/3/16,1045,6072,6,24,16,8,1.007,3.328
2005/3/16,1145,6069,-2,12,7,5,1.006,4.528
2005/3/16,1245,6062,-8,13,11,2,1.005,3.378
2005/3/16,1345,6068,6,16,8,8,1.002,1.604
2005/3/17,945,6020,12,33,8,25,1.008,0.37
2005/3/17,1045,6017,-2,21,18,3,1.006,0.897
2005/3/17,1145,6032,14,13,-2,15,1.002,1.387
2005/3/17,1245,6022,-11,18,13,5,1.003,1.166
2005/3/17,1345,6015,-7,15,8,7,1.004,0.694
2005/3/18,945,6032,2,27,11,16,1.001,0.53
2005/3/18,1045,6019,-13,21,16,5,1.002,1.041
2005/3/18,1145,6010,-8,16,10,6,1.003,1.07
2005/3/18,1245,6021,11,16,4,12,1,1.964
2005/3/18,1345,6027,6,21,4,17,0.999,1.132
2005/3/21,945,6041,23,33,12,21,0.996,0.637
2005/3/21,1045,6047,4,18,3,15,0.996,1.021
2005/3/21,1145,6041,-6,14,11,3,0.997,1.69
2005/3/21,1245,6039,-1,13,6,7,0.998,1.711
2005/3/21,1345,6040,0,10,0,10,0.998,1.449
2005/3/22,945,6000,-32,42,30,12,1.005,0.382
2005/3/22,1045,5991,-7,28,13,15,1.005,1.019
2005/3/22,1145,6012,22,30,3,27,1.001,1.179
2005/3/22,1245,6013,0,19,9,10,1.001,0.951
2005/3/22,1345,6008,-5,22,19,3,1.002,0.924
2005/3/23,945,5980,-1,23,14,9,1.006,0.596
2005/3/23,1045,5970,-9,15,15,0,1.007,0.979
2005/3/23,1145,5985,14,24,8,16,1.003,0.99
2005/3/23,1245,6002,17,17,-3,20,0.999,1.745
2005/3/23,1345,6010,8,15,0,15,0.997,1.289
2005/3/24,945,6032,22,25,-1,26,0.993,0.957
2005/3/24,1045,6032,-1,15,5,10,0.994,1.432
2005/3/24,1145,6005,-25,30,27,3,0.999,0.918
2005/3/24,1245,6009,4,19,7,12,0.998,1.628
2005/3/24,1345,6012,3,14,2,12,0.998,1.418
2005/3/25,945,6009,-3,14,14,0,0.999,1.24
2005/3/25,1045,6018,9,13,4,9,0.998,1.547
2005/3/25,1145,6020,2,12,8,4,0.998,1.371
2005/3/25,1245,6030,11,18,3,15,0.997,1.423
2005/3/25,1345,6050,21,25,2,23,0.994,0.66
2005/3/28,945,6044,-25,44,33,11,0.996,0.568
2005/3/28,1045,6041,-3,26,21,5,0.997,1.058
2005/3/28,1145,6044,2,17,11,6,0.996,1.748
2005/3/28,1245,6049,4,12,4,8,0.996,2.784
2005/3/28,1345,6054,5,10,-3,13,0.996,1.454
2005/3/29,945,6001,-30,45,39,6,1.005,0.393
2005/3/29,1045,6010,10,19,5,14,1.004,0.852
2005/3/29,1145,5992,-18,27,20,7,1.006,0.87
2005/3/29,1245,5986,-5,18,7,11,1.007,0.818
2005/3/29,1345,5973,-12,18,12,6,1.008,0.807
2005/3/30,945,5976,19,29,3,26,1.006,0.653
2005/3/30,1045,5967,-8,16,8,8,1.006,1.664
2005/3/30,1145,5967,0,10,1,9,1.005,2.757
2005/3/30,1245,5979,12,15,3,12,1.002,1.925
2005/3/30,1345,5975,-3,12,3,9,1.001,1.468
2005/3/31,945,6004,-5,21,15,6,0.996,0.686
2005/3/31,1045,6010,7,11,4,7,0.995,2.296
2005/3/31,1145,6011,0,7,4,3,0.995,2.295
2005/3/31,1245,6011,-1,7,1,6,0.995,2.47
2005/3/31,1345,6010,0,13,3,10,0.996,1.033
2005/4/1,945,6000,-8,28,18,10,0.999,0.583
2005/4/1,1045,5993,-7,13,14,-1,1,1.505
2005/4/1,1145,5995,2,24,1,23,1,0.675
2005/4/1,1245,6003,7,20,0,20,0.999,0.945
2005/4/1,1345,6045,45,44,0,44,0.993,0.356
2005/4/4,945,6024,3,18,10,8,0.996,0.995
2005/4/4,1045,6035,13,20,7,13,0.995,1.503
2005/4/4,1145,6040,5,15,5,10,0.994,1.916
2005/4/4,1245,6028,-13,20,15,5,0.997,1.688
2005/4/4,1345,6025,-4,11,8,3,0.998,2.124
2005/4/6,945,6025,-6,36,8,28,0.998,0.676
2005/4/6,1045,6032,7,19,8,11,0.997,1.024
2005/4/6,1145,6030,-2,12,6,6,0.998,1.874
2005/4/6,1245,6021,-8,20,12,8,1,1.561
2005/4/6,1345,6011,-10,16,13,3,1.002,1.156
2005/4/7,945,6021,8,27,9,18,1.001,0.733
2005/4/7,1045,5996,-24,34,32,2,1.005,0.804
2005/4/7,1145,5983,-10,24,19,5,1.006,0.531
2005/4/7,1245,5989,6,19,10,9,1.004,1.621
2005/4/7,1345,5985,-4,14,4,10,1.004,0.818
2005/4/8,945,6005,-3,15,7,8,1.001,0.877
2005/4/8,1045,6002,-4,10,10,0,1.001,1.61
2005/4/8,1145,6005,3,9,2,7,1,3.263
2005/4/8,1245,6009,4,6,0,6,0.999,4.87
2005/4/8,1345,6010,1,11,7,4,0.998,1.177
2005/4/11,945,5988,3,20,15,5,1.002,0.931
2005/4/11,1045,5980,-7,24,10,14,1.002,0.816
2005/4/11,1145,5978,-2,12,8,4,1.002,2.036
2005/4/11,1245,5979,1,10,4,6,1.002,2.278
2005/4/11,1345,5980,1,11,8,3,1.002,1.118
2005/4/12,945,5977,1,19,11,8,1.002,0.67
2005/4/12,1045,5989,12,11,-1,12,0.999,1.16
2005/4/12,1145,5991,2,11,9,2,0.999,0.961
2005/4/12,1245,5994,5,10,5,5,0.998,1.758
2005/4/12,1345,5990,-4,13,13,0,0.998,0.705
2005/4/13,945,6004,-1,17,8,9,0.996,0.778
2005/4/13,1045,5996,-8,19,10,9,0.998,1.049
2005/4/13,1145,6000,4,8,2,6,0.998,1.609
2005/4/13,1245,6000,-1,13,5,8,0.998,1.88
2005/4/13,1345,6007,9,13,0,13,0.997,1.125
2005/4/14,945,5975,4,22,5,17,1.002,0.424
2005/4/14,1045,5978,3,12,7,5,1.002,0.881
2005/4/14,1145,5978,-1,9,6,3,1.002,2.06
2005/4/14,1245,5975,-2,8,3,5,1.002,1.455
2005/4/14,1345,5975,0,9,2,7,1.002,0.999
2005/4/15,945,5930,5,20,5,15,1.008,0.456
2005/4/15,1045,5911,-18,35,19,16,1.01,0.551
2005/4/15,1145,5903,-8,16,15,1,1.01,1.413
2005/4/15,1245,5891,-12,15,15,0,1.01,1.491
2005/4/15,1345,5892,0,21,5,16,1.008,0.726
2005/4/18,945,5792,-27,44,30,14,1.023,0.474
2005/4/18,1045,5772,-20,25,21,4,1.023,1.059
2005/4/18,1145,5749,-23,27,26,1,1.024,0.927
2005/4/18,1245,5699,-51,56,55,1,1.029,0.826
2005/4/18,1345,5707,9,52,8,44,1.023,0.754
2005/4/19,945,5738,11,22,5,17,1.014,1.274
2005/4/19,1045,5747,10,21,5,16,1.009,1.919
2005/4/19,1145,5747,0,10,1,9,1.006,2.132
2005/4/19,1245,5758,11,16,6,10,1.001,1.67
2005/4/19,1345,5754,-5,38,31,7,1,1.317
2005/4/20,945,5771,-10,38,31,7,0.996,1.139
2005/4/20,1045,5706,-62,54,61,-7,1.007,1.436
2005/4/20,1145,5725,18,50,12,38,1.002,2.173
2005/4/20,1245,5700,-25,30,29,1,1.006,2.398
2005/4/20,1345,5701,1,14,6,8,1.006,0.889
2005/4/21,945,5645,25,56,13,43,1.014,0.204
2005/4/21,1045,5695,49,50,2,48,1.004,0.62
2005/4/21,1145,5686,-10,27,14,13,1.005,1.029
2005/4/21,1245,5694,8,17,1,16,1.002,1.865
2005/4/21,1345,5688,-6,18,19,-1,1.002,0.975
2005/4/22,945,5756,8,41,13,28,0.99,0.616
2005/4/22,1045,5739,-18,24,22,2,0.992,1.459
2005/4/22,1145,5721,-18,29,23,6,0.996,1.332
2005/4/22,1245,5721,0,22,9,13,0.996,1.84
2005/4/22,1345,5725,3,14,7,7,0.996,1.583
2005/4/25,945,5718,7,26,12,14,0.998,1.339
2005/4/25,1045,5721,4,15,11,4,0.999,1.884
2005/4/25,1145,5729,8,13,4,9,0.998,2.327
2005/4/25,1245,5724,-3,13,12,1,1,1.731
2005/4/25,1345,5728,4,11,5,6,1,1.756
2005/4/26,945,5725,-13,31,24,7,1,0.582
2005/4/26,1045,5737,12,14,-2,16,0.997,1.402
2005/4/26,1145,5754,18,37,9,28,0.994,0.633
2005/4/26,1245,5762,8,23,16,7,0.994,0.579
2005/4/26,1345,5765,3,18,10,8,0.994,0.836
2005/4/27,945,5760,12,25,7,18,0.995,0.754
2005/4/27,1045,5751,-10,25,12,13,0.998,1.131
2005/4/27,1145,5749,-2,14,6,8,0.998,2.613
2005/4/27,1245,5760,11,16,5,11,0.997,1.824
2005/4/27,1345,5745,-14,9,14,-5,1,2.282
2005/4/28,945,5729,-11,37,18,19,1.003,0.614
2005/4/28,1045,5744,19,32,9,23,1,0.867
2005/4/28,1145,5763,19,22,0,22,0.997,1.049
2005/4/28,1245,5769,7,17,8,9,0.996,0.748
2005/4/28,1345,5780,12,27,14,13,0.994,0.573
2005/4/29,945,5762,7,21,5,16,0.998,0.709
2005/4/29,1045,5765,4,16,4,12,0.997,1.583
2005/4/29,1145,5751,-14,15,17,-2,1,2.738
2005/4/29,1245,5750,-2,18,10,8,1,1.457
2005/4/29,1345,5770,20,22,-3,25,0.996,1.255
2005/5/3,945,5825,25,32,20,12,0.988,0.529
2005/5/3,1045,5833,8,18,9,9,0.988,1.33
2005/5/3,1145,5829,-5,10,7,3,0.991,2.33
2005/5/3,1245,5822,-8,17,12,5,0.993,1.698
2005/5/3,1345,5800,-21,25,22,3,0.998,0.822
2005/5/4,945,5810,-10,24,18,6,0.997,0.636
2005/5/4,1045,5800,-10,30,15,15,1,0.892
2005/5/4,1145,5806,6,20,5,15,0.999,1.348
2005/5/4,1245,5807,2,11,5,6,1,2.533
2005/5/4,1345,5806,-1,9,1,8,1.001,1.384
2005/5/5,945,5864,4,30,7,23,0.992,0.387
2005/5/5,1045,5866,1,11,2,9,0.993,0.909
2005/5/5,1145,5903,38,45,7,38,0.987,0.464
2005/5/5,1245,5922,19,30,3,27,0.985,0.804
2005/5/5,1345,5902,-21,43,41,2,0.99,0.592
2005/5/6,945,5915,5,23,3,20,0.989,1.224
2005/5/6,1045,5911,-4,15,11,4,0.992,1.904
2005/5/6,1145,5925,15,25,10,15,0.991,1.994
2005/5/6,1245,5938,13,15,0,15,0.991,1.909
2005/5/6,1345,5948,11,27,1,26,0.992,1.154
2005/5/9,945,5930,-6,24,17,7,0.996,0.958
2005/5/9,1045,5929,0,16,15,1,0.997,2.006
2005/5/9,1145,5938,8,11,2,9,0.997,3.172
2005/5/9,1245,5928,-10,13,11,2,0.999,2.529
2005/5/9,1345,5947,19,24,4,20,0.996,1.009
2005/5/10,945,5928,-21,35,27,8,1,0.612
2005/5/10,1045,5926,-2,11,8,3,1,1.23
2005/5/10,1145,5938,12,16,3,13,0.999,1.692
2005/5/10,1245,5937,-1,12,8,4,0.999,1.595
2005/5/10,1345,5925,-13,21,20,1,1.001,1.029
2005/5/11,945,5892,2,19,7,12,1.006,0.424
2005/5/11,1045,5893,0,8,4,4,1.005,1.6
2005/5/11,1145,5903,10,18,9,9,1.003,1.115
2005/5/11,1245,5903,0,10,7,3,1.002,2.042
2005/5/11,1345,5898,-4,13,12,1,1.003,1.105
2005/5/12,945,5903,-2,17,8,9,1.001,0.875
2005/5/12,1045,5905,3,12,5,7,1,1.231
2005/5/12,1145,5895,-10,19,11,8,1.002,1.109
2005/5/12,1245,5905,11,12,0,12,0.999,1.949
2005/5/12,1345,5929,23,26,0,26,0.994,0.771
2005/5/13,945,5989,71,85,18,67,0.985,0.27
2005/5/13,1045,6002,13,24,-2,26,0.984,0.821
2005/5/13,1145,5991,-12,16,12,4,0.988,1.421
2005/5/13,1245,5981,-10,19,17,2,0.991,1.957
2005/5/13,1345,5986,4,20,12,8,0.992,0.84
2005/5/16,945,5972,-25,50,43,7,0.996,0.719
2005/5/16,1045,5956,-17,20,20,0,0.999,1.445
2005/5/16,1145,5959,2,20,11,9,1,1.759
2005/5/16,1245,5964,5,13,2,11,1,2.357
2005/5/16,1345,5931,-33,42,35,7,1.007,0.964
2005/5/17,945,5935,-28,41,24,17,1.007,0.766
2005/5/17,1045,5942,7,21,3,18,1.005,2.509
2005/5/17,1145,5930,-14,22,13,9,1.006,2.144
2005/5/17,1245,5888,-42,45,42,3,1.012,0.857
2005/5/17,1345,5877,-11,30,11,19,1.012,0.586
2005/5/18,945,5886,-23,27,21,6,1.009,1.321
2005/5/18,1045,5908,22,25,2,23,1.004,1.821
2005/5/18,1145,5903,-4,13,10,3,1.004,2.391
2005/5/18,1245,5905,2,15,10,5,1.003,2.226
2005/5/18,1345,5880,-26,23,30,-7,1.006,1.031
2005/5/19,945,5964,23,45,11,34,0.991,0.256
2005/5/19,1045,5954,-10,14,11,3,0.993,1.278
2005/5/19,1145,5953,0,13,1,12,0.994,1.189
2005/5/19,1245,5939,-14,15,17,-2,0.996,1.726
2005/5/19,1345,5947,8,17,6,11,0.996,0.911
2005/5/20,945,5950,-4,20,11,9,0.996,0.805
2005/5/20,1045,5953,2,15,11,4,0.997,1.247
2005/5/20,1145,5949,-6,11,7,4,0.998,2.065
2005/5/20,1245,5941,-8,11,10,1,1,3.389
2005/5/20,1345,5920,-20,24,28,-4,1.005,1
2005/5/23,945,5876,-50,63,48,15,1.012,0.367
2005/5/23,1045,5869,-6,24,13,11,1.012,0.797
2005/5/23,1145,5870,1,20,10,10,1.01,1.778
2005/5/23,1245,5865,-5,22,12,10,1.009,1.632
2005/5/23,1345,5878,13,18,-3,21,1.006,1.22
2005/5/24,945,5878,0,18,11,7,1.005,1.126
2005/5/24,1045,5879,1,20,16,4,1.003,1.214
2005/5/24,1145,5877,-3,10,11,-1,1.002,2.145
2005/5/24,1245,5882,5,13,7,6,1,2.195
2005/5/24,1345,5875,-7,13,10,3,1,1.984
2005/5/25,945,5920,40,52,10,42,0.992,0.395
2005/5/25,1045,5904,-17,27,17,10,0.995,0.546
2005/5/25,1145,5851,-52,58,58,0,1.005,0.658
2005/5/25,1245,5836,-16,34,20,14,1.007,0.556
2005/5/25,1345,5849,12,22,9,13,1.005,0.921
2005/5/26,945,5858,-3,31,15,16,1.003,0.96
2005/5/26,1045,5874,17,21,4,17,1,1.148
2005/5/26,1145,5872,-2,19,12,7,1,1.588
2005/5/26,1245,5873,1,17,10,7,1,2.998
2005/5/26,1345,5899,26,29,3,26,0.995,0.975
2005/5/27,945,5959,29,42,6,36,0.986,0.54
2005/5/27,1045,5955,-4,16,5,11,0.987,0.924
2005/5/27,1145,5942,-14,17,15,2,0.99,1.361
2005/5/27,1245,5951,9,11,2,9,0.99,2.162
2005/5/27,1345,5950,-1,21,13,8,0.992,1.038
2005/5/30,945,5938,-20,34,29,5,0.996,1.02
2005/5/30,1045,5937,-1,13,8,5,0.998,2.438
2005/5/30,1145,5957,21,33,6,27,0.995,1.499
2005/5/30,1245,5950,-7,24,19,5,0.998,1.451
2005/5/30,1345,5952,3,10,5,5,0.999,1.481
2005/5/31,945,5934,-6,36,14,22,1.002,0.47
2005/5/31,1045,5959,24,31,1,30,0.997,0.931
2005/5/31,1145,5950,-8,19,15,4,0.999,0.817
2005/5/31,1245,5951,2,25,11,14,0.999,1.162
2005/5/31,1345,5943,-9,22,15,7,1,0.769
2005/6/1,945,5946,3,21,10,11,0.999,0.922
2005/6/1,1045,5923,-23,35,20,15,1.003,0.564
2005/6/1,1145,5921,-2,24,8,16,1.004,1.079
2005/6/1,1245,5925,5,14,3,11,1.002,2.146
2005/6/1,1345,5935,10,13,3,10,1,1.243
2005/6/2,945,5977,14,21,8,13,0.994,0.585
2005/6/2,1045,5995,17,28,10,18,0.991,0.615
2005/6/2,1145,5981,-13,19,13,6,0.994,1.579
2005/6/2,1245,5989,8,16,5,11,0.993,2.162
2005/6/2,1345,5973,-16,18,20,-2,0.997,1.235
2005/6/3,945,6002,14,32,8,24,0.993,0.82
2005/6/3,1045,6021,18,35,14,21,0.99,0.543
2005/6/3,1145,6044,23,32,9,23,0.988,0.893
2005/6/3,1245,6039,-5,17,8,9,0.991,1.599
2005/6/3,1345,6038,0,22,20,2,0.993,1.003
2005/6/6,945,6043,28,38,12,26,0.993,1.073
2005/6/6,1045,6060,18,24,3,21,0.991,1.214
2005/6/6,1145,6058,-2,23,9,14,0.993,1.249
2005/6/6,1245,6058,1,9,1,8,0.994,3.011
2005/6/6,1345,6069,10,14,3,11,0.994,1.263
2005/6/7,945,6052,-19,19,15,4,0.998,1.091
2005/6/7,1045,6044,-9,19,12,7,1,1.214
2005/6/7,1145,6057,13,19,6,13,0.998,2.004
2005/6/7,1245,6060,3,16,12,4,0.998,1.21
2005/6/7,1345,6060,1,10,6,4,0.998,1.42
2005/6/8,945,6092,40,50,13,37,0.993,0.493
2005/6/8,1045,6113,19,31,2,29,0.991,0.756
2005/6/8,1145,6119,7,16,7,9,0.991,0.923
2005/6/8,1245,6122,3,17,2,15,0.991,1.479
2005/6/8,1345,6131,9,30,12,18,0.991,0.622
2005/6/9,945,6141,22,45,21,24,0.99,0.795
2005/6/9,1045,6145,4,27,2,25,0.991,1.129
2005/6/9,1145,6140,-4,17,5,12,0.993,2.343
2005/6/9,1245,6135,-7,12,10,2,0.995,3.364
2005/6/9,1345,6125,-10,20,8,12,0.998,1.048
2005/6/10,945,6129,-12,67,60,7,0.999,0.449
2005/6/10,1045,6148,21,30,-2,32,0.997,1.568
2005/6/10,1145,6147,0,17,11,6,0.997,2.206
2005/6/10,1245,6152,5,17,10,7,0.997,2.23
2005/6/10,1345,6175,24,26,1,25,0.994,0.972
2005/6/13,945,6163,-12,29,22,7,0.997,1.029
2005/6/13,1045,6163,-1,18,17,1,0.997,1.722
2005/6/13,1145,6175,12,17,5,12,0.995,2.114
2005/6/13,1245,6202,26,42,16,26,0.992,0.683
2005/6/13,1345,6240,36,39,5,34,0.987,0.531
2005/6/14,945,6247,8,26,1,25,0.987,0.752
2005/6/14,1045,6250,3,26,21,5,0.989,0.886
2005/6/14,1145,6258,9,21,9,12,0.989,1.405
2005/6/14,1245,6243,-15,34,17,17,0.993,1.134
2005/6/14,1345,6221,-22,26,22,4,0.998,0.856
2005/6/15,945,6235,1,21,10,11,0.997,1.74
2005/6/15,1045,6221,-14,19,20,-1,1,2.679
2005/6/15,1145,6235,14,12,-1,13,0.999,2.199
2005/6/15,1245,6249,15,19,2,17,0.997,1.879
2005/6/15,1345,6266,18,24,4,20,0.995,0.622
2005/6/16,945,6142,-8,31,27,4,1.014,0.358
2005/6/16,1045,6157,15,27,2,25,1.01,0.845
2005/6/16,1145,6178,21,27,7,20,1.005,0.64
2005/6/16,1245,6176,-3,13,8,5,1.004,1.357
2005/6/16,1345,6180,6,24,14,10,1.002,0.697
2005/6/17,945,6235,47,69,18,51,0.993,0.467
2005/6/17,1045,6236,1,22,1,21,0.993,1.289
2005/6/17,1145,6241,5,24,11,13,0.992,1.143
2005/6/17,1245,6219,-23,47,37,10,0.996,0.978
2005/6/17,1345,6189,-30,45,29,16,1,0.661
2005/6/20,945,6173,-17,38,35,3,1.003,1.229
2005/6/20,1045,6183,10,23,11,12,1.002,2.322
2005/6/20,1145,6192,9,20,11,9,1.001,2.608
2005/6/20,1245,6196,4,19,10,9,1.001,2.898
2005/6/20,1345,6188,-8,16,10,6,1.002,1.822
2005/6/21,945,6188,-3,22,7,15,1.002,1.162
2005/6/21,1045,6177,-11,17,11,6,1.003,1.71
2005/6/21,1145,6187,10,23,2,21,1.001,1.342
2005/6/21,1245,6200,13,22,5,17,0.998,0.819
2005/6/21,1345,6197,-3,8,5,3,0.998,1.023
2005/6/22,945,6244,45,49,6,43,0.991,0.357
2005/6/22,1045,6258,14,23,10,13,0.99,0.737
2005/6/22,1145,6272,14,24,7,17,0.989,0.837
2005/6/22,1245,6315,42,50,3,47,0.983,0.613
2005/6/22,1345,6330,15,34,13,21,0.983,0.5
2005/6/23,945,6337,12,28,19,9,0.984,0.644
2005/6/23,1045,6330,-7,18,20,-2,0.987,1.562
2005/6/23,1145,6340,10,15,5,10,0.988,2.958
2005/6/23,1245,6332,-8,15,16,-1,0.992,2.565
2005/6/23,1345,6350,18,18,-4,22,0.991,1.702
2005/6/24,945,6298,-13,26,24,2,1.001,0.79
2005/6/24,1045,6291,-6,20,14,6,1.003,1.296
2005/6/24,1145,6290,-2,28,10,18,1.004,1.106
2005/6/24,1245,6315,25,41,6,35,1,1.136
2005/6/24,1345,6297,-17,25,28,-3,1.003,1.049
2005/6/27,945,6252,6,27,11,16,1.009,0.72
2005/6/27,1045,6240,-12,20,10,10,1.009,0.965
2005/6/27,1145,6246,6,39,26,13,1.007,0.999
2005/6/27,1245,6250,4,24,12,12,1.005,1.168
2005/6/27,1345,6257,7,8,-2,10,1.002,1.832
2005/6/28,945,6266,5,22,9,13,1,0.928
2005/6/28,1045,6259,-8,13,8,5,1.001,2.561
2005/6/28,1145,6264,5,10,4,6,0.999,1.928
2005/6/28,1245,6280,15,20,5,15,0.996,1.054
2005/6/28,1345,6284,4,13,4,9,0.995,1.067
2005/6/29,945,6306,-19,52,47,5,0.993,0.404
2005/6/29,1045,6229,-76,92,78,14,1.006,0.387
2005/6/29,1145,6220,-9,32,17,15,1.007,0.916
2005/6/29,1245,6197,-23,56,24,32,1.011,0.535
2005/6/29,1345,6199,1,32,24,8,1.009,0.882
2005/6/30,945,6204,-11,42,24,18,1.008,0.95
2005/6/30,1045,6201,-3,21,13,8,1.007,1.877
2005/6/30,1145,6212,11,19,5,14,1.005,3.348
2005/6/30,1245,6210,-3,13,15,-2,1.004,2.873
2005/6/30,1345,6199,-10,25,21,4,1.005,2.332
2005/7/1,945,6132,-58,78,71,7,1.014,0.648
2005/7/1,1045,6163,32,34,4,30,1.006,1.169
2005/7/1,1145,6188,25,49,8,41,1.001,0.898
2005/7/1,1245,6207,19,25,-2,27,0.997,1.435
2005/7/1,1345,6227,20,28,3,25,0.994,0.686
2005/7/4,945,6187,-61,60,55,5,1.001,0.776
2005/7/4,1045,6210,23,41,12,29,0.997,1.342
2005/7/4,1145,6202,-10,28,20,8,0.998,2.041
2005/7/4,1245,6206,4,16,4,12,0.998,3.71
2005/7/4,1345,6211,4,14,-1,15,0.997,1.844
2005/7/5,945,6178,-32,46,40,6,1.002,0.609
2005/7/5,1045,6169,-9,17,13,4,1.005,1.272
2005/7/5,1145,6187,18,25,8,17,1.002,1.304
2005/7/5,1245,6194,7,20,11,9,1.001,1.091
2005/7/5,1345,6163,-30,34,31,3,1.005,0.776
2005/7/6,945,6180,-5,29,15,14,1.002,0.605
2005/7/6,1045,6190,12,19,7,12,1,1.246
2005/7/6,1145,6189,0,21,19,2,1,1.195
2005/7/6,1245,6179,-9,24,18,6,1.001,1.584
2005/7/6,1345,6182,4,27,0,27,1,0.71
2005/7/7,945,6174,8,35,-3,38,1.001,0.589
2005/7/7,1045,6163,-10,19,17,2,1.002,1.443
2005/7/7,1145,6164,1,18,12,6,1.002,1.806
2005/7/7,1245,6156,-8,23,12,11,1.003,1.436
2005/7/7,1345,6166,9,22,2,20,1.001,0.719
2005/7/8,945,6173,3,29,13,16,0.999,0.752
2005/7/8,1045,6199,26,34,6,28,0.995,0.825
2005/7/8,1145,6192,-7,16,11,5,0.996,2.006
2005/7/8,1245,6176,-16,33,27,6,0.999,1.432
2005/7/8,1345,6181,5,19,1,18,0.998,1.103
2005/7/11,945,6243,-5,32,22,10,0.99,0.566
2005/7/11,1045,6247,5,19,10,9,0.99,1.358
2005/7/11,1145,6260,13,18,4,14,0.989,1.236
2005/7/11,1245,6271,11,34,17,17,0.989,0.896
2005/7/11,1345,6302,30,34,4,30,0.986,0.733
2005/7/12,945,6333,8,28,15,13,0.984,0.651
2005/7/12,1045,6341,8,16,2,14,0.985,1.504
2005/7/12,1145,6332,-10,21,21,0,0.989,1.067
2005/7/12,1245,6341,9,17,-1,18,0.99,1.471
2005/7/12,1345,6340,-1,20,12,8,0.992,1.144
2005/7/13,945,6339,-2,22,15,7,0.994,1.108
2005/7/13,1045,6375,34,47,13,34,0.99,0.62
2005/7/13,1145,6393,18,35,14,21,0.989,0.739
2005/7/13,1245,6375,-19,30,20,10,0.994,1.222
2005/7/13,1345,6376,2,15,7,8,0.995,1.27
2005/7/14,945,6402,2,35,18,17,0.993,0.779
2005/7/14,1045,6394,-9,23,8,15,0.995,1.299
2005/7/14,1145,6420,26,34,4,30,0.992,0.934
2005/7/14,1245,6418,-2,28,20,8,0.993,0.92
2005/7/14,1345,6435,18,18,-2,20,0.992,1.34
2005/7/15,945,6429,-17,27,19,8,0.994,0.951
2005/7/15,1045,6434,5,17,6,11,0.995,2.23
2005/7/15,1145,6439,4,20,10,10,0.995,1.761
2005/7/15,1245,6433,-7,15,13,2,0.997,2.569
2005/7/15,1345,6411,-22,30,32,-2,1.001,1.102
2005/7/19,945,6397,-22,34,22,12,1.004,0.89
2005/7/19,1045,6413,15,26,5,21,1.001,1.343
2005/7/19,1145,6427,16,20,2,18,0.999,1.341
2005/7/19,1245,6426,-1,9,4,5,0.999,1.828
2005/7/19,1345,6430,4,14,3,11,0.999,1.019
2005/7/20,945,6429,-1,28,9,19,0.999,0.909
2005/7/20,1045,6437,8,16,6,10,0.998,1.221
2005/7/20,1145,6467,31,45,12,33,0.993,0.668
2005/7/20,1245,6440,-28,36,34,2,0.998,1.029
2005/7/20,1345,6413,-27,41,29,12,1.002,0.583
2005/7/21,945,6428,2,44,24,20,1,0.27
2005/7/21,1045,6419,-8,24,7,17,1.002,0.84
2005/7/21,1145,6360,-59,94,64,30,1.011,0.471
2005/7/21,1245,6354,-5,32,23,9,1.011,1.064
2005/7/21,1345,6365,13,26,12,14,1.008,1.536
2005/7/22,945,6343,-11,38,23,15,1.01,0.975
2005/7/22,1045,6334,-8,27,27,0,1.01,1.972
2005/7/22,1145,6344,10,36,17,19,1.007,1.255
2005/7/22,1245,6338,-6,18,16,2,1.006,2.438
2005/7/22,1345,6342,4,15,3,12,1.004,1.979
2005/7/25,945,6371,12,26,11,15,0.998,0.997
2005/7/25,1045,6385,15,25,5,20,0.995,1.883
2005/7/25,1145,6387,2,16,11,5,0.994,1.258
2005/7/25,1245,6386,-3,12,4,8,0.995,2.524
2005/7/25,1345,6406,21,25,-2,27,0.992,1.131
2005/7/26,945,6394,-1,25,4,21,0.995,0.779
2005/7/26,1045,6394,0,18,14,4,0.996,1.275
2005/7/26,1145,6385,-9,22,13,9,0.998,1.543
2005/7/26,1245,6359,-27,31,29,2,1.003,0.791
2005/7/26,1345,6330,-30,32,21,11,1.008,0.424
2005/7/27,945,6316,-12,26,26,0,1.009,0.785
2005/7/27,1045,6317,2,28,16,12,1.008,0.798
2005/7/27,1145,6303,-13,36,19,17,1.01,0.782
2005/7/27,1245,6321,18,33,4,29,1.005,1.353
2005/7/27,1345,6310,-11,14,9,5,1.006,1.519
2005/7/28,945,6314,-11,27,21,6,1.004,1.067
2005/7/28,1045,6326,11,19,1,18,1.001,1.486
2005/7/28,1145,6316,-9,17,17,0,1.002,2.464
2005/7/28,1245,6320,4,18,2,16,1,1.928
2005/7/28,1345,6350,30,31,0,31,0.995,0.65
2005/7/29,945,6374,13,32,21,11,0.991,0.512
2005/7/29,1045,6315,-60,72,63,9,1.002,0.477
2005/7/29,1145,6319,5,36,8,28,1.001,0.933
2005/7/29,1245,6324,5,31,15,16,1,1.402
2005/7/29,1345,6277,-46,49,50,-1,1.008,0.677
2005/8/1,945,6275,-6,30,19,11,1.007,1.092
2005/8/1,1045,6284,9,23,6,17,1.005,2.341
2005/8/1,1145,6288,3,17,9,8,1.004,3.971
2005/8/1,1245,6285,-3,11,10,1,1.004,4.338
2005/8/1,1345,6297,13,20,-1,21,1.002,2.264
2005/8/2,945,6312,14,37,18,19,0.998,0.765
2005/8/2,1045,6306,-6,44,9,35,0.998,0.758
2005/8/2,1145,6308,1,23,17,6,0.998,0.896
2005/8/2,1245,6302,-6,32,16,16,0.999,0.947
2005/8/2,1345,6340,38,31,-6,37,0.992,0.69
2005/8/3,945,6383,8,25,12,13,0.987,0.408
2005/8/3,1045,6402,19,25,6,19,0.986,0.811
2005/8/3,1145,6411,9,26,3,23,0.986,1.316
2005/8/3,1245,6426,15,32,14,18,0.986,0.739
2005/8/3,1345,6431,5,30,24,6,0.987,0.761
2005/8/4,945,6430,-16,33,22,11,0.99,0.893
2005/8/4,1045,6441,12,18,7,11,0.99,1.739
2005/8/4,1145,6460,19,28,4,24,0.989,1.553
2005/8/4,1245,6435,-25,37,25,12,0.995,1.334
2005/8/4,1345,6445,10,18,-1,19,0.996,1.606
2005/8/8,945,6365,5,25,11,14,1.008,0.663
2005/8/8,1045,6368,4,23,7,16,1.007,1.928
2005/8/8,1145,6372,4,17,8,9,1.006,2.644
2005/8/8,1245,6375,3,17,8,9,1.005,2.033
2005/8/8,1345,6370,-5,19,6,13,1.005,1.063
2005/8/9,945,6370,9,21,3,18,1.004,0.753
2005/8/9,1045,6375,5,19,4,15,1.002,1.552
2005/8/9,1145,6361,-13,16,14,2,1.003,1.781
2005/8/9,1245,6378,16,16,2,14,0.999,1.932
2005/8/9,1345,6394,17,19,-4,23,0.995,1.117
2005/8/10,945,6420,7,17,8,9,0.992,0.444
2005/8/10,1045,6375,-45,62,48,14,1,0.392
2005/8/10,1145,6369,-6,24,10,14,1.001,0.977
2005/8/10,1245,6364,-5,14,13,1,1.002,2.537
2005/8/10,1345,6345,-20,30,23,7,1.005,0.609
2005/8/11,945,6370,10,22,5,17,1.001,0.911
2005/8/11,1045,6356,-14,29,18,11,1.003,1.393
2005/8/11,1145,6356,0,16,13,3,1.003,2.127
2005/8/11,1245,6355,-2,25,10,15,1.003,1.745
2005/8/11,1345,6389,41,41,-1,42,0.997,0.913
2005/8/12,945,6390,-4,34,22,12,0.997,0.646
2005/8/12,1045,6390,0,18,12,6,0.996,1.664
2005/8/12,1145,6381,-10,24,14,10,0.998,1.564
2005/8/12,1245,6399,16,22,1,21,0.995,1.885
2005/8/12,1345,6352,-46,47,46,1,1.003,0.734
2005/8/15,945,6277,-60,61,61,0,1.015,0.436
2005/8/15,1045,6262,-16,50,33,17,1.016,0.724
2005/8/15,1145,6262,0,19,8,11,1.014,1.183
2005/8/15,1245,6248,-14,32,17,15,1.015,1.32
2005/8/15,1345,6240,-7,34,18,16,1.015,0.921
2005/8/16,945,6242,-3,27,15,12,1.012,0.997
2005/8/16,1045,6245,3,16,6,10,1.009,1.652
2005/8/16,1145,6235,-11,26,15,11,1.008,1.543
2005/8/16,1245,6215,-19,41,24,17,1.009,0.959
2005/8/16,1345,6235,20,40,20,20,1.003,1.08
2005/8/17,945,6228,43,46,7,39,1.002,1.114
2005/8/17,1045,6238,10,23,13,10,0.999,1.447
2005/8/17,1145,6244,6,13,1,12,0.998,2.055
2005/8/17,1245,6247,3,11,1,10,0.997,1.855
2005/8/17,1345,6220,-27,30,35,-5,1.001,0.919
2005/8/18,945,6239,1,27,8,19,0.998,0.557
2005/8/18,1045,6206,-34,48,33,15,1.004,0.559
2005/8/18,1145,6204,-2,24,2,22,1.003,0.89
2005/8/18,1245,6215,10,21,14,7,1.001,1.272
2005/8/18,1345,6190,-26,24,24,0,1.005,0.889
2005/8/19,945,6166,-13,30,11,19,1.009,0.515
2005/8/19,1045,6141,-24,33,27,6,1.012,1.077
2005/8/19,1145,6174,32,45,6,39,1.005,1.201
2005/8/19,1245,6164,-10,15,12,3,1.006,2.432
2005/8/19,1345,6164,1,20,6,14,1.004,1.608
2005/8/22,945,6182,-7,22,15,7,1,1.041
2005/8/22,1045,6186,2,10,4,6,0.999,2.67
2005/8/22,1145,6192,6,13,3,10,0.998,1.779
2005/8/22,1245,6193,0,17,14,3,0.997,1.611
2005/8/22,1345,6215,22,25,3,22,0.993,0.886
2005/8/23,945,6212,3,16,-4,20,0.994,0.902
2005/8/23,1045,6192,-20,32,22,10,0.998,0.891
2005/8/23,1145,6199,7,17,7,10,0.998,1.4
2005/8/23,1245,6198,-1,13,3,10,0.999,2.564
2005/8/23,1345,6185,-12,21,19,2,1.001,1.121
2005/8/24,945,6148,-13,22,13,9,1.007,0.487
2005/8/24,1045,6150,2,15,5,10,1.006,1.262
2005/8/24,1145,6168,18,26,5,21,1.002,0.959
2005/8/24,1245,6152,-16,31,26,5,1.005,0.894
2005/8/24,1345,6147,-5,27,22,5,1.005,0.734
2005/8/25,945,6128,10,39,12,27,1.006,0.489
2005/8/25,1045,6143,15,19,2,17,1.002,1.265
2005/8/25,1145,6162,19,22,6,16,0.999,1.027
2005/8/25,1245,6145,-16,17,15,2,1.001,1.235
2005/8/25,1345,6126,-19,28,23,5,1.003,0.856
2005/8/26,945,6142,-5,21,9,12,1,0.919
2005/8/26,1045,6148,5,17,11,6,0.999,1.337
2005/8/26,1145,6142,-5,19,15,4,1,1.537
2005/8/26,1245,6147,5,16,8,8,0.999,1.473
2005/8/26,1345,6150,3,6,1,5,0.998,1.597
2005/8/29,945,6085,-31,44,45,-1,1.009,0.511
2005/8/29,1045,6059,-27,42,31,11,1.012,0.611
2005/8/29,1145,6058,-1,25,7,18,1.011,1.266
2005/8/29,1245,6037,-21,26,24,2,1.013,1.351
2005/8/29,1345,6046,9,18,4,14,1.01,0.936
2005/8/30,945,6076,-4,24,16,8,1.004,0.824
2005/8/30,1045,6050,-27,37,30,7,1.007,0.954
2005/8/30,1145,6060,9,17,5,12,1.004,2.051
2005/8/30,1245,6056,-4,18,9,9,1.003,2.416
2005/8/30,1345,6055,-1,14,7,7,1.002,1.574
2005/8/31,945,6071,26,44,14,30,0.998,0.659
2005/8/31,1045,6062,-10,25,21,4,0.999,0.921
2005/8/31,1145,6011,-51,62,53,9,1.008,0.741
2005/8/31,1245,5993,-19,31,25,6,1.01,0.645
2005/8/31,1345,6050,58,66,3,63,1,0.625
2005/9/2,945,6091,-10,30,22,8,0.993,0.646
2005/9/2,1045,6097,7,14,2,12,0.992,2.344
2005/9/2,1145,6098,1,17,8,9,0.993,1.397
2005/9/2,1245,6102,5,13,7,6,0.993,2.149
2005/9/2,1345,6119,17,24,3,21,0.991,0.968
2005/9/5,945,6109,-6,17,11,6,0.994,1.35
2005/9/5,1045,6105,-4,15,11,4,0.995,2.68
2005/9/5,1145,6110,6,14,4,10,0.995,3.428
2005/9/5,1245,6116,6,12,1,11,0.996,2.553
2005/9/5,1345,6108,-7,11,8,3,0.999,2
2005/9/6,945,6150,20,22,9,13,0.992,0.386
2005/9/6,1045,6145,-4,12,5,7,0.994,1.222
2005/9/6,1145,6145,1,14,9,5,0.995,1.629
2005/9/6,1245,6138,-7,20,10,10,0.997,1.003
2005/9/6,1345,6150,12,14,0,14,0.996,1.012
2005/9/7,945,6156,-32,40,31,9,0.996,0.36
2005/9/7,1045,6148,-7,25,9,16,0.998,0.718
2005/9/7,1145,6148,0,12,4,8,0.999,2.334
2005/9/7,1245,6149,1,9,6,3,0.999,2.094
2005/9/7,1345,6164,15,17,-1,18,0.997,0.952
2005/9/8,945,6157,-1,18,12,6,0.999,0.942
2005/9/8,1045,6155,-2,15,10,5,0.999,2.068
2005/9/8,1145,6158,3,6,2,4,0.999,4.376
2005/9/8,1245,6146,-13,22,16,6,1.001,1.085
2005/9/8,1345,6154,9,20,4,16,1,1.204
2005/9/9,945,6151,-1,18,7,11,1,0.768
2005/9/9,1045,6120,-32,37,32,5,1.005,0.418
2005/9/9,1145,6105,-16,27,15,12,1.007,0.58
2005/9/9,1245,6117,13,16,1,15,1.004,1.958
2005/9/9,1345,6114,-3,16,9,7,1.004,0.769
2005/9/12,945,6133,-25,24,27,-3,1.001,0.579
2005/9/12,1045,6138,5,21,5,16,1,1.306
2005/9/12,1145,6151,13,15,-4,19,0.997,2.711
2005/9/12,1245,6152,1,11,5,6,0.997,1.228
2005/9/12,1345,6165,14,17,3,14,0.995,1.073
2005/9/13,945,6155,-3,16,9,7,0.997,1.083
2005/9/13,1045,6183,27,36,6,30,0.992,0.629
2005/9/13,1145,6177,-5,16,9,7,0.994,1.063
2005/9/13,1245,6179,1,9,6,3,0.995,1.933
2005/9/13,1345,6164,-15,20,19,1,0.999,1.036
2005/9/14,945,6157,7,21,9,12,1,0.844
2005/9/14,1045,6151,-6,18,6,12,1.001,1.112
2005/9/14,1145,6144,-6,21,10,11,1.002,1.381
2005/9/14,1245,6145,1,18,2,16,1.002,1.444
2005/9/14,1345,6155,10,16,2,14,1,1.148
2005/9/15,945,6110,-20,40,27,13,1.007,0.473
2005/9/15,1045,6119,8,15,7,8,1.005,1.032
2005/9/15,1145,6108,-11,17,15,2,1.006,1.294
2005/9/15,1245,6099,-9,14,16,-2,1.006,1.501
2005/9/15,1345,6080,-19,22,25,-3,1.008,0.638
2005/9/16,945,6062,-23,32,27,5,1.01,0.809
2005/9/16,1045,6030,-30,47,35,12,1.014,0.592
2005/9/16,1145,6047,16,40,6,34,1.009,0.906
2005/9/16,1245,6028,-18,25,20,5,1.01,1.326
2005/9/16,1345,6045,18,26,-3,29,1.006,0.93
2005/9/19,945,6043,-7,26,15,11,1.005,1.42
2005/9/19,1045,6034,-9,17,15,2,1.005,3.304
2005/9/19,1145,6039,5,19,6,13,1.003,2.83
2005/9/19,1245,6040,2,14,9,5,1.001,2.166
2005/9/19,1345,6030,-10,9,10,-1,1.002,1.822
2005/9/20,945,6013,-18,47,21,26,1.004,0.598
2005/9/20,1045,6072,59,76,16,60,0.993,0.455
2005/9/20,1145,6076,6,15,2,13,0.993,1.404
2005/9/20,1245,6112,36,48,12,36,0.988,0.601
2005/9/20,1345,6106,-5,15,16,-1,0.99,0.816
2005/9/21,945,6104,22,30,12,18,0.991,1.277
2005/9/21,1045,6093,-11,18,14,4,0.994,1.57
2005/9/21,1145,6100,7,11,3,8,0.994,2.784
2005/9/21,1245,6092,-8,15,9,6,0.996,3.776
2005/9/21,1345,6059,-32,33,30,3,1.002,1.124
2005/9/22,945,6038,7,32,9,23,1.006,0.407
2005/9/22,1045,5986,-53,75,54,21,1.015,0.39
2005/9/22,1145,5997,10,29,8,21,1.012,0.87
2005/9/22,1245,5993,-5,22,8,14,1.011,1.128
2005/9/22,1345,5979,-14,30,18,12,1.012,0.641
2005/9/23,945,5954,-12,35,24,11,1.014,0.69
2005/9/23,1045,5936,-18,33,26,7,1.015,0.929
2005/9/23,1145,5940,4,20,5,15,1.011,1.829
2005/9/23,1245,5924,-15,37,25,12,1.011,1.727
2005/9/23,1345,5931,7,44,6,38,1.007,0.926
2005/9/26,945,5950,-11,28,21,7,1.003,1.108
2005/9/26,1045,5925,-25,34,31,3,1.006,1.339
2005/9/26,1145,5906,-19,38,20,18,1.008,0.855
2005/9/26,1245,5934,28,39,9,30,1.001,1.42
2005/9/26,1345,5950,16,25,8,17,0.998,1.288
2005/9/27,945,5904,-27,41,30,11,1.005,0.727
2005/9/27,1045,5965,60,75,15,60,0.994,0.546
2005/9/27,1145,5959,-5,22,13,9,0.995,1.763
2005/9/27,1245,5937,-22,39,30,9,0.999,1.5
2005/9/27,1345,5935,-3,20,9,11,1,1.198
2005/9/28,945,5919,-22,40,27,13,1.002,0.989
2005/9/28,1045,5922,3,21,9,12,1.001,1.793
2005/9/28,1145,5958,37,51,15,36,0.995,0.688
2005/9/28,1245,5946,-11,25,26,-1,0.998,1.352
2005/9/28,1345,5933,-14,19,18,1,1,1.228
2005/9/29,945,5948,18,28,6,22,0.998,1.261
2005/9/29,1045,5960,12,25,13,12,0.997,0.877
2005/9/29,1145,5985,25,39,12,27,0.992,0.617
2005/9/29,1245,6006,21,36,12,24,0.989,0.808
2005/9/29,1345,6022,16,21,-3,24,0.988,0.787
2005/9/30,945,6073,34,37,9,28,0.981,0.516
2005/9/30,1045,6095,22,49,19,30,0.98,0.663
2005/9/30,1145,6091,-4,33,22,11,0.984,1.25
2005/9/30,1245,6104,13,20,-1,21,0.984,2.311
2005/9/30,1345,6095,-10,22,20,2,0.988,1.075
2005/10/3,945,6093,-13,19,19,0,0.991,1.171
2005/10/3,1045,6122,32,36,2,34,0.989,1.598
2005/10/3,1145,6127,5,17,5,12,0.99,1.378
2005/10/3,1245,6125,-1,10,3,7,0.993,2.17
2005/10/3,1345,6118,-7,13,11,2,0.996,1.905
2005/10/4,945,6129,-1,31,19,12,0.996,0.688
2005/10/4,1045,6138,9,25,8,17,0.995,1.209
2005/10/4,1145,6155,17,29,7,22,0.993,0.809
2005/10/4,1245,6154,-1,21,12,9,0.994,1.032
2005/10/4,1345,6142,-10,15,13,2,0.997,1.113
2005/10/5,945,6149,17,26,8,18,0.996,0.612
2005/10/5,1045,6139,-9,22,11,11,0.999,1.017
2005/10/5,1145,6141,3,16,4,12,0.999,1.694
2005/10/5,1245,6147,7,20,8,12,0.998,2.079
2005/10/5,1345,6130,-18,32,20,12,1.001,0.898
2005/10/6,945,6081,1,29,13,16,1.009,0.677
2005/10/6,1045,6085,4,15,2,13,1.007,1.532
2005/10/6,1145,6092,6,17,6,11,1.005,1.809
2005/10/6,1245,6093,0,13,4,9,1.004,2.507
2005/10/6,1345,6100,7,16,-1,17,1.002,1.158
2005/10/7,945,6096,13,18,7,11,1.002,1.009
2005/10/7,1045,6097,0,17,12,5,1.001,1.152
2005/10/7,1145,6094,-3,15,5,10,1,2.02
2005/10/7,1245,6095,2,14,7,7,1,2.236
2005/10/7,1345,6095,-1,18,8,10,0.999,0.84
2005/10/11,945,6112,34,52,14,38,0.996,0.485
2005/10/11,1045,6095,-17,23,15,8,0.999,0.859
2005/10/11,1145,6086,-9,16,10,6,1.001,1.576
2005/10/11,1245,6089,3,10,2,8,1,2.064
2005/10/11,1345,6099,9,13,-2,15,0.998,1.2
2005/10/12,945,6042,-36,44,35,9,1.008,0.304
2005/10/12,1045,6033,-9,25,17,8,1.008,0.712
2005/10/12,1145,6045,13,17,1,16,1.005,1.612
2005/10/12,1245,6026,-19,28,24,4,1.008,1.277
2005/10/12,1345,6004,-22,29,22,7,1.01,0.585
2005/10/13,945,5962,-19,34,24,10,1.016,0.705
2005/10/13,1045,5955,-7,17,14,3,1.014,1.933
2005/10/13,1145,5946,-9,21,11,10,1.014,1.14
2005/10/13,1245,5958,13,22,6,16,1.009,2
2005/10/13,1345,5985,27,33,0,33,1.002,1.068
2005/10/14,945,5985,3,19,8,11,1.001,1.194
2005/10/14,1045,5972,-11,26,26,0,1.002,1.243
2005/10/14,1145,5970,-2,18,13,5,1.001,2.14
2005/10/14,1245,5975,5,9,0,9,0.999,2.815
2005/10/14,1345,5968,-7,16,14,2,1,1.425
2005/10/17,945,5956,-29,34,29,5,1.002,0.872
2005/10/17,1045,5894,-61,57,58,-1,1.012,0.478
2005/10/17,1145,5885,-10,26,19,7,1.013,0.935
2005/10/17,1245,5865,-20,30,26,4,1.015,1.207
2005/10/17,1345,5815,-50,55,53,2,1.022,0.556
2005/10/18,945,5830,4,28,16,12,1.017,1.056
2005/10/18,1045,5853,20,42,7,35,1.01,0.774
2005/10/18,1145,5851,-1,12,9,3,1.009,1.868
2005/10/18,1245,5849,-3,18,6,12,1.007,2.173
2005/10/18,1345,5839,-10,17,13,4,1.006,1.871
2005/10/19,945,5753,-33,49,36,13,1.018,0.912
2005/10/19,1045,5728,-25,45,27,18,1.019,1.122
2005/10/19,1145,5712,-16,28,31,-3,1.019,2.006
2005/10/19,1245,5717,5,30,17,13,1.015,1.443
2005/10/19,1345,5678,-39,33,39,-6,1.019,0.771
2005/10/20,945,5753,21,51,16,35,1.004,0.295
2005/10/20,1045,5752,0,22,5,17,1.003,0.794
2005/10/20,1145,5727,-25,36,30,6,1.006,0.775
2005/10/20,1245,5693,-34,45,37,8,1.01,0.654
2005/10/20,1345,5772,79,146,7,139,0.993,0.401
2005/10/21,945,5731,6,72,13,59,0.999,0.597
2005/10/21,1045,5725,-6,25,23,2,1,1.315
2005/10/21,1145,5745,20,29,3,26,0.996,2.288
2005/10/21,1245,5736,-9,29,19,10,0.998,2.332
2005/10/21,1345,5735,-1,31,9,22,0.999,1.965
2005/10/24,945,5734,-11,30,21,9,0.999,1.18
2005/10/24,1045,5738,5,21,11,10,0.998,2.525
2005/10/24,1145,5704,-35,40,36,4,1.004,1.574
2005/10/24,1245,5718,14,19,4,15,1.001,2.085
2005/10/24,1345,5712,-5,24,4,20,1.003,1.158
2005/10/25,945,5791,11,25,16,9,0.99,0.467
2005/10/25,1045,5766,-25,37,27,10,0.995,0.758
2005/10/25,1145,5758,-8,26,16,10,0.997,1.233
2005/10/25,1245,5749,-10,20,8,12,0.999,1.199
2005/10/25,1345,5718,-31,44,47,-3,1.005,0.809
2005/10/26,945,5695,-37,45,35,10,1.009,0.661
2005/10/26,1045,5730,35,64,17,47,1.002,0.657
2005/10/26,1145,5713,-17,39,18,21,1.005,1.226
2005/10/26,1245,5712,-1,26,20,6,1.005,1.558
2005/10/26,1345,5704,-7,26,24,2,1.006,1.265
2005/10/27,945,5699,18,71,17,54,1.005,0.555
2005/10/27,1045,5719,19,40,7,33,1,1.003
2005/10/27,1145,5692,-27,28,27,1,1.004,1.787
2005/10/27,1245,5677,-18,26,21,5,1.006,1.344
2005/10/27,1345,5675,-3,24,22,2,1.005,1.761
2005/10/28,945,5664,49,70,23,47,1.005,0.691
2005/10/28,1045,5659,-6,27,16,11,1.005,1.39
2005/10/28,1145,5650,-8,23,8,15,1.005,1.602
2005/10/28,1245,5655,6,16,4,12,1.003,2.849
2005/10/28,1345,5660,4,25,13,12,1.002,0.962
2005/10/31,945,5700,0,25,10,15,0.995,0.765
2005/10/31,1045,5710,9,25,5,20,0.993,1.235
2005/10/31,1145,5744,34,40,4,36,0.987,0.733
2005/10/31,1245,5745,1,16,10,6,0.988,1.169
2005/10/31,1345,5775,29,42,7,35,0.984,0.786
2005/11/1,945,5792,-14,34,28,6,0.984,0.518
2005/11/1,1045,5811,20,25,2,23,0.983,1.347
2005/11/1,1145,5812,1,13,2,11,0.986,1.677
2005/11/1,1245,5801,-11,23,18,5,0.99,1.35
2005/11/1,1345,5798,-3,14,6,8,0.993,1.278
2005/11/2,945,5820,12,29,12,17,0.991,0.743
2005/11/2,1045,5812,-7,15,7,8,0.995,1.414
2005/11/2,1145,5822,9,19,9,10,0.995,1.243
2005/11/2,1245,5839,15,22,6,16,0.993,0.998
2005/11/2,1345,5853,15,23,5,18,0.993,0.85
2005/11/3,945,5859,-21,32,28,4,0.993,0.606
2005/11/3,1045,5864,3,19,10,9,0.993,1.552
2005/11/3,1145,5864,0,12,4,8,0.994,2.97
2005/11/3,1245,5848,-15,26,23,3,0.998,1.731
2005/11/3,1345,5842,-6,16,12,4,0.999,0.984
2005/11/4,945,5902,27,47,14,33,0.99,0.446
2005/11/4,1045,5886,-16,31,24,7,0.995,1.169
2005/11/4,1145,5870,-16,23,24,-1,0.998,1.265
2005/11/4,1245,5880,10,16,2,14,0.998,1.92
2005/11/4,1345,5885,6,29,7,22,0.997,0.822
2005/11/7,945,5865,-26,23,22,1,1.001,0.954
2005/11/7,1045,5859,-6,19,5,14,1.002,0.849
2005/11/7,1145,5855,-4,15,5,10,1.003,1.711
2005/11/7,1245,5849,-6,15,9,6,1.004,1.901
2005/11/7,1345,5832,-17,24,18,6,1.007,0.78
2005/11/8,945,5842,-8,23,8,15,1.004,0.807
2005/11/8,1045,5839,-3,18,8,10,1.004,1.28
2005/11/8,1145,5840,0,11,3,8,1.003,2.258
2005/11/8,1245,5839,0,16,10,6,1.003,1.486
2005/11/8,1345,5840,2,7,1,6,1.002,1.523
2005/11/9,945,5888,55,66,6,60,0.993,0.435
2005/11/9,1045,5922,35,42,7,35,0.987,0.45
2005/11/9,1145,5929,6,23,6,17,0.987,1.006
2005/11/9,1245,5951,23,39,18,21,0.985,0.724
2005/11/9,1345,5973,22,28,7,21,0.983,0.828
2005/11/10,945,5985,17,35,18,17,0.983,0.768
2005/11/10,1045,5986,1,14,11,3,0.985,1.889
2005/11/10,1145,6016,30,40,7,33,0.983,0.852
2005/11/10,1245,6028,12,28,10,18,0.983,0.799
2005/11/10,1345,6000,-29,42,30,12,0.991,0.955
2005/11/11,945,6046,-4,45,34,11,0.987,0.703
2005/11/11,1045,6044,-2,26,13,13,0.99,1.654
2005/11/11,1145,6052,7,20,12,8,0.991,2.212
2005/11/11,1245,6070,18,36,13,23,0.99,1.242
2005/11/11,1345,6096,26,26,-3,29,0.988,1.014
2005/11/14,945,6089,-5,20,6,14,0.991,1.186
2005/11/14,1045,6077,-12,28,30,-2,0.995,1.642
2005/11/14,1145,6091,14,14,-1,15,0.994,2.712
2005/11/14,1245,6086,-5,15,10,5,0.996,2.904
2005/11/14,1345,6090,6090,20,12,8,0.896,1.344
2005/11/15,945,6050,-37,50,48,2,0.903,0.586
2005/11/15,1045,6027,-23,41,28,13,0.906,0.657
2005/11/15,1145,6015,-12,27,14,13,0.908,0.772
2005/11/15,1245,6028,13,25,2,23,0.905,1.13
2005/11/15,1345,6030,3,20,0,20,0.904,1.341
2005/11/16,945,6073,48,75,15,60,0.897,1.119
2005/11/16,1045,6056,-16,21,16,5,0.899,2.099
2005/11/16,1145,6003,-54,80,57,23,0.907,0.957
2005/11/16,1245,6020,16,32,1,31,0.903,2.362
2005/11/16,1345,6039,18,21,2,19,0.999,1.828
2005/11/17,945,6008,-41,71,61,10,1.004,0.43
2005/11/17,1045,6008,0,27,9,18,1.003,0.832
2005/11/17,1145,6008,0,28,5,23,1.003,0.771
2005/11/17,1245,6012,4,28,22,6,1.002,0.8
2005/11/17,1345,6023,11,23,12,11,1,1.081
2005/11/18,945,6086,-13,32,21,11,0.991,0.632
2005/11/18,1045,6116,29,42,9,33,0.986,0.585
2005/11/18,1145,6113,-4,21,14,7,0.988,1.425
2005/11/18,1245,6113,0,17,12,5,0.99,1.806
2005/11/18,1345,6110,-4,25,10,15,0.992,1.034
2005/11/21,945,6118,-1,23,11,12,0.991,1.081
2005/11/21,1045,6130,12,21,10,11,0.991,1.194
2005/11/21,1145,6121,-9,30,24,6,0.995,1.217
2005/11/21,1245,6115,-5,27,18,9,0.998,1.539
2005/11/21,1345,6117,3,28,1,27,0.999,1.078
2005/11/22,945,6066,-44,37,38,-1,1.007,0.662
2005/11/22,1045,6082,16,25,8,17,1.004,1.171
2005/11/22,1145,6082,0,15,5,10,1.004,2.243
2005/11/22,1245,6076,-6,18,11,7,1.004,2.333
2005/11/22,1345,6075,-1,9,4,5,1.004,1.425
2005/11/23,945,6093,9,30,27,3,1,0.581
2005/11/23,1045,6093,0,20,5,15,1,0.956
2005/11/23,1145,6081,-10,22,13,9,1.001,1.394
2005/11/23,1245,6097,17,31,11,20,0.998,1.106
2005/11/23,1345,6123,27,29,1,28,0.993,0.645
2005/11/24,945,6094,-31,28,27,1,0.998,0.755
2005/11/24,1045,6102,8,19,6,13,0.998,1.47
2005/11/24,1145,6116,14,23,8,15,0.996,1.096
2005/11/24,1245,6116,0,31,17,14,0.996,0.872
2005/11/24,1345,6096,-20,34,20,14,1,1.004
2005/11/25,945,6110,14,44,18,26,0.998,0.688
2005/11/25,1045,6117,6,17,3,14,0.997,1.897
2005/11/25,1145,6115,-2,18,5,13,0.998,1.994
2005/11/25,1245,6116,3,11,4,7,0.998,2.978
2005/11/25,1345,6110,-7,14,14,0,1,1.058
2005/11/28,945,6167,48,53,2,51,0.99,0.516
2005/11/28,1045,6178,12,21,5,16,0.99,0.808
2005/11/28,1145,6198,20,25,2,23,0.988,1.041
2005/11/28,1245,6204,5,22,10,12,0.988,1.056
2005/11/28,1345,6213,8,11,2,9,0.988,1.019
2005/11/29,945,6190,-5,24,15,9,0.993,0.77
2005/11/29,1045,6182,-8,11,11,0,0.996,1.427
2005/11/29,1145,6181,0,14,11,3,0.997,2.007
2005/11/29,1245,6190,9,10,0,10,0.997,2.399
2005/11/29,1345,6145,-45,49,46,3,1.005,0.581
2005/11/30,945,6167,7,29,7,22,1.002,0.701
2005/11/30,1045,6163,-4,11,6,5,1.003,1.569
2005/11/30,1145,6174,9,23,5,18,1.001,1.41
2005/11/30,1245,6196,21,27,-2,29,0.997,1.121
2005/11/30,1345,6187,-9,34,18,16,0.998,0.649
2005/12/1,945,6162,-13,24,15,9,1.002,1.052
2005/12/1,1045,6166,4,11,3,8,1.001,1.798
2005/12/1,1145,6162,-4,15,13,2,1.001,2.234
2005/12/1,1245,6159,-2,18,14,4,1.002,1.895
2005/12/1,1345,6174,15,25,-4,29,0.999,0.839
2005/12/2,945,6236,-12,27,18,9,0.99,0.516
2005/12/2,1045,6230,-6,20,9,11,0.992,1.056
2005/12/2,1145,6225,-4,13,9,4,0.994,1.443
2005/12/2,1245,6217,-9,19,18,1,0.996,1.813
2005/12/2,1345,6223,5,20,3,17,0.995,0.629
2005/12/5,945,6265,15,60,27,33,0.99,0.429
2005/12/5,1045,6242,-23,37,26,11,0.995,0.876
2005/12/5,1145,6258,16,25,6,19,0.994,1.653
2005/12/5,1245,6299,41,54,4,50,0.989,0.645
2005/12/5,1345,6363,66,69,0,69,0.981,0.541
2005/12/6,945,6345,3,27,7,20,0.986,0.957
2005/12/6,1045,6362,17,24,3,21,0.985,1.155
2005/12/6,1145,6355,-7,18,9,9,0.988,1.645
2005/12/6,1245,6362,7,18,3,15,0.989,2.222
2005/12/6,1345,6369,7,21,-1,22,0.99,1.369
2005/12/7,945,6350,-29,29,29,0,0.995,0.961
2005/12/7,1045,6326,-24,31,21,10,1,0.709
2005/12/7,1145,6327,0,17,8,9,1.001,1.202
2005/12/7,1245,6332,6,14,7,7,1.001,1.732
2005/12/7,1345,6347,15,18,4,14,1,0.762
2005/12/8,945,6313,-12,33,22,11,1.005,0.695
2005/12/8,1045,6297,-15,22,21,1,1.007,0.997
2005/12/8,1145,6289,-8,27,21,6,1.007,1.036
2005/12/8,1245,6250,-38,51,40,11,1.012,0.589
2005/12/8,1345,6240,-11,40,14,26,1.012,0.717
2005/12/9,945,6250,-7,29,15,14,1.009,0.996
2005/12/9,1045,6251,1,17,1,16,1.007,1.905
2005/12/9,1145,6205,-46,41,50,-9,1.013,1.015
2005/12/9,1245,6224,19,24,3,21,1.008,1.299
2005/12/9,1345,6240,16,36,20,16,1.004,0.894
2005/12/12,945,6207,-58,103,78,25,1.008,0.587
2005/12/12,1045,6226,18,37,14,23,1.003,1.473
2005/12/12,1145,6230,4,25,12,13,1.002,2.254
2005/12/12,1245,6245,14,21,5,16,0.998,1.884
2005/12/12,1345,6273,28,33,3,30,0.994,0.892
2005/12/13,945,6240,-15,37,24,13,0.999,1.019
2005/12/13,1045,6247,7,22,13,9,0.998,1.627
2005/12/13,1145,6259,12,19,2,17,0.996,2.21
2005/12/13,1245,6266,7,29,19,10,0.995,1.021
2005/12/13,1345,6241,-25,40,29,11,1,0.816
2005/12/14,945,6253,-9,26,19,7,0.998,0.809
2005/12/14,1045,6223,-29,37,31,6,1.004,0.709
2005/12/14,1145,6227,5,22,13,9,1.003,1.591
2005/12/14,1245,6237,10,18,6,12,1.001,2.037
2005/12/14,1345,6215,-24,33,24,9,1.005,0.724
2005/12/15,945,6250,40,38,-3,41,0.998,0.703
2005/12/15,1045,6245,-5,20,13,7,0.999,1.807
2005/12/15,1145,6226,-20,37,21,16,1.002,1.129
2005/12/15,1245,6227,1,17,10,7,1.002,1.81
2005/12/15,1345,6270,44,45,-2,47,0.994,0.886
2005/12/16,945,6360,103,104,4,100,0.98,0.395
2005/12/16,1045,6376,18,38,9,29,0.979,0.885
2005/12/16,1145,6370,-6,23,13,10,0.982,1.594
2005/12/16,1245,6364,-7,15,16,-1,0.986,1.692
2005/12/16,1345,6356,-9,22,9,13,0.989,0.76
2005/12/19,945,6367,7,25,18,7,0.99,0.955
2005/12/19,1045,6385,18,25,5,20,0.989,1.905
2005/12/19,1145,6431,45,47,-1,48,0.984,0.917
2005/12/19,1245,6436,6,51,16,35,0.986,0.984
2005/12/19,1345,6450,15,33,2,31,0.987,1.256
2005/12/20,945,6429,-6,32,16,16,0.993,1.101
2005/12/20,1045,6430,1,17,9,8,0.994,1.466
2005/12/20,1145,6432,3,10,0,10,0.995,2.169
2005/12/20,1245,6425,-7,19,15,4,0.997,2.018
2005/12/20,1345,6433,8,16,0,16,0.996,0.785
2005/12/21,945,6440,2,37,23,14,0.996,1.349
2005/12/21,1045,6460,20,30,9,21,0.995,2.296
2005/12/21,1145,6465,4,12,3,9,0.995,2.571
2005/12/21,1245,6467,3,11,2,9,0.995,2.296
2005/12/21,1345,6469,2,18,11,7,0.995,0.779
2005/12/22,945,6458,-24,38,31,7,0.998,0.384
2005/12/22,1045,6447,-11,28,27,1,1,0.872
2005/12/22,1145,6457,11,19,8,11,0.999,1.341
2005/12/22,1245,6451,-6,16,12,4,1,1.876
2005/12/22,1345,6430,-21,28,23,5,1.004,0.505
2005/12/23,945,6434,-11,19,18,1,1.003,0.774
2005/12/23,1045,6460,25,24,-1,25,0.999,1.004
2005/12/23,1145,6505,45,69,18,51,0.992,0.501
2005/12/23,1245,6518,13,32,24,8,0.991,0.573
2005/12/23,1345,6544,27,34,5,29,0.988,0.896
2005/12/26,945,6553,-6,56,41,15,0.987,0.78
2005/12/26,1045,6575,21,42,17,25,0.985,1.446
2005/12/26,1145,6566,-9,24,22,2,0.989,2.873
2005/12/26,1245,6568,1,20,14,6,0.99,4.244
2005/12/26,1345,6578,9,17,7,10,0.99,1.975
2005/12/27,945,6576,18,33,4,29,0.992,1.103
2005/12/27,1045,6541,-34,44,33,11,1,0.904
2005/12/27,1145,6572,29,37,5,32,0.996,1.026
2005/12/27,1245,6598,27,34,5,29,0.994,0.826
2005/12/27,1345,6567,-31,40,29,11,0.999,0.784
2005/12/28,945,6508,-11,29,29,0,1.008,0.595
2005/12/28,1045,6519,11,22,10,12,1.006,1.115
2005/12/28,1145,6536,16,25,9,16,1.002,1.428
2005/12/28,1245,6535,-1,11,6,5,1.002,3.193
2005/12/28,1345,6550,15,32,13,19,0.999,0.987
2005/12/29,945,6624,69,59,-5,64,0.988,0.56
2005/12/29,1045,6637,14,33,8,25,0.987,0.67
2005/12/29,1145,6626,-11,25,11,14,0.99,1.245
2005/12/29,1245,6607,-19,19,27,-8,0.993,1.671
2005/12/29,1345,6605,-2,21,11,10,0.994,0.78
2005/12/30,945,6597,-3,32,18,14,0.996,0.879
2005/12/30,1045,6578,-19,48,36,12,1,0.817
2005/12/30,1145,6588,11,15,5,10,1,1.973
2005/12/30,1245,6581,-7,26,14,12,1.002,2.037
2005/12/30,1345,6595,14,21,-1,22,1,1.357
2006/1/2,945,6490,39,55,17,38,1.015,0.402
2006/1/2,1045,6482,-6,33,19,14,1.014,0.944
2006/1/2,1145,6484,1,27,3,24,1.011,1.256
2006/1/2,1245,6475,-9,16,9,7,1.01,3.325
2006/1/2,1345,6478,3,19,11,8,1.008,1.561
2006/1/3,945,6497,9,37,0,37,1.003,0.747
2006/1/3,1045,6516,18,37,9,28,0.999,0.735
2006/1/3,1145,6570,54,79,16,63,0.99,0.656
2006/1/3,1245,6591,21,60,34,26,0.986,0.519
2006/1/3,1345,6641,50,52,-3,55,0.979,0.86
2006/1/4,945,6664,-11,33,19,14,0.979,0.66
2006/1/4,1045,6657,-7,33,12,21,0.983,1.103
2006/1/4,1145,6661,4,20,12,8,0.985,1.772
2006/1/4,1245,6631,-30,43,37,6,0.992,1.13
2006/1/4,1345,6655,23,52,0,52,0.991,0.94
2006/1/5,945,6702,37,82,36,46,0.986,0.615
2006/1/5,1045,6702,-3,23,17,6,0.989,1.401
2006/1/5,1145,6707,5,32,27,5,0.991,1.37
2006/1/5,1245,6700,-7,28,24,4,0.994,1.683
2006/1/5,1345,6723,23,57,17,40,0.993,0.802
2006/1/6,945,6719,-24,33,24,9,0.994,0.817
2006/1/6,1045,6709,-11,40,23,17,0.997,1.117
2006/1/6,1145,6726,17,21,1,20,0.995,1.87
2006/1/6,1245,6714,-11,26,20,6,0.998,1.757
2006/1/6,1345,6717,5,22,9,13,0.998,1.462
2006/1/9,945,6753,6,40,36,4,0.994,0.637
2006/1/9,1045,6770,18,36,10,26,0.992,1.029
2006/1/9,1145,6770,0,20,10,10,0.993,1.901
2006/1/9,1245,6763,-7,28,21,7,0.995,1.279
2006/1/9,1345,6760,-3,19,13,6,0.997,1.439
2006/1/10,945,6736,-45,48,39,9,1.001,0.592
2006/1/10,1045,6714,-21,32,23,9,1.004,0.751
2006/1/10,1145,6727,13,13,0,13,1.002,1.389
2006/1/10,1245,6717,-9,21,13,8,1.004,1.647
2006/1/10,1345,6739,23,26,-2,28,1.001,0.95
2006/1/11,945,6697,-26,41,30,11,1.007,0.564
2006/1/11,1045,6708,10,29,7,22,1.004,0.986
2006/1/11,1145,6714,5,24,2,22,1.002,1.199
2006/1/11,1245,6737,23,35,4,31,0.998,1.098
2006/1/11,1345,6760,23,43,14,29,0.994,0.541
2006/1/12,945,6779,7,30,21,9,0.991,0.782
2006/1/12,1045,6764,-16,35,31,4,0.994,1.346
2006/1/12,1145,6780,17,22,2,20,0.993,1.624
2006/1/12,1245,6765,-15,20,17,3,0.996,1.917
2006/1/12,1345,6705,-59,72,68,4,1.005,0.602
2006/1/13,945,6720,19,46,18,28,1.003,0.834
2006/1/13,1045,6735,17,26,2,24,1.001,1.596
2006/1/13,1145,6730,-5,23,17,6,1.002,1.529
2006/1/13,1245,6696,-34,43,37,6,1.007,0.981
2006/1/13,1345,6712,17,46,11,35,1.004,0.936
2006/1/16,945,6730,48,78,8,70,1,0.817
2006/1/16,1045,6712,-16,33,27,6,1.002,0.972
2006/1/16,1145,6719,7,27,5,22,1,1.546
2006/1/16,1245,6722,3,25,18,7,0.999,0.975
2006/1/16,1345,6729,8,25,15,10,0.997,0.764
2006/1/17,945,6751,21,43,16,27,0.994,0.771
2006/1/17,1045,6742,-9,22,20,2,0.996,1.556
2006/1/17,1145,6741,-2,16,9,7,0.997,1.518
2006/1/17,1245,6741,-1,20,18,2,0.997,2.446
2006/1/17,1345,6689,-52,57,56,1,1.005,0.755
2006/1/18,945,6591,-21,30,33,-3,1.019,0.655
2006/1/18,1045,6541,-50,67,46,21,1.025,1.024
2006/1/18,1145,6540,-1,27,16,11,1.022,2.859
2006/1/18,1245,6468,-72,98,91,7,1.031,1.423
2006/1/18,1345,6490,20,42,15,27,1.024,1.143
2006/1/19,945,6509,-18,46,30,16,1.017,0.407
2006/1/19,1045,6483,-27,39,32,7,1.018,1.003
2006/1/19,1145,6486,3,32,6,26,1.013,0.978
2006/1/19,1245,6517,31,45,16,29,1.005,0.91
2006/1/19,1345,6513,-2,25,22,3,1.002,1.165
2006/1/20,945,6514,-13,43,35,8,1,0.653
2006/1/20,1045,6497,-16,43,28,15,1.002,1.103
2006/1/20,1145,6507,11,33,11,22,0.999,1.352
2006/1/20,1245,6468,-39,63,46,17,1.005,1.004
2006/1/20,1345,6472,2,25,23,2,1.004,1.236
2006/1/23,945,6385,-15,34,30,4,1.016,0.7
2006/1/23,1045,6402,17,20,5,15,1.011,1.93
2006/1/23,1145,6395,-7,26,13,13,1.011,1.723
2006/1/23,1245,6405,10,18,10,8,1.008,2.038
2006/1/23,1345,6380,-25,28,26,2,1.01,1.091
2006/1/24,945,6446,29,40,-1,41,0.998,0.733
2006/1/24,1045,6436,-10,25,19,6,0.999,1.224
2006/1/24,1145,6430,-6,16,7,9,0.999,1.96
2006/1/24,1245,6429,-1,16,13,3,0.998,1.999
2006/1/24,1345,6450,21,30,10,20,0.994,0.917
2006/1/25,945,6466,-5,37,24,13,0.993,0.605
2006/1/25,1045,6477,12,16,7,9,0.992,1.054
2006/1/25,1145,6484,7,14,3,11,0.992,1.355
2006/1/25,1245,6507,23,32,11,21,0.99,0.77
2006/1/25,1345,6532,24,34,-3,37,0.988,0.873
2006/2/3,945,6562,-6,63,52,11,0.986,0.444
2006/2/3,1045,6557,-5,31,19,12,0.988,1.087
2006/2/3,1145,6568,10,19,5,14,0.988,2.336
2006/2/3,1245,6565,-4,11,9,2,0.991,2.049
2006/2/3,1345,6585,20,34,3,31,0.99,0.943
2006/2/6,945,6524,-31,60,36,24,1.001,0.684
2006/2/6,1045,6534,11,24,5,19,1,1.329
2006/2/6,1145,6550,17,26,2,24,0.998,1.375
2006/2/6,1245,6583,35,37,0,37,0.994,0.814
2006/2/6,1345,6700,118,141,22,119,0.978,0.501
2006/2/7,945,6724,24,57,11,46,0.977,0.604
2006/2/7,1045,6706,-16,42,32,10,0.982,1.152
2006/2/7,1145,6720,14,23,-1,24,0.982,1.425
2006/2/7,1245,6729,9,26,13,13,0.983,1.178
2006/2/7,1345,6705,-24,45,21,24,0.989,1.059
2006/2/8,945,6670,-32,39,32,7,0.996,1.114
2006/2/8,1045,6660,-12,28,23,5,1,1.369
2006/2/8,1145,6670,10,19,10,9,1,2.353
2006/2/8,1245,6625,-45,56,47,9,1.009,0.724
2006/2/8,1345,6619,-7,26,14,12,1.01,0.957
2006/2/9,945,6649,-30,51,44,7,1.005,0.645
2006/2/9,1045,6665,16,24,6,18,1.002,1.426
2006/2/9,1145,6665,0,13,4,9,1.001,3.022
2006/2/9,1245,6669,5,34,30,4,1,1.014
2006/2/9,1345,6593,-76,95,74,21,1.011,0.465
2006/2/10,945,6547,-49,66,73,-7,1.016,0.617
2006/2/10,1045,6556,9,28,16,12,1.013,1.54
2006/2/10,1145,6577,21,32,5,27,1.008,2.155
2006/2/10,1245,6573,-4,40,25,15,1.007,1.039
2006/2/10,1345,6563,-12,45,42,3,1.008,1.071
2006/2/13,945,6585,34,72,22,50,1.003,0.879
2006/2/13,1045,6566,-20,39,23,16,1.004,1.487
2006/2/13,1145,6546,-19,39,33,6,1.006,1.633
2006/2/13,1245,6534,-12,32,20,12,1.006,1.159
2006/2/13,1345,6541,6,22,14,8,1.003,1.225
2006/2/14,945,6558,30,37,-9,46,0.999,0.842
2006/2/14,1045,6548,-8,25,6,19,1.001,0.983
2006/2/14,1145,6564,17,31,4,27,0.998,1.452
2006/2/14,1245,6583,19,41,18,23,0.995,0.776
2006/2/14,1345,6610,27,35,10,25,0.991,0.976
2006/2/15,945,6622,22,37,16,21,0.99,1.536
2006/2/15,1045,6639,17,22,4,18,0.988,2.58
2006/2/15,1145,6618,-22,25,22,3,0.993,1.861
2006/2/15,1245,6596,-22,31,30,1,0.997,2.06
2006/2/15,1345,6590,-5,24,8,16,0.999,1.1
2006/2/16,945,6655,65,91,20,71,0.99,0.292
2006/2/16,1045,6670,16,21,-2,23,0.989,0.807
2006/2/16,1145,6677,7,32,8,24,0.99,0.828
2006/2/16,1245,6670,-7,26,12,14,0.993,0.969
2006/2/16,1345,6669,-1,20,16,4,0.994,0.997
2006/2/17,945,6660,-41,74,59,15,0.997,0.517
2006/2/17,1045,6669,9,24,2,22,0.996,1.323
2006/2/17,1145,6657,-12,27,25,2,0.999,1.279
2006/2/17,1245,6649,-8,25,16,9,1,1.417
2006/2/17,1345,6682,34,34,0,34,0.996,1.399
2006/2/20,945,6640,-20,47,27,20,1.004,0.739
2006/2/20,1045,6689,49,64,11,53,0.996,0.781
2006/2/20,1145,6684,-6,22,9,13,0.997,1.549
2006/2/20,1245,6660,-24,27,23,4,1.001,1.711
2006/2/20,1345,6677,16,32,13,19,0.998,1.275
2006/2/21,945,6661,-38,64,49,15,1,0.596
2006/2/21,1045,6651,-10,26,13,13,1.002,1.026
2006/2/21,1145,6658,7,18,5,13,1.001,1.761
2006/2/21,1245,6642,-16,25,18,7,1.003,1.362
2006/2/21,1345,6628,-14,33,31,2,1.005,1.052
2006/2/22,945,6595,-36,65,55,10,1.01,0.533
2006/2/22,1045,6566,-29,40,45,-5,1.013,0.7
2006/2/22,1145,6510,-57,64,54,10,1.02,0.547
2006/2/22,1245,6515,5,33,13,20,1.017,1.172
2006/2/22,1345,6528,13,27,4,23,1.013,1.369
2006/2/23,945,6503,-42,52,45,7,1.014,0.712
2006/2/23,1045,6533,28,40,11,29,1.007,1.241
2006/2/23,1145,6512,-21,20,23,-3,1.008,2.253
2006/2/23,1245,6494,-19,38,30,8,1.009,1.304
2006/2/23,1345,6493,-2,34,5,29,1.007,1.032
2006/2/24,945,6504,9,45,18,27,1.003,0.87
2006/2/24,1045,6506,2,23,17,6,1.001,1.478
2006/2/24,1145,6496,-10,28,18,10,1.002,1.502
2006/2/24,1245,6506,10,18,1,17,1,2.717
2006/2/24,1345,6527,21,23,6,17,0.997,0.856
2006/2/27,945,6503,-11,42,12,30,1,0.775
2006/2/27,1045,6519,16,37,16,21,0.998,0.994
2006/2/27,1145,6532,13,25,11,14,0.995,1.202
2006/2/27,1245,6522,-9,25,16,9,0.997,1.781
2006/2/27,1345,6530,8,30,18,12,0.996,1.044
2006/3/1,945,6540,28,62,5,57,0.995,0.541
2006/3/1,1045,6579,39,58,1,57,0.99,0.822
2006/3/1,1145,6583,5,27,15,12,0.99,0.803
2006/3/1,1245,6605,22,33,3,30,0.988,1.223
2006/3/1,1345,6582,-23,37,36,1,0.993,0.994
2006/3/2,945,6623,9,23,12,11,0.989,0.661
2006/3/2,1045,6611,-12,43,36,7,0.992,0.903
2006/3/2,1145,6608,-3,21,11,10,0.994,1.385
2006/3/2,1245,6607,-1,18,16,2,0.995,2.196
2006/3/2,1345,6617,11,19,8,11,0.995,1.487
2006/3/3,945,6593,-17,40,29,11,1,0.857
2006/3/3,1045,6590,-2,21,7,14,1.001,0.934
2006/3/3,1145,6565,-23,29,27,2,1.005,1.068
2006/3/3,1245,6545,-19,44,34,10,1.008,0.835
2006/3/3,1345,6503,-42,48,40,8,1.014,0.687
2006/3/6,945,6524,24,35,8,27,1.009,0.88
2006/3/6,1045,6522,-2,16,12,4,1.008,1.673
2006/3/6,1145,6507,-15,40,18,22,1.009,1.057
2006/3/6,1245,6538,31,34,6,28,1.002,1.392
2006/3/6,1345,6548,8,29,2,27,1,1.373
2006/3/7,945,6490,-20,37,23,14,1.007,0.697
2006/3/7,1045,6490,0,28,12,16,1.006,1.157
2006/3/7,1145,6495,6,24,9,15,1.003,1.27
2006/3/7,1245,6466,-30,44,33,11,1.007,0.932
2006/3/7,1345,6475,9,21,2,19,1.004,1.067
2006/3/8,945,6483,23,42,22,20,1.002,0.711
2006/3/8,1045,6444,-39,46,36,10,1.008,0.801
2006/3/8,1145,6425,-20,27,19,8,1.009,0.951
2006/3/8,1245,6444,21,48,9,39,1.005,0.741
2006/3/8,1345,6455,11,37,22,15,1.002,0.774
2006/3/9,945,6485,25,43,9,34,0.997,0.936
2006/3/9,1045,6467,-19,36,33,3,0.999,1.194
2006/3/9,1145,6461,-6,23,17,6,1,2.022
2006/3/9,1245,6481,19,25,1,24,0.996,1.927
2006/3/9,1345,6477,-3,23,13,10,0.997,1.287
2006/3/10,945,6455,-22,56,43,13,1.001,0.803
2006/3/10,1045,6498,42,57,5,52,0.994,0.817
2006/3/10,1145,6477,-22,34,36,-2,0.998,0.918
2006/3/10,1245,6479,2,28,7,21,0.998,1.231
2006/3/10,1345,6467,-11,25,14,11,1.001,1.264
2006/3/13,945,6491,-19,31,26,5,0.998,0.788
2006/3/13,1045,6498,7,20,7,13,0.997,1.837
2006/3/13,1145,6496,-1,13,12,1,0.997,2.517
2006/3/13,1245,6516,21,28,7,21,0.995,1.69
2006/3/13,1345,6535,18,24,-2,26,0.993,0.91
2006/3/14,945,6507,-15,21,16,5,0.998,1.025
2006/3/14,1045,6487,-19,30,28,2,1.001,0.948
2006/3/14,1145,6440,-47,67,43,24,1.009,0.513
2006/3/14,1245,6432,-7,28,23,5,1.009,1.007
2006/3/14,1345,6454,23,23,-1,24,1.005,1.164
2006/3/15,945,6480,1,28,20,8,1,1.026
2006/3/15,1045,6478,-3,22,8,14,1.001,1.736
2006/3/15,1145,6490,12,26,6,20,0.998,2.443
2006/3/15,1245,6507,16,28,2,26,0.996,1.973
2006/3/15,1345,6510,2,30,25,5,0.995,1.075
2006/3/16,945,6534,42,79,15,64,0.991,0.46
2006/3/16,1045,6543,9,30,11,19,0.99,0.639
2006/3/16,1145,6523,-19,33,26,7,0.994,0.978
2006/3/16,1245,6489,-34,42,36,6,1.001,0.568
2006/3/16,1345,6448,-41,55,55,0,1.008,0.602
2006/3/17,945,6445,-5,50,27,23,1.008,0.684
2006/3/17,1045,6442,-5,23,13,10,1.008,1.663
2006/3/17,1145,6469,27,38,5,33,1.003,1.681
2006/3/17,1245,6469,1,23,6,17,1.003,2.015
2006/3/17,1345,6478,9,18,5,13,1.001,1.414
2006/3/20,945,6509,11,23,16,7,0.996,1.017
2006/3/20,1045,6465,-46,57,49,8,1.002,0.792
2006/3/20,1145,6493,26,28,0,28,0.997,1.655
2006/3/20,1245,6488,-5,26,25,1,0.997,1.186
2006/3/20,1345,6496,8,29,-1,30,0.996,0.912
2006/3/21,945,6504,16,47,9,38,0.995,0.609
2006/3/21,1045,6462,-42,44,40,4,1.003,0.728
2006/3/21,1145,6461,-1,27,9,18,1.003,0.883
2006/3/21,1245,6460,-1,24,14,10,1.003,1.934
2006/3/21,1345,6450,-10,20,16,4,1.005,1.391
2006/3/22,945,6393,-22,40,19,21,1.012,0.483
2006/3/22,1045,6376,-18,30,18,12,1.013,0.804
2006/3/22,1145,6370,-6,13,11,2,1.013,2.503
2006/3/22,1245,6370,0,21,15,6,1.011,1.92
2006/3/22,1345,6361,-9,19,15,4,1.01,1.043
2006/3/23,945,6358,-15,30,29,1,1.009,0.962
2006/3/23,1045,6368,9,27,10,17,1.005,1.274
2006/3/23,1145,6345,-24,19,28,-9,1.007,2.097
2006/3/23,1245,6335,-10,24,15,9,1.007,0.809
2006/3/23,1345,6358,23,34,-1,35,1.001,1.066
2006/3/24,945,6356,12,28,10,18,1.001,1.108
2006/3/24,1045,6359,4,29,16,13,1,0.957
2006/3/24,1145,6356,-4,15,3,12,1,2.154
2006/3/24,1245,6358,2,20,5,15,0.999,1.841
2006/3/24,1345,6366,7,15,3,12,0.998,1.255
2006/3/27,945,6381,-5,26,13,13,0.996,0.909
2006/3/27,1045,6373,-7,23,14,9,0.997,1.51
2006/3/27,1145,6377,4,15,4,11,0.997,2.551
2006/3/27,1245,6386,9,12,-1,13,0.996,2.369
2006/3/27,1345,6390,4,13,0,13,0.996,1.088
2006/3/28,945,6394,15,26,8,18,0.996,0.538
2006/3/28,1045,6386,-5,16,11,5,0.998,1.099
2006/3/28,1145,6394,9,12,2,10,0.997,2.011
2006/3/28,1245,6411,17,20,1,19,0.995,0.636
2006/3/28,1345,6405,-7,20,20,0,0.997,0.632
2006/3/29,945,6407,22,33,1,32,0.996,0.597
2006/3/29,1045,6440,34,38,0,38,0.992,0.531
2006/3/29,1145,6422,-19,26,16,10,0.995,0.965
2006/3/29,1245,6424,1,16,10,6,0.996,1.811
2006/3/29,1345,6440,16,26,11,15,0.994,0.886
2006/3/30,945,6469,6,21,12,9,0.991,0.652
2006/3/30,1045,6482,14,20,3,17,0.99,1.206
2006/3/30,1145,6504,22,21,1,20,0.988,0.847
2006/3/30,1245,6488,-15,41,30,11,0.992,0.819
2006/3/30,1345,6487,0,39,6,33,0.994,0.728
2006/3/31,945,6528,27,53,17,36,0.989,0.674
2006/3/31,1045,6543,15,25,4,21,0.989,1.355
2006/3/31,1145,6547,4,18,3,15,0.99,1.491
2006/3/31,1245,6570,24,34,2,32,0.988,1.033
2006/3/31,1345,6561,-9,35,29,6,0.992,0.826
2006/4/3,945,6577,-6,24,11,13,0.991,1.406
2006/4/3,1045,6601,24,33,8,25,0.989,1.159
2006/4/3,1145,6609,8,29,16,13,0.99,1.247
2006/4/3,1245,6628,18,29,4,25,0.988,1.745
2006/4/3,1345,6638,11,26,0,26,0.989,1.139
2006/4/4,945,6632,3,26,11,15,0.992,1.114
2006/4/4,1045,6622,-11,29,20,9,0.995,1.306
2006/4/4,1145,6629,6,21,10,11,0.995,2.152
2006/4/4,1245,6630,1,11,3,8,0.996,2.164
2006/4/4,1345,6630,2,23,13,10,0.997,0.884
2006/4/6,945,6674,-3,35,29,6,0.992,0.596
2006/4/6,1045,6683,9,12,5,7,0.992,1.749
2006/4/6,1145,6691,8,13,4,9,0.992,1.725
2006/4/6,1245,6694,2,18,8,10,0.993,1.077
2006/4/6,1345,6727,32,39,6,33,0.989,0.496
2006/4/7,945,6712,-16,22,18,4,0.993,1.045
2006/4/7,1045,6712,0,15,4,11,0.994,1.325
2006/4/7,1145,6734,23,27,3,24,0.992,0.924
2006/4/7,1245,6767,32,50,15,35,0.989,0.588
2006/4/7,1345,6751,-16,51,40,11,0.993,0.611
2006/4/10,945,6757,35,45,1,44,0.993,0.772
2006/4/10,1045,6786,30,30,2,28,0.99,0.777
2006/4/10,1145,6797,10,46,31,15,0.99,0.614
2006/4/10,1245,6767,-30,35,31,4,0.996,0.984
2006/4/10,1345,6779,12,34,-2,36,0.995,0.934
2006/4/11,945,6721,-31,46,43,3,1.004,0.903
2006/4/11,1045,6724,1,19,9,10,1.004,1.29
2006/4/11,1145,6716,-9,22,15,7,1.005,1.787
2006/4/11,1245,6745,28,26,-2,28,1,1.858
2006/4/11,1345,6755,8,19,1,18,0.999,1.285
2006/4/12,945,6734,23,39,0,39,1.002,0.682
2006/4/12,1045,6793,59,69,16,53,0.993,0.653
2006/4/12,1145,6758,-36,55,48,7,0.998,0.864
2006/4/12,1245,6756,-4,35,17,18,0.998,1.177
2006/4/12,1345,6808,53,52,-2,54,0.99,0.836
2006/4/13,945,6830,11,43,25,18,0.988,0.742
2006/4/13,1045,6836,6,26,14,12,0.988,1.43
2006/4/13,1145,6836,-1,34,27,7,0.99,1.247
2006/4/13,1245,6850,15,29,12,17,0.99,1.818
2006/4/13,1345,6866,16,30,1,29,0.989,1.222
2006/4/14,945,6884,4,33,9,24,0.989,1.052
2006/4/14,1045,6883,-2,17,11,6,0.991,1.811
2006/4/14,1145,6886,3,16,5,11,0.992,1.823
2006/4/14,1245,6926,40,40,-1,41,0.988,0.829
2006/4/14,1345,6984,58,58,2,56,0.982,0.471
2006/4/17,945,6981,10,54,47,7,0.985,0.697
2006/4/17,1045,6981,-1,33,15,18,0.987,0.992
2006/4/17,1145,7010,30,55,25,30,0.985,0.96
2006/4/17,1245,7018,9,44,17,27,0.986,1.246
2006/4/17,1345,6986,-27,33,33,0,0.993,1.422
2006/4/18,945,6973,-35,35,22,13,0.997,1.081
2006/4/18,1045,6919,-54,52,49,3,1.006,0.842
2006/4/18,1145,6982,62,59,-7,66,0.997,1.273
2006/4/18,1245,6991,9,37,13,24,0.997,1.267
2006/4/18,1345,6983,-9,24,19,5,1,1.445
2006/4/19,945,7077,-37,32,11,21,0.988,1.384
2006/4/19,1045,7090,13,33,11,22,0.988,1.736
2006/4/19,1145,7077,-12,28,13,15,0.991,1.544
2006/4/19,1245,7058,-20,28,27,1,0.995,1.442
2006/4/19,1345,7042,-17,31,19,12,0.998,1.386
2006/4/20,945,7044,-3,37,24,13,0.998,0.566
2006/4/20,1045,7088,44,56,8,48,0.993,0.57
2006/4/20,1145,7100,13,32,15,17,0.993,0.692
2006/4/20,1245,7087,-12,57,38,19,0.997,0.547
2006/4/20,1345,7121,36,44,3,41,0.993,0.878
2006/4/21,945,7155,24,41,-3,44,0.989,0.792
2006/4/21,1045,7128,-28,35,21,14,0.994,1.155
2006/4/21,1145,7147,19,22,0,22,0.992,2.065
2006/4/21,1245,7139,-8,27,20,7,0.994,1.513
2006/4/21,1345,7105,-33,58,35,23,1,0.855
2006/4/24,945,7098,45,68,3,65,1.001,0.776
2006/4/24,1045,7116,19,41,9,32,0.999,1.011
2006/4/24,1145,7098,-18,40,35,5,1.002,1.159
2006/4/24,1245,7125,28,34,5,29,0.998,1.598
2006/4/24,1345,7081,-44,50,45,5,1.005,0.986
2006/4/25,945,7139,54,60,14,46,0.996,0.753
2006/4/25,1045,7052,-88,91,92,-1,1.008,0.646
2006/4/25,1145,7060,8,40,16,24,1.006,0.81
2006/4/25,1245,7060,-1,33,25,8,1.005,1.454
2006/4/25,1345,7053,-6,38,13,25,1.005,1.084
2006/4/26,945,7078,7,40,7,33,1.001,1.047
2006/4/26,1045,7076,-1,27,14,13,1.001,1.661
2006/4/26,1145,7071,-5,21,15,6,1.001,1.945
2006/4/26,1245,7126,55,52,-4,56,0.993,0.997
2006/4/26,1345,7208,83,84,-1,85,0.982,0.552
2006/4/27,945,7200,-33,33,27,6,0.985,0.831
2006/4/27,1045,7204,8,42,13,29,0.985,1.052
2006/4/27,1145,7209,6,42,16,26,0.987,0.956
2006/4/27,1245,7215,5,42,5,37,0.988,1.272
2006/4/27,1345,7176,-38,62,43,19,0.996,0.855
2006/4/28,945,7143,-10,67,40,27,1.001,0.736
2006/4/28,1045,7124,-19,63,32,31,1.005,0.873
2006/4/28,1145,7138,13,23,7,16,1.004,1.978
2006/4/28,1245,7161,23,24,-2,26,1.001,1.661
2006/4/28,1345,7180,20,59,35,24,0.999,0.828
2006/5/2,945,7184,12,64,15,49,0.998,0.981
2006/5/2,1045,7209,26,38,9,29,0.994,1.132
2006/5/2,1145,7185,-24,44,37,7,0.998,1.312
2006/5/2,1245,7196,11,35,10,25,0.996,1.415
2006/5/2,1345,7219,23,61,-1,62,0.992,0.82
2006/5/3,945,7255,5,31,23,8,0.989,0.799
2006/5/3,1045,7263,9,32,17,15,0.989,1.096
2006/5/3,1145,7262,-2,28,13,15,0.991,1.388
2006/5/3,1245,7270,6,31,19,12,0.992,1.292
2006/5/3,1345,7267,1,23,11,12,0.994,1.384
2006/5/4,945,7292,25,53,13,40,0.992,0.799
2006/5/4,1045,7330,39,43,5,38,0.988,0.869
2006/5/4,1145,7343,11,32,14,18,0.988,0.811
2006/5/4,1245,7350,9,35,0,35,0.989,1.343
2006/5/4,1345,7375,25,24,0,24,0.988,0.964
2006/5/5,945,7404,26,40,11,29,0.986,0.846
2006/5/5,1045,7450,46,72,17,55,0.981,0.839
2006/5/5,1145,7465,18,39,1,38,0.982,1.145
2006/5/5,1245,7460,-7,40,38,2,0.985,0.935
2006/5/5,1345,7421,-39,96,37,59,0.993,0.523
2006/5/8,945,7453,-17,44,27,17,0.992,1.081
2006/5/8,1045,7470,16,27,-1,28,0.992,2.21
2006/5/8,1145,7458,-12,26,27,-1,0.995,1.519
2006/5/8,1245,7473,16,31,10,21,0.995,2.074
2006/5/8,1345,7518,44,53,-3,56,0.99,1.071
2006/5/9,945,7470,-23,65,31,34,0.998,0.625
2006/5/9,1045,7483,12,34,7,27,0.997,1.174
2006/5/9,1145,7470,-14,39,44,-5,1,0.967
2006/5/9,1245,7432,-41,80,66,14,1.005,0.672
2006/5/9,1345,7392,-39,50,51,-1,1.01,0.676
2006/5/10,945,7435,34,35,10,25,1.003,0.864
2006/5/10,1045,7356,-79,93,90,3,1.013,0.727
2006/5/10,1145,7352,-4,62,22,40,1.012,0.745
2006/5/10,1245,7330,-22,82,48,34,1.014,0.709
2006/5/10,1345,7318,-12,58,20,38,1.014,1.054
2006/5/11,945,7306,6,41,8,33,1.013,1.141
2006/5/11,1045,7335,28,53,13,40,1.007,1.254
2006/5/11,1145,7345,8,29,10,19,1.003,1.631
2006/5/11,1245,7339,-5,37,34,3,1.002,1.29
2006/5/11,1345,7369,31,50,8,42,0.997,1.46
2006/5/12,945,7296,23,44,16,28,1.005,0.963
2006/5/12,1045,7281,-14,46,22,24,1.005,1.056
2006/5/12,1145,7296,14,30,7,23,1.002,1.856
2006/5/12,1245,7294,-2,30,18,12,1.002,1.521
2006/5/12,1345,7257,-37,52,47,5,1.006,1.011
2006/5/15,945,7199,10,34,15,19,1.013,0.891
2006/5/15,1045,7201,2,21,8,13,1.011,1.477
2006/5/15,1145,7205,4,17,8,9,1.009,1.972
2006/5/15,1245,7186,-19,19,20,-1,1.009,2.021
2006/5/15,1345,7153,-33,38,35,3,1.012,0.719
2006/5/16,945,7161,5,37,15,22,1.009,1.008
2006/5/16,1045,7153,-8,29,25,4,1.008,1.127
2006/5/16,1145,7153,-2,22,15,7,1.007,1.293
2006/5/16,1245,7088,-60,71,62,9,1.014,0.614
2006/5/16,1345,7022,-67,66,66,0,1.02,0.633
2006/5/17,945,7100,64,63,-2,65,1.007,0.996
2006/5/17,1045,7057,-43,57,55,2,1.012,1.423
2006/5/17,1145,7090,32,56,11,45,1.005,1.814
2006/5/17,1245,7118,28,61,1,60,0.999,1.988
2006/5/17,1345,7111,-7,42,34,8,1,1.405
2006/5/18,945,6984,7,53,12,41,1.015,0.453
2006/5/18,1045,6982,-3,25,7,18,1.013,1.361
2006/5/18,1145,6983,2,26,5,21,1.01,1.476
2006/5/18,1245,6993,9,30,4,26,1.006,1.329
2006/5/18,1345,7000,8,25,5,20,1.004,0.731
2006/5/19,945,6985,5,37,23,14,1.005,0.802
2006/5/19,1045,7011,26,29,-2,31,1,1.413
2006/5/19,1145,7036,24,38,12,26,0.996,0.8
2006/5/19,1245,7045,8,30,21,9,0.994,1.023
2006/5/19,1345,7042,-2,18,18,0,0.993,1.265
2006/5/22,945,7060,6,22,21,1,0.992,0.886
2006/5/22,1045,7053,-9,19,13,6,0.994,1.388
2006/5/22,1145,6964,-89,97,85,12,1.008,0.643
2006/5/22,1245,6936,-28,64,39,25,1.011,0.646
2006/5/22,1345,6868,-68,71,68,3,1.021,0.809
2006/5/23,945,6831,2,54,37,17,1.024,0.697
2006/5/23,1045,6859,28,58,26,32,1.017,0.93
2006/5/23,1145,6889,30,34,1,33,1.011,1.528
2006/5/23,1245,6833,-54,76,68,8,1.017,0.85
2006/5/23,1345,6844,12,47,9,38,1.012,0.863
2006/5/24,945,6874,38,48,24,24,1.005,0.805
2006/5/24,1045,6865,-9,64,49,15,1.003,0.947
2006/5/24,1145,6812,-53,75,64,11,1.008,0.741
2006/5/24,1245,6803,-11,63,37,26,1.007,0.772
2006/5/24,1345,6890,87,152,29,123,0.993,0.645
2006/5/25,945,6845,-18,62,52,10,1,1.148
2006/5/25,1045,6857,12,41,31,10,0.998,1.833
2006/5/25,1145,6855,-1,41,31,10,0.998,1.93
2006/5/25,1245,6820,-36,47,52,-5,1.003,1.257
2006/5/25,1345,6855,36,50,12,38,0.998,1.466
2006/5/26,945,6933,6,32,27,5,0.988,0.98
2006/5/26,1045,6934,1,20,12,8,0.989,2.395
2006/5/26,1145,6912,-23,42,28,14,0.993,1.818
2006/5/26,1245,6880,-31,70,33,37,0.999,0.691
2006/5/26,1345,6872,-7,40,23,17,1.001,0.898
2006/5/29,945,6881,-24,59,35,24,1,1.178
2006/5/29,1045,6886,4,26,16,10,1,2.547
2006/5/29,1145,6871,-14,29,21,8,1.003,1.757
2006/5/29,1245,6885,13,29,19,10,1.001,1.484
2006/5/29,1345,6891,5,42,32,10,1.001,0.812
2006/5/30,945,6865,-39,56,48,8,1.004,0.824
2006/5/30,1045,6820,-46,69,54,15,1.01,0.621
2006/5/30,1145,6888,67,102,20,82,0.998,0.606
2006/5/30,1245,6871,-19,47,37,10,1.001,0.925
2006/5/30,1345,6844,-27,56,50,6,1.004,0.955
2006/6/1,945,6848,-16,38,20,18,1.003,1.09
2006/6/1,1045,6860,11,48,37,11,1.001,0.947
2006/6/1,1145,6865,5,29,17,12,1,1.896
2006/6/1,1245,6850,-14,23,27,-4,1.002,1.972
2006/6/1,1345,6854,4,19,5,14,1.001,1.605
2006/6/2,945,6870,-45,60,48,12,0.999,0.749
2006/6/2,1045,6857,-13,37,25,12,1.001,1.308
2006/6/2,1145,6891,34,36,3,33,0.996,1.31
2006/6/2,1245,6921,30,71,24,47,0.992,0.605
2006/6/2,1345,6967,47,53,1,52,0.986,0.725
2006/6/5,945,6921,-26,46,43,3,0.994,1.019
2006/6/5,1045,6898,-24,40,32,8,0.998,0.943
2006/6/5,1145,6902,4,19,12,7,0.998,1.772
2006/6/5,1245,6730,-172,205,192,13,1.024,0.45
2006/6/5,1345,6678,-54,110,77,33,1.031,0.566
2006/6/6,945,6680,58,75,13,62,1.026,0.801
2006/6/6,1045,6656,-24,57,26,31,1.027,1.247
2006/6/6,1145,6623,-32,67,36,31,1.029,0.895
2006/6/6,1245,6682,58,83,6,77,1.016,1.389
2006/6/6,1345,6689,8,41,23,18,1.011,0.985
2006/6/7,945,6645,-11,38,19,19,1.013,1.088
2006/6/7,1045,6623,-23,62,45,17,1.013,1.419
2006/6/7,1145,6626,3,33,9,24,1.008,1.73
2006/6/7,1245,6617,-8,71,49,22,1.005,1.05
2006/6/7,1345,6576,-41,59,60,-1,1.01,0.814
2006/6/8,945,6491,-34,77,56,21,1.021,0.81
2006/6/8,1045,6395,-96,153,110,43,1.034,0.717
2006/6/8,1145,6410,18,99,58,41,1.027,0.713
2006/6/8,1245,6397,-15,77,53,24,1.026,0.903
2006/6/8,1345,6216,-181,207,202,5,1.051,0.606
2006/6/9,945,6274,-20,73,47,26,1.036,0.774
2006/6/9,1045,6272,0,73,21,52,1.03,1.018
2006/6/9,1145,6271,0,55,49,6,1.025,1.105
2006/6/9,1245,6345,75,110,13,97,1.007,1.147
2006/6/9,1345,6375,31,80,40,40,0.998,0.879
2006/6/12,945,6345,13,61,24,37,1,1.322
2006/6/12,1045,6305,-40,63,50,13,1.004,1.685
2006/6/12,1145,6307,0,52,11,41,1.002,1.551
2006/6/12,1245,6333,26,49,12,37,0.996,1.485
2006/6/12,1345,6379,46,71,30,41,0.988,0.827
2006/6/13,945,6314,32,55,9,46,0.998,1.167
2006/6/13,1045,6328,14,60,16,44,0.997,1.16
2006/6/13,1145,6310,-19,37,22,15,1,1.433
2006/6/13,1245,6235,-75,85,98,-13,1.013,1.039
2006/6/13,1345,6270,33,67,42,25,1.006,0.712
2006/6/14,945,6367,114,110,8,102,0.989,0.744
2006/6/14,1045,6374,7,42,6,36,0.989,1.145
2006/6/14,1145,6403,28,70,35,35,0.985,0.777
2006/6/14,1245,6447,44,49,13,36,0.98,1.064
2006/6/14,1345,6465,19,43,5,38,0.979,1.195
2006/6/15,945,6432,-56,89,73,16,0.987,0.779
2006/6/15,1045,6441,9,45,22,23,0.988,1.483
2006/6/15,1145,6424,-18,54,13,41,0.992,1.104
2006/6/15,1245,6382,-42,66,40,26,1,1.318
2006/6/15,1345,6409,28,69,26,43,0.998,0.971
2006/6/16,945,6579,-71,69,51,18,0.978,0.753
2006/6/16,1045,6592,13,23,10,13,0.98,1.981
2006/6/16,1145,6577,-14,22,18,4,0.985,1.934
2006/6/16,1245,6545,-32,68,44,24,0.993,1.115
2006/6/16,1345,6580,35,63,4,59,0.989,1.038
2006/6/19,945,6552,-14,38,28,10,0.994,1.344
2006/6/19,1045,6542,-10,29,23,6,0.998,1.728
2006/6/19,1145,6592,49,49,-6,55,0.992,1.382
2006/6/19,1245,6570,-22,30,23,7,0.998,1.387
2006/6/19,1345,6575,5,33,9,24,1,1.344
2006/6/20,945,6496,-69,79,64,15,1.011,0.612
2006/6/20,1045,6451,-44,71,56,15,1.016,0.724
2006/6/20,1145,6384,-68,104,91,13,1.025,0.809
2006/6/20,1245,6315,-69,136,82,54,1.033,0.573
2006/6/20,1345,6359,44,56,8,48,1.022,0.855
2006/6/21,945,6388,26,101,27,74,1.014,1.367
2006/6/21,1045,6375,-13,48,29,19,1.014,2.508
2006/6/21,1145,6332,-43,72,55,17,1.018,1.894
2006/6/21,1245,6343,12,53,30,23,1.012,2.184
2006/6/21,1345,6316,-27,39,25,14,1.013,1.875
2006/6/22,945,6403,64,94,21,73,0.996,0.548
2006/6/22,1045,6417,13,42,23,19,0.992,0.789
2006/6/22,1145,6427,10,26,6,20,0.99,1.416
2006/6/22,1245,6445,17,23,6,17,0.988,0.963
2006/6/22,1345,6430,-16,24,20,4,0.992,0.92
2006/6/23,945,6320,-70,72,64,8,1.01,0.502
2006/6/23,1045,6301,-20,54,23,31,1.012,0.692
2006/6/23,1145,6334,33,55,16,39,1.005,1.067
2006/6/23,1245,6328,-4,44,19,25,1.006,1.352
2006/6/23,1345,6377,50,80,28,52,0.998,0.76
2006/6/26,945,6411,6,48,12,36,0.994,1.159
2006/6/26,1045,6394,-17,36,24,12,0.997,1.747
2006/6/26,1145,6435,41,42,-1,43,0.99,1.474
2006/6/26,1245,6493,61,73,7,66,0.981,0.86
2006/6/26,1345,6481,-12,43,32,11,0.984,1.157
2006/6/27,945,6525,50,85,5,80,0.979,0.782
2006/6/27,1045,6550,25,58,25,33,0.978,0.727
2006/6/27,1145,6526,-25,70,37,33,0.985,0.703
2006/6/27,1245,6490,-37,58,44,14,0.994,1.064
2006/6/27,1345,6515,24,60,12,48,0.993,0.945
2006/6/28,945,6420,-15,27,22,5,1.008,0.914
2006/6/28,1045,6428,8,36,4,32,1.007,1.167
2006/6/28,1145,6444,17,35,6,29,1.005,1.393
2006/6/28,1245,6437,-7,24,10,14,1.006,2.043
2006/6/28,1345,6455,19,33,11,22,1.002,1.305
2006/6/29,945,6523,35,30,6,24,0.992,0.933
2006/6/29,1045,6538,15,33,15,18,0.99,1.241
2006/6/29,1145,6512,-26,57,35,22,0.993,0.847
2006/6/29,1245,6540,28,30,2,28,0.989,1.178
2006/6/29,1345,6535,-5,39,18,21,0.991,0.821
2006/6/30,945,6642,-30,51,42,9,0.978,0.758
2006/6/30,1045,6638,-4,26,14,12,0.982,1.257
2006/6/30,1145,6641,2,18,12,6,0.985,2.325
2006/6/30,1245,6659,19,22,3,19,0.985,2.005
2006/6/30,1345,6655,-4,20,10,10,0.989,1.152
2006/7/3,945,6655,-10,35,17,18,0.992,1.186
2006/7/3,1045,6660,5,20,3,17,0.993,2.219
2006/7/3,1145,6658,-2,17,5,12,0.995,2.404
2006/7/3,1245,6653,-6,25,20,5,0.998,1.349
2006/7/3,1345,6666,13,19,-1,20,0.998,1.48
2006/7/4,945,6674,-16,39,19,20,0.997,0.572
2006/7/4,1045,6709,35,50,14,36,0.992,0.471
2006/7/4,1145,6718,9,33,12,21,0.992,0.993
2006/7/4,1245,6696,-23,42,31,11,0.996,0.879
2006/7/4,1345,6668,-27,56,27,29,1.001,0.637
2006/7/5,945,6642,-4,29,13,16,1.005,0.749
2006/7/5,1045,6662,21,36,6,30,1.001,1.173
2006/7/5,1145,6615,-47,57,47,10,1.009,0.912
2006/7/5,1245,6600,-13,34,4,30,1.01,0.581
2006/7/5,1345,6570,-29,37,40,-3,1.014,1.267
2006/7/6,945,6573,22,45,4,41,1.011,0.864
2006/7/6,1045,6546,-27,48,27,21,1.014,1.115
2006/7/6,1145,6558,13,50,17,33,1.01,1.14
2006/7/6,1245,6581,23,34,-9,43,1.004,1.114
2006/7/6,1345,6579,-3,21,6,15,1.002,1.066
2006/7/7,945,6559,-19,27,13,14,1.004,1.008
2006/7/7,1045,6564,5,27,20,7,1.002,1.464
2006/7/7,1145,6566,2,28,12,16,1,1.997
2006/7/7,1245,6573,6,25,15,10,0.999,1.502
2006/7/7,1345,6558,-14,26,20,6,1.001,1.509
2006/7/10,945,6511,0,34,9,25,1.007,0.873
2006/7/10,1045,6518,7,18,5,13,1.005,1.641
2006/7/10,1145,6544,26,31,1,30,1.001,1.636
2006/7/10,1245,6631,87,97,12,85,0.987,0.406
2006/7/10,1345,6659,27,30,-1,31,0.984,0.724
2006/7/11,945,6644,34,37,4,33,0.987,0.987
2006/7/11,1045,6621,-23,33,29,4,0.991,1.23
2006/7/11,1145,6615,-7,31,8,23,0.993,0.828
2006/7/11,1245,6615,0,24,16,8,0.994,1.323
2006/7/11,1345,6598,-17,19,19,0,0.997,1.09
2006/7/12,945,6642,39,53,16,37,0.992,0.736
2006/7/12,1045,6675,33,47,15,32,0.989,0.809
2006/7/12,1145,6668,-6,19,13,6,0.992,2.07
2006/7/12,1245,6558,-108,139,111,28,1.011,0.366
2006/7/12,1345,6579,22,59,15,44,1.006,0.859
2006/7/13,945,6562,24,63,14,49,1.008,0.84
2006/7/13,1045,6545,-17,31,23,8,1.009,1.405
2006/7/13,1145,6533,-12,32,22,10,1.01,1.46
2006/7/13,1245,6530,-1,41,29,12,1.009,1.551
2006/7/13,1345,6516,-13,31,21,10,1.01,1.315
2006/7/14,945,6405,-21,36,19,17,1.025,0.789
2006/7/14,1045,6400,-5,20,16,4,1.022,1.86
2006/7/14,1145,6359,-41,59,33,26,1.024,0.777
2006/7/14,1245,6351,-7,39,30,9,1.021,1.184
2006/7/14,1345,6368,17,40,6,34,1.015,1.175
2006/7/17,945,6278,-64,106,84,22,1.026,0.645
2006/7/17,1045,6291,14,47,17,30,1.019,1.259
2006/7/17,1145,6276,-15,31,18,13,1.018,1.94
2006/7/17,1245,6183,-94,108,100,8,1.029,0.767
2006/7/17,1345,6221,37,65,-3,68,1.017,0.932
2006/7/18,945,6252,50,46,12,34,1.009,1.069
2006/7/18,1045,6240,-15,37,15,22,1.008,1.54
2006/7/18,1145,6233,-6,28,25,3,1.007,1.262
2006/7/18,1245,6256,24,20,-3,23,1.001,1.616
2006/7/18,1345,6266,10,33,11,22,0.998,1.313
2006/7/19,945,6312,32,52,1,51,0.99,1.295
2006/7/19,1045,6325,13,32,15,17,0.988,1.274
2006/7/19,1145,6313,-11,33,23,10,0.99,2.166
2006/7/19,1245,6313,-1,32,13,19,0.991,1.814
2006/7/19,1345,6266,-47,59,46,13,1.001,1.028
2006/7/20,945,6276,17,37,18,19,1,0.47
2006/7/20,1045,6304,29,43,15,28,0.996,0.696
2006/7/20,1145,6281,-23,34,28,6,1,0.872
2006/7/20,1245,6305,23,31,8,23,0.997,1.152
2006/7/20,1345,6339,35,35,0,35,0.993,0.708
2006/7/21,945,6262,-10,32,25,7,1.005,0.747
2006/7/21,1045,6248,-12,29,25,4,1.006,1.166
2006/7/21,1145,6266,20,34,3,31,1.002,1.195
2006/7/21,1245,6279,12,32,-1,33,0.999,1.847
2006/7/21,1345,6292,14,23,8,15,0.997,0.957
2006/7/24,945,6189,4,34,8,26,1.012,0.849
2006/7/24,1045,6197,9,32,12,20,1.009,1.326
2006/7/24,1145,6191,-7,26,17,9,1.009,1.674
2006/7/24,1245,6229,39,49,11,38,1.001,0.832
2006/7/24,1345,6238,9,19,9,10,0.998,0.941
2006/7/25,945,6328,-20,51,39,12,0.985,0.658
2006/7/25,1045,6334,7,17,10,7,0.986,1.491
2006/7/25,1145,6329,-5,28,6,22,0.988,1.144
2006/7/25,1245,6320,-9,22,13,9,0.99,1.327
2006/7/25,1345,6315,-6,29,9,20,0.992,0.961
2006/7/26,945,6287,-21,57,36,21,0.998,0.679
2006/7/26,1045,6323,36,63,25,38,0.994,0.628
2006/7/26,1145,6293,-30,33,36,-3,1.001,1.044
2006/7/26,1245,6294,1,31,20,11,1.002,1.121
2006/7/26,1345,6292,-1,36,27,9,1.003,1.322
2006/7/27,945,6318,26,42,7,35,0.998,0.913
2006/7/27,1045,6350,31,38,8,30,0.993,0.658
2006/7/27,1145,6351,0,28,13,15,0.993,1.224
2006/7/27,1245,6377,24,35,7,28,0.99,0.9
2006/7/27,1345,6401,25,32,7,25,0.987,0.778
2006/7/28,945,6418,37,52,7,45,0.985,0.894
2006/7/28,1045,6410,-9,20,15,5,0.989,1.493
2006/7/28,1145,6373,-39,68,41,27,0.996,0.73
2006/7/28,1245,6405,32,54,9,45,0.992,1.418
2006/7/28,1345,6396,-10,34,15,19,0.995,1.551
2006/7/31,945,6445,-11,33,23,10,0.99,0.968
2006/7/31,1045,6425,-21,37,24,13,0.995,0.942
2006/7/31,1145,6368,-56,79,56,23,1.005,0.67
2006/7/31,1245,6355,-12,49,20,29,1.008,0.964
2006/7/31,1345,6361,6,35,17,18,1.006,1.185
2006/8/1,945,6386,15,49,29,20,1.002,0.854
2006/8/1,1045,6390,4,33,24,9,1.001,1.108
2006/8/1,1145,6371,-17,44,18,26,1.004,1.066
2006/8/1,1245,6375,6,28,13,15,1.003,1.356
2006/8/1,1345,6379,4,21,6,15,1.002,1.694
2006/8/2,945,6372,23,35,7,28,1.001,1.214
2006/8/2,1045,6411,39,61,10,51,0.994,0.782
2006/8/2,1145,6433,23,41,21,20,0.99,0.783
2006/8/2,1245,6422,-11,23,16,7,0.993,1.433
2006/8/2,1345,6439,16,22,-1,23,0.992,1.371
2006/8/3,945,6453,-6,28,16,12,0.991,0.847
2006/8/3,1045,6421,-32,42,36,6,0.997,0.89
2006/8/3,1145,6415,-7,31,12,19,0.998,0.784
2006/8/3,1245,6424,9,24,11,13,0.997,1.458
2006/8/3,1345,6408,-16,37,37,0,1.001,1.226
2006/8/4,945,6420,-20,35,20,15,1,1.177
2006/8/4,1045,6418,-1,31,26,5,1.001,1.099
2006/8/4,1145,6432,13,17,3,14,0.999,2.03
2006/8/4,1245,6368,-64,66,63,3,1.009,0.688
2006/8/4,1345,6366,-2,25,7,18,1.009,0.647
2006/8/7,945,6351,-1,32,17,15,1.009,0.99
2006/8/7,1045,6383,32,57,19,38,1.003,0.869
2006/8/7,1145,6359,-25,44,37,7,1.006,1.169
2006/8/7,1245,6358,-2,29,8,21,1.005,1.105
2006/8/7,1345,6350,-8,25,15,10,1.006,1.48
2006/8/8,945,6431,61,66,10,56,0.992,0.547
2006/8/8,1045,6434,3,24,16,8,0.991,1.183
2006/8/8,1145,6421,-13,23,18,5,0.994,2.079
2006/8/8,1245,6428,5,23,11,12,0.993,1.615
2006/8/8,1345,6501,73,73,-1,74,0.982,0.678
2006/8/9,945,6467,-4,27,20,7,0.989,0.922
2006/8/9,1045,6460,-7,23,12,11,0.992,1.38
2006/8/9,1145,6472,11,27,14,13,0.992,1.407
2006/8/9,1245,6531,59,67,7,60,0.984,0.735
2006/8/9,1345,6580,48,41,-8,49,0.98,0.592
2006/8/10,945,6566,23,56,32,24,0.984,0.674
2006/8/10,1045,6568,3,27,16,11,0.986,1.686
2006/8/10,1145,6537,-31,77,57,20,0.993,0.649
2006/8/10,1245,6556,19,35,12,23,0.992,1.356
2006/8/10,1345,6555,-1,45,35,10,0.994,0.945
2006/8/11,945,6557,1,41,28,13,0.995,1.113
2006/8/11,1045,6550,-6,36,14,22,0.997,1.453
2006/8/11,1145,6548,-1,27,19,8,0.999,1.601
2006/8/11,1245,6545,-3,18,9,9,1,2.301
2006/8/11,1345,6538,-9,32,24,8,1.002,1.298
2006/8/14,945,6611,54,83,27,56,0.991,0.569
2006/8/14,1045,6605,-7,28,20,8,0.992,1.33
2006/8/14,1145,6583,-22,43,31,12,0.996,1.013
2006/8/14,1245,6592,9,23,3,20,0.996,1.772
2006/8/14,1345,6595,3,29,17,12,0.996,1.024
2006/8/15,945,6586,1,28,17,11,0.998,1.042
2006/8/15,1045,6590,4,20,15,5,0.997,1.561
2006/8/15,1145,6587,-1,33,17,16,0.998,1.236
2006/8/15,1245,6604,18,32,8,24,0.996,1.259
2006/8/15,1345,6607,2,16,4,12,0.997,1.507
2006/8/16,945,6660,1,22,19,3,0.991,1.363
2006/8/16,1045,6665,5,9,5,4,0.99,3.06
2006/8/16,1145,6684,19,30,11,19,0.989,1.251
2006/8/16,1245,6688,4,15,10,5,0.989,1.759
2006/8/16,1345,6692,6,17,10,7,0.99,0.776
2006/8/17,945,6698,-24,34,34,0,0.991,0.435
2006/8/17,1045,6697,-3,18,11,7,0.993,0.849
2006/8/17,1145,6706,9,24,12,12,0.994,0.898
2006/8/17,1245,6714,8,22,9,13,0.994,0.99
2006/8/17,1345,6695,-20,33,23,10,0.999,0.649
2006/8/18,945,6692,-17,20,24,-4,1,0.949
2006/8/18,1045,6693,1,15,15,0,1,1.852
2006/8/18,1145,6704,11,18,7,11,0.999,2.2
2006/8/18,1245,6706,2,9,6,3,0.999,2.256
2006/8/18,1345,6698,-8,17,14,3,1,1.022
2006/8/21,945,6630,-58,76,64,12,1.01,0.432
2006/8/21,1045,6617,-13,43,18,25,1.011,0.542
2006/8/21,1145,6536,-86,71,81,-10,1.023,0.65
2006/8/21,1245,6488,-50,64,55,9,1.028,0.628
2006/8/21,1345,6460,-27,55,38,17,1.028,0.632
2006/8/22,945,6491,-9,32,8,24,1.02,0.902
2006/8/22,1045,6501,10,31,12,19,1.016,1.173
2006/8/22,1145,6497,-4,18,11,7,1.013,2.269
2006/8/22,1245,6514,16,21,5,16,1.007,1.656
2006/8/22,1345,6539,26,35,7,28,1.001,0.936
2006/8/23,945,6415,-110,147,107,40,1.018,0.495
2006/8/23,1045,6440,23,53,14,39,1.01,0.931
2006/8/23,1145,6528,87,103,17,86,0.994,0.661
2006/8/23,1245,6533,5,42,12,30,0.993,1.354
2006/8/23,1345,6515,-18,59,28,31,0.996,1.055
2006/8/24,945,6501,19,64,28,36,0.998,0.874
2006/8/24,1045,6508,8,36,13,23,0.997,1.656
2006/8/24,1145,6512,4,25,3,22,0.997,2.059
2006/8/24,1245,6491,-21,38,20,18,1,1.519
2006/8/24,1345,6515,23,34,9,25,0.996,1.521
2006/8/25,945,6560,45,68,25,43,0.989,0.752
2006/8/25,1045,6524,-36,53,44,9,0.997,0.994
2006/8/25,1145,6539,15,22,5,17,0.996,1.853
2006/8/25,1245,6526,-13,24,14,10,0.998,1.667
2006/8/25,1345,6489,-37,49,36,13,1.004,0.71
2006/8/28,945,6457,-44,103,52,51,1.009,0.594
2006/8/28,1045,6432,-23,34,26,8,1.012,1.361
2006/8/28,1145,6415,-17,45,25,20,1.014,0.879
2006/8/28,1245,6410,-5,43,15,28,1.013,0.947
2006/8/28,1345,6402,-7,49,33,16,1.013,1.177
2006/8/29,945,6442,-8,29,8,21,1.006,1.175
2006/8/29,1045,6447,4,21,15,6,1.003,1.27
2006/8/29,1145,6446,-2,14,10,4,1.002,2.536
2006/8/29,1245,6441,-4,18,5,13,1.001,1.791
2006/8/29,1345,6439,-3,13,7,6,1,1.922
2006/8/30,945,6536,82,117,14,103,0.985,0.387
2006/8/30,1045,6568,32,48,12,36,0.981,0.697
2006/8/30,1145,6561,-7,29,24,5,0.984,1.33
2006/8/30,1245,6568,6,16,6,10,0.985,1.97
2006/8/30,1345,6563,-5,30,3,27,0.989,0.833
2006/8/31,945,6621,36,60,23,37,0.982,0.619
2006/8/31,1045,6616,-4,32,18,14,0.985,1.224
2006/8/31,1145,6630,13,34,5,29,0.986,1.397
2006/8/31,1245,6642,14,25,6,19,0.987,1.007
2006/8/31,1345,6621,-22,38,21,17,0.993,0.993
2006/9/1,945,6611,-9,32,27,5,0.997,1.154
2006/9/1,1045,6616,4,16,11,5,0.997,2.692
2006/9/1,1145,6634,18,33,11,22,0.995,1.616
2006/9/1,1245,6630,-5,17,13,4,0.997,1.804
2006/9/1,1345,6646,16,28,2,26,0.996,1.46
2006/9/4,945,6714,23,41,15,26,0.987,0.543
2006/9/4,1045,6716,2,13,3,10,0.988,1.886
2006/9/4,1145,6718,2,19,4,15,0.989,1.682
2006/9/4,1245,6752,33,42,3,39,0.986,0.658
2006/9/4,1345,6738,-13,25,13,12,0.989,0.874
2006/9/5,945,6739,1,30,10,20,0.991,0.799
2006/9/5,1045,6720,-19,19,21,-2,0.996,1.592
2006/9/5,1145,6735,13,22,-1,23,0.995,1.493
2006/9/5,1245,6734,-1,17,12,5,0.997,1.7
2006/9/5,1345,6738,5,16,1,15,0.998,1.481
2006/9/6,945,6693,-34,85,42,43,1.005,0.39
2006/9/6,1045,6691,-2,25,14,11,1.005,1.119
2006/9/6,1145,6642,-49,66,56,10,1.012,0.575
2006/9/6,1245,6643,0,44,4,40,1.011,0.669
2006/9/6,1345,6653,10,26,10,16,1.008,1.004
2006/9/7,945,6611,-4,27,9,18,1.012,0.65
2006/9/7,1045,6596,-17,31,17,14,1.012,1.141
2006/9/7,1145,6604,6,23,7,16,1.009,1.867
2006/9/7,1245,6664,60,69,3,66,0.998,0.849
2006/9/7,1345,6640,-24,37,40,-3,1.001,0.988
2006/9/8,945,6632,12,45,16,29,1,1.007
2006/9/8,1045,6682,50,67,13,54,0.992,0.673
2006/9/8,1145,6671,-9,34,13,21,0.994,1.415
2006/9/8,1245,6671,-1,35,28,7,0.994,1.088
2006/9/8,1345,6696,26,15,-11,26,0.991,1.576
2006/9/11,945,6783,99,152,27,125,0.979,0.473
2006/9/11,1045,6775,-8,40,20,20,0.983,1.38
2006/9/11,1145,6753,-20,35,25,10,0.988,1.638
2006/9/11,1245,6658,-95,124,96,28,1.005,0.515
2006/9/11,1345,6648,-10,60,34,26,1.006,0.926
2006/9/12,945,6631,0,73,47,26,1.009,0.885
2006/9/12,1045,6643,12,37,14,23,1.007,1.58
2006/9/12,1145,6649,5,35,8,27,1.006,1.723
2006/9/12,1245,6633,-14,43,32,11,1.008,1.523
2006/9/12,1345,6588,-43,42,44,-2,1.014,0.939
2006/9/13,945,6642,-9,37,28,9,1.005,0.946
2006/9/13,1045,6621,-22,49,34,15,1.006,1.251
2006/9/13,1145,6622,0,22,16,6,1.004,1.746
2006/9/13,1245,6632,10,24,12,12,1,1.708
2006/9/13,1345,6644,12,29,11,18,0.998,1.08
2006/9/14,945,6657,7,49,32,17,0.997,0.684
2006/9/14,1045,6627,-31,55,40,15,1.001,0.782
2006/9/14,1145,6540,-86,91,93,-2,1.015,0.515
2006/9/14,1245,6545,4,46,5,41,1.012,0.776
2006/9/14,1345,6579,34,74,11,63,1.006,0.75
2006/9/15,945,6591,-6,75,38,37,1.003,0.794
2006/9/15,1045,6609,18,32,9,23,0.999,1.678
2006/9/15,1145,6619,9,35,21,14,0.998,1.111
2006/9/15,1245,6611,-8,22,20,2,0.999,1.915
2006/9/15,1345,6669,57,64,6,58,0.99,0.904
2006/9/18,945,6799,10,75,22,53,0.973,0.812
2006/9/18,1045,6821,23,42,18,24,0.972,1.407
2006/9/18,1145,6866,45,55,9,46,0.968,1.005
2006/9/18,1245,6875,8,36,12,24,0.972,1.309
2006/9/18,1345,6895,20,25,5,20,0.974,0.991
2006/9/19,945,6893,-8,45,14,31,0.979,0.856
2006/9/19,1045,6892,-1,25,8,17,0.983,1.665
2006/9/19,1145,6905,13,38,18,20,0.985,1.557
2006/9/19,1245,6899,-5,22,13,9,0.99,1.872
2006/9/19,1345,6876,-24,40,35,5,0.998,1.345
2006/9/20,945,6867,17,36,11,25,1,1.561
2006/9/20,1045,6838,-29,31,35,-4,1.005,1.645
2006/9/20,1145,6846,9,50,24,26,1.004,1.327
2006/9/20,1245,6871,23,37,3,34,1,2.331
2006/9/20,1345,6880,10,24,15,9,0.999,1.132
2006/9/21,945,6874,-26,67,46,21,1,0.372
2006/9/21,1045,6838,-36,52,47,5,1.005,0.742
2006/9/21,1145,6836,-2,32,12,20,1.004,0.683
2006/9/21,1245,6866,30,58,17,41,0.999,0.627
2006/9/21,1345,6880,13,33,-2,35,0.996,1.064
2006/9/22,945,6840,-6,36,26,10,1.002,0.682
2006/9/22,1045,6854,13,27,8,19,1,1.35
2006/9/22,1145,6841,-13,21,15,6,1.002,1.834
2006/9/22,1245,6852,11,16,1,15,1,2.642
2006/9/22,1345,6858,5,16,14,2,0.999,1.323
2006/9/25,945,6864,21,81,56,25,0.997,0.532
2006/9/25,1045,6852,-13,32,21,11,0.999,1.407
2006/9/25,1145,6847,-5,33,7,26,1,0.908
2006/9/25,1245,6863,15,36,16,20,0.998,1.056
2006/9/25,1345,6925,64,64,0,64,0.989,0.725
2006/9/26,945,6915,0,49,40,9,0.991,0.656
2006/9/26,1045,6908,-8,32,20,12,0.993,1.181
2006/9/26,1145,6922,14,31,7,24,0.992,1.695
2006/9/26,1245,6898,-25,35,24,11,0.997,1.249
2006/9/26,1345,6900,2,21,14,7,0.997,1.489
2006/9/27,945,6930,-24,48,35,13,0.994,0.661
2006/9/27,1045,6950,20,22,0,22,0.992,1.784
2006/9/27,1145,6953,3,24,11,13,0.993,1.415
2006/9/27,1245,6946,-6,24,6,18,0.996,1.088
2006/9/27,1345,6955,10,24,3,21,0.996,1.139
2006/9/28,945,6942,-18,63,41,22,0.998,0.63
2006/9/28,1045,6891,-50,61,51,10,1.006,0.651
2006/9/28,1145,6879,-12,42,6,36,1.008,0.69
2006/9/28,1245,6881,2,28,9,19,1.007,1.325
2006/9/28,1345,6864,-17,42,44,-2,1.009,0.829
2006/9/29,945,6877,-3,39,17,22,1.006,1.18
2006/9/29,1045,6870,-7,30,23,7,1.006,1.229
2006/9/29,1145,6862,-6,31,21,10,1.006,1.881
2006/9/29,1245,6866,3,24,5,19,1.004,1.628
2006/9/29,1345,6877,12,24,11,13,1.001,1.611
2006/10/2,945,6955,85,91,20,71,0.989,0.474
2006/10/2,1045,6932,-24,52,31,21,0.992,0.965
2006/10/2,1145,6941,9,25,6,19,0.992,1.517
2006/10/2,1245,6936,-4,17,16,1,0.993,1.527
2006/10/2,1345,6959,23,36,9,27,0.991,1.048
2006/10/3,945,6933,-14,28,20,8,0.996,0.827
2006/10/3,1045,6941,8,16,8,8,0.995,2.351
2006/10/3,1145,6942,1,17,5,12,0.996,1.915
2006/10/3,1245,6955,13,24,5,19,0.995,1.663
2006/10/3,1345,6940,-16,23,23,0,0.999,1.601
2006/10/4,945,6897,-51,87,73,14,1.006,0.407
2006/10/4,1045,6900,2,21,9,12,1.005,0.914
2006/10/4,1145,6903,3,14,6,8,1.004,1.724
2006/10/4,1245,6880,-21,31,22,9,1.007,0.988
2006/10/4,1345,6867,-12,34,23,11,1.008,0.678
2006/10/5,945,6933,-1,35,22,13,0.998,0.652
2006/10/5,1045,6944,11,21,6,15,0.997,1.313
2006/10/5,1145,6991,46,57,10,47,0.99,0.668
2006/10/5,1245,6996,5,24,14,10,0.99,1.047
2006/10/5,1345,7012,16,19,3,16,0.988,1.074
2006/10/11,945,7018,-25,50,19,31,0.989,0.883
2006/10/11,1045,7004,-14,22,14,8,0.992,2.488
2006/10/11,1145,7006,1,19,5,14,0.994,2.583
2006/10/11,1245,7001,-4,21,15,6,0.996,2.214
2006/10/11,1345,7009,8,18,8,10,0.996,1.9
2006/10/12,945,6982,-30,73,56,17,1.001,0.547
2006/10/12,1045,6986,5,15,5,10,1.001,1.303
2006/10/12,1145,6991,5,19,4,15,1.001,1.648
2006/10/12,1245,6998,6,20,8,12,1,1.229
2006/10/12,1345,6981,-16,37,28,9,1.003,0.797
2006/10/13,945,7042,-24,27,24,3,0.994,0.578
2006/10/13,1045,7057,15,20,6,14,0.993,1.169
2006/10/13,1145,7086,28,33,1,32,0.989,1.039
2006/10/13,1245,7099,13,22,10,12,0.989,0.773
2006/10/13,1345,7080,-18,35,23,12,0.993,0.928
2006/10/14,945,7093,4,19,-4,23,0.992,1.561
2006/10/14,1045,7079,-14,29,22,7,0.996,1.055
2006/10/14,1145,7085,5,15,8,7,0.996,2.564
2006/10/14,1245,7091,7,15,2,13,0.996,3.201
2006/10/14,1345,7102,11,17,-5,22,0.996,1.999
2006/10/16,945,7133,22,56,16,40,0.993,0.557
2006/10/16,1045,7145,11,36,15,21,0.992,0.665
2006/10/16,1145,7147,1,20,11,9,0.993,1.369
2006/10/16,1245,7152,5,22,12,10,0.993,1.244
2006/10/16,1345,7143,-9,42,18,24,0.995,0.594
2006/10/17,945,7111,-29,27,18,9,1,0.603
2006/10/17,1045,7099,-12,15,20,-5,1.002,1.394
2006/10/17,1145,7090,-5,22,8,14,1.004,0.684
2006/10/17,1245,7094,5,15,7,8,1.003,1.582
2006/10/17,1345,7076,-18,30,31,-1,1.006,0.871
2006/10/18,945,7033,-18,30,22,8,1.011,0.981
2006/10/18,1045,7009,-23,36,22,14,1.013,0.967
2006/10/18,1145,6992,-15,37,21,16,1.014,1.28
2006/10/18,1245,7000,8,17,6,11,1.01,2.248
2006/10/18,1345,7025,25,22,-2,24,1.005,1.459
2006/10/19,945,7012,8,38,21,17,1.005,0.622
2006/10/19,1045,6991,-21,30,27,3,1.006,1.182
2006/10/19,1145,6975,-16,35,21,14,1.007,0.537
2006/10/19,1245,6980,4,20,10,10,1.005,1.368
2006/10/19,1345,6981,1,21,13,8,1.003,1.097
2006/10/20,945,7007,0,26,16,10,0.999,0.808
2006/10/20,1045,7010,3,12,4,8,0.998,2.163
2006/10/20,1145,7015,6,17,11,6,0.997,1.164
2006/10/20,1245,7019,4,7,0,7,0.997,2.97
2006/10/20,1345,7017,-2,9,6,3,0.997,1.326
2006/10/23,945,6990,-38,55,42,13,1.002,0.705
2006/10/23,1045,6995,5,23,14,9,1.001,1.163
2006/10/23,1145,6994,0,17,9,8,1.001,1.468
2006/10/23,1245,7013,18,24,4,20,0.998,1.357
2006/10/23,1345,7049,36,38,1,37,0.994,0.529
2006/10/24,945,7077,3,25,6,19,0.991,0.589
2006/10/24,1045,7099,23,48,21,27,0.989,0.472
2006/10/24,1145,7096,-3,19,13,6,0.99,1.277
2006/10/24,1245,7099,3,14,6,8,0.991,2.111
2006/10/24,1345,7097,0,15,5,10,0.992,1.205
2006/10/25,945,7096,11,23,9,14,0.993,0.948
2006/10/25,1045,7082,-16,28,18,10,0.997,1.056
2006/10/25,1145,7077,-4,18,9,9,0.999,1.963
2006/10/25,1245,7093,16,24,3,21,0.998,1.633
2006/10/25,1345,7060,-33,35,35,0,1.003,0.766
2006/10/26,945,7108,28,35,10,25,0.997,0.625
2006/10/26,1045,7113,5,24,12,12,0.996,0.942
2006/10/26,1145,7112,-2,11,5,6,0.997,1.619
2006/10/26,1245,7096,-16,29,23,6,0.999,1.373
2006/10/26,1345,7093,-3,24,3,21,1,0.684
2006/10/27,945,7110,0,26,20,6,0.998,0.615
2006/10/27,1045,7106,-5,19,9,10,0.998,1.47
2006/10/27,1145,7109,4,11,6,5,0.998,2.271
2006/10/27,1245,7104,-5,18,11,7,0.999,1.647
2006/10/27,1345,7093,-13,32,16,16,1.001,0.867
2006/10/30,945,6994,-41,47,34,13,1.015,0.441
2006/10/30,1045,6998,3,18,4,14,1.013,1.126
2006/10/30,1145,6990,-9,16,11,5,1.012,1.732
2006/10/30,1245,6984,-5,15,7,8,1.011,1.417
2006/10/30,1345,6981,-4,28,25,3,1.01,0.739
2006/10/31,945,6981,0,31,16,15,1.008,0.846
2006/10/31,1045,6984,2,13,9,4,1.006,2.176
2006/10/31,1145,6995,11,15,4,11,1.003,2.703
2006/10/31,1245,6999,4,10,4,6,1,1.865
2006/10/31,1345,7002,3,21,7,14,0.998,1.207
2006/11/1,945,7014,15,23,5,18,0.996,0.898
2006/11/1,1045,7017,2,16,8,8,0.996,1.237
2006/11/1,1145,7014,-3,12,5,7,0.997,1.825
2006/11/1,1245,7010,-4,22,4,18,0.998,1.233
2006/11/1,1345,7003,-7,14,11,3,0.999,1.007
2006/11/2,945,7010,47,43,-1,44,0.998,0.415
2006/11/2,1045,7047,38,45,11,34,0.993,0.413
2006/11/2,1145,7051,4,18,5,13,0.993,1.426
2006/11/2,1245,7057,5,22,15,7,0.993,1.006
2006/11/2,1345,7063,6,22,2,20,0.993,1.052
2006/11/3,945,7100,23,57,12,45,0.989,0.618
2006/11/3,1045,7127,27,32,-5,37,0.987,0.918
2006/11/3,1145,7148,21,36,10,26,0.985,0.761
2006/11/3,1245,7162,13,31,11,20,0.985,1.152
2006/11/3,1345,7141,-21,33,38,-5,0.99,0.875
2006/11/6,945,7084,-16,63,24,39,1,0.585
2006/11/6,1045,7108,24,35,8,27,0.998,1.353
2006/11/6,1145,7101,-7,18,10,8,1,2.563
2006/11/6,1245,7141,40,49,5,44,0.995,1.213
2006/11/6,1345,7115,-26,44,41,3,0.999,0.987
2006/11/7,945,7176,12,27,21,6,0.992,0.828
2006/11/7,1045,7192,15,33,13,20,0.991,1.166
2006/11/7,1145,7194,1,24,17,7,0.992,1.383
2006/11/7,1245,7184,-10,22,13,9,0.994,1.714
2006/11/7,1345,7183,-1,20,9,11,0.994,1.228
2006/11/8,945,7187,2,23,1,22,0.995,1.04
2006/11/8,1045,7180,-6,17,7,10,0.997,1.66
2006/11/8,1145,7176,-4,16,8,8,0.999,2.721
2006/11/8,1245,7175,-1,22,1,21,1,1.539
2006/11/8,1345,7156,-19,20,23,-3,1.003,1.385
2006/11/9,945,7200,4,37,26,11,0.997,0.48
2006/11/9,1045,7207,7,17,4,13,0.997,1.172
2006/11/9,1145,7197,-10,42,35,7,0.998,0.613
2006/11/9,1245,7195,-2,20,5,15,0.999,0.794
2006/11/9,1345,7128,-67,87,69,18,1.008,0.405
2006/11/10,945,7118,-13,40,24,16,1.009,0.821
2006/11/10,1045,7138,20,30,10,20,1.005,1.368
2006/11/10,1145,7135,-2,31,19,12,1.005,1.666
2006/11/10,1245,7144,9,20,6,14,1.003,2.059
2006/11/10,1345,7162,18,38,2,36,1,1.181
2006/11/13,945,7161,-1,30,17,13,1,1.374
2006/11/13,1045,7120,-40,51,41,10,1.005,0.702
2006/11/13,1145,7132,12,20,5,15,1.002,2.001
2006/11/13,1245,7138,6,17,9,8,1,1.809
2006/11/13,1345,7132,-6,26,17,9,1,0.911
2006/11/14,945,7173,-6,28,22,6,0.995,0.754
2006/11/14,1045,7189,15,31,4,27,0.994,1.058
2006/11/14,1145,7187,-3,26,17,9,0.995,1.146
2006/11/14,1245,7194,7,23,8,15,0.995,1.354
2006/11/14,1345,7206,10,23,6,17,0.994,0.89
2006/11/15,945,7237,-13,24,21,3,0.991,1.054
2006/11/15,1045,7234,-3,17,12,5,0.992,1.449
2006/11/15,1145,7239,3,10,6,4,0.993,1.971
2006/11/15,1245,7236,-4,23,3,20,0.995,1.26
2006/11/15,1345,7247,11,15,-3,18,0.995,0.834
2006/11/16,945,7266,13,33,4,29,0.993,0.437
2006/11/16,1045,7246,-20,27,19,8,0.997,0.823
2006/11/16,1145,7245,-1,21,7,14,0.998,1.058
2006/11/16,1245,7250,4,15,7,8,0.998,1.808
2006/11/16,1345,7248,-2,12,4,8,0.999,1.534
2006/11/17,945,7249,-12,36,25,11,0.999,0.684
2006/11/17,1045,7258,9,18,3,15,0.998,1.611
2006/11/17,1145,7260,1,22,4,18,0.998,1.611
2006/11/17,1245,7256,-3,17,9,8,0.999,1.903
2006/11/17,1345,7257,2,15,4,11,0.999,1.326
2006/11/20,945,7223,-22,30,22,8,1.004,0.56
2006/11/20,1045,7218,-5,19,6,13,1.004,0.627
2006/11/20,1145,7227,9,11,-1,12,1.002,1.554
2006/11/20,1245,7232,6,15,6,9,1.001,1.357
2006/11/20,1345,7220,-11,13,11,2,1.003,1.228
2006/11/21,945,7237,-1,30,19,11,1,0.571
2006/11/21,1045,7240,3,11,4,7,0.999,1.983
2006/11/21,1145,7295,54,66,7,59,0.992,0.424
2006/11/21,1245,7300,5,24,11,13,0.991,1.099
2006/11/21,1345,7306,6,12,1,11,0.991,1.265
2006/11/22,945,7308,-12,26,15,11,0.992,1.02
2006/11/22,1045,7318,11,24,12,12,0.992,1.021
2006/11/22,1145,7321,3,12,2,10,0.993,2.017
2006/11/22,1245,7329,8,17,6,11,0.993,1.221
2006/11/22,1345,7343,14,21,2,19,0.992,1.061
2006/11/23,945,7338,-12,23,22,1,0.995,0.89
2006/11/23,1045,7395,56,60,7,53,0.988,0.601
2006/11/23,1145,7373,-22,71,54,17,0.993,0.428
2006/11/23,1245,7379,5,27,11,16,0.994,1.17
2006/11/23,1345,7394,16,24,2,22,0.993,1.427
2006/11/24,945,7387,9,34,10,24,0.994,0.959
2006/11/24,1045,7395,8,25,14,11,0.994,1.347
2006/11/24,1145,7408,13,16,-1,17,0.994,2.333
2006/11/24,1245,7406,-3,18,8,10,0.995,2.308
2006/11/24,1345,7433,27,37,4,33,0.993,0.966
2006/11/27,945,7479,-8,26,19,7,0.988,0.779
2006/11/27,1045,7458,-21,41,34,7,0.993,0.949
2006/11/27,1145,7472,14,20,5,15,0.992,1.521
2006/11/27,1245,7504,31,46,11,35,0.989,0.751
2006/11/27,1345,7510,3,32,-2,34,0.99,0.852
2006/11/28,945,7463,17,33,12,21,0.997,0.845
2006/11/28,1045,7453,-10,22,14,8,0.999,1.145
2006/11/28,1145,7464,13,16,2,14,0.999,1.884
2006/11/28,1245,7470,7,11,0,11,0.999,2.058
2006/11/28,1345,7454,-16,21,15,6,1.002,1.321
2006/11/29,945,7486,9,19,8,11,0.997,1.008
2006/11/29,1045,7448,-39,43,50,-7,1.002,0.78
2006/11/29,1145,7425,-25,59,29,30,1.005,0.42
2006/11/29,1245,7448,24,28,0,28,1.002,1.056
2006/11/29,1345,7465,17,30,1,29,0.999,0.811
2006/11/30,945,7486,-12,40,29,11,0.996,0.775
2006/11/30,1045,7509,24,35,14,21,0.994,1.002
2006/11/30,1145,7517,7,30,21,9,0.993,0.986
2006/11/30,1245,7532,15,22,3,19,0.992,1.32
2006/11/30,1345,7542,10,31,11,20,0.992,0.894
2006/12/1,945,7572,21,51,16,35,0.989,0.934
2006/12/1,1045,7573,1,33,6,27,0.99,1.327
2006/12/1,1145,7591,19,40,16,24,0.989,0.772
2006/12/1,1245,7614,23,37,12,25,0.988,1.072
2006/12/1,1345,7612,-1,30,7,23,0.991,0.872
2006/12/4,945,7608,-4,35,12,23,0.993,1.06
2006/12/4,1045,7629,17,36,0,36,0.992,1.385
2006/12/4,1145,7649,20,44,19,25,0.99,0.974
2006/12/4,1245,7645,-4,50,29,21,0.993,0.963
2006/12/4,1345,7658,13,26,12,14,0.993,1.291
2006/12/5,945,7686,-2,26,18,8,0.991,0.882
2006/12/5,1045,7656,-30,55,34,21,0.996,0.881
2006/12/5,1145,7633,-22,36,39,-3,1,1.142
2006/12/5,1245,7617,-16,31,30,1,1.003,1.055
2006/12/5,1345,7610,-8,51,6,45,1.004,0.569
2006/12/6,945,7632,22,34,18,16,1.001,0.912
2006/12/6,1045,7678,44,56,7,49,0.995,0.842
2006/12/6,1145,7658,-20,28,23,5,0.998,1.497
2006/12/6,1245,7673,14,23,5,18,0.997,1.982
2006/12/6,1345,7714,40,46,0,46,0.992,0.846
2006/12/7,945,7698,-40,40,29,11,0.994,1.051
2006/12/7,1045,7697,-2,33,8,25,0.995,1.074
2006/12/7,1145,7720,21,25,-8,33,0.992,1.881
2006/12/7,1245,7718,-2,20,15,5,0.994,1.116
2006/12/7,1345,7698,-20,37,21,16,0.998,0.902
2006/12/8,945,7656,-19,35,23,12,1.004,0.842
2006/12/8,1045,7645,-10,39,29,10,1.006,1.157
2006/12/8,1145,7610,-36,42,44,-2,1.01,1.154
2006/12/8,1245,7614,5,28,12,16,1.009,0.885
2006/12/8,1345,7633,19,29,2,27,1.005,0.961
2006/12/11,945,7591,-9,64,48,16,1.009,0.647
2006/12/11,1045,7597,5,25,7,18,1.007,1.324
2006/12/11,1145,7627,31,36,2,34,1.002,1.339
2006/12/11,1245,7621,-6,21,16,5,1.001,1.492
2006/12/11,1345,7614,-8,28,18,10,1.001,1.34
2006/12/12,945,7561,-39,51,43,8,1.007,0.603
2006/12/12,1045,7527,-34,50,39,11,1.01,0.605
2006/12/12,1145,7502,-24,47,23,24,1.012,0.682
2006/12/12,1245,7473,-28,49,30,19,1.014,0.802
2006/12/12,1345,7467,-6,23,22,1,1.013,1.095
2006/12/13,945,7491,14,33,9,24,1.008,1.005
2006/12/13,1045,7425,-66,66,64,2,1.016,0.811
2006/12/13,1145,7402,-24,47,20,27,1.017,0.731
2006/12/13,1245,7385,-17,30,32,-2,1.016,1.584
2006/12/13,1345,7450,65,81,16,65,1.004,0.798
2006/12/14,945,7467,17,57,17,40,1,1.016
2006/12/14,1045,7465,-4,24,20,4,0.999,1.62
2006/12/14,1145,7483,18,29,7,22,0.996,2.016
2006/12/14,1245,7467,-14,22,24,-2,0.997,2.169
2006/12/14,1345,7478,10,23,11,12,0.996,1.566
2006/12/15,945,7541,-3,26,13,13,0.989,0.985
2006/12/15,1045,7547,6,14,5,9,0.988,2.129
2006/12/15,1145,7551,4,18,8,10,0.989,2.171
2006/12/15,1245,7550,-2,16,9,7,0.992,1.989
2006/12/15,1345,7540,-10,24,9,15,0.995,0.853
2006/12/18,945,7546,-4,23,17,6,0.996,0.965
2006/12/18,1045,7597,52,61,6,55,0.99,0.637
2006/12/18,1145,7647,50,46,2,44,0.985,0.531
2006/12/18,1245,7645,-2,33,23,10,0.988,0.789
2006/12/18,1345,7634,-11,18,19,-1,0.991,1.194
2006/12/19,945,7630,17,32,13,19,0.993,0.884
2006/12/19,1045,7623,-7,57,52,5,0.995,0.679
2006/12/19,1145,7605,-18,39,24,15,0.998,0.71
2006/12/19,1245,7616,10,34,22,12,0.997,1.401
2006/12/19,1345,7593,-21,32,22,10,1.001,1.366
2006/12/20,945,7624,14,27,17,10,0.998,1.773
2006/12/20,1045,7638,14,21,6,15,0.997,3.128
2006/12/20,1145,7664,25,41,8,33,0.994,2.072
2006/12/20,1245,7662,-2,23,16,7,0.995,1.825
2006/12/20,1345,7662,0,30,4,26,0.995,1.386
2006/12/21,945,7695,21,40,15,25,0.992,0.511
2006/12/21,1045,7650,-45,63,44,19,0.998,0.474
2006/12/21,1145,7656,5,27,18,9,0.998,1.126
2006/12/21,1245,7663,7,28,18,10,0.998,1.147
2006/12/21,1345,7642,-21,42,17,25,1.001,0.509
2006/12/22,945,7634,-2,39,30,9,1.002,0.764
2006/12/22,1045,7649,17,29,6,23,1.001,1.259
2006/12/22,1145,7670,22,25,3,22,0.998,1.258
2006/12/22,1245,7667,-3,19,12,7,0.998,1.809
2006/12/22,1345,7692,25,29,-2,31,0.995,1.031
2006/12/25,945,7672,8,27,11,16,0.998,1.074
2006/12/25,1045,7684,12,21,5,16,0.996,1.954
2006/12/25,1145,7688,4,25,10,15,0.996,1.671
2006/12/25,1245,7683,-4,18,7,11,0.997,2.404
2006/12/25,1345,7679,-4,11,8,3,0.998,2.375
2006/12/26,945,7761,81,95,8,87,0.988,0.425
2006/12/26,1045,7778,17,29,7,22,0.987,0.865
2006/12/26,1145,7784,5,26,18,8,0.988,0.923
2006/12/26,1245,7770,-14,27,22,5,0.991,1.208
2006/12/26,1345,7789,21,21,-3,24,0.99,0.851
2006/12/27,945,7821,23,45,24,21,0.988,0.633
2006/12/27,1045,7811,-11,32,28,4,0.991,1.179
2006/12/27,1145,7816,4,18,9,9,0.992,1.7
2006/12/27,1245,7822,7,23,13,10,0.993,1.424
2006/12/27,1345,7795,-28,46,29,17,0.998,0.71
2006/12/28,945,7787,-35,72,53,19,1.001,0.623
2006/12/28,1045,7765,-23,46,27,19,1.004,0.78
2006/12/28,1145,7783,18,31,14,17,1.002,1.082
2006/12/28,1245,7796,12,23,12,11,1,1.27
2006/12/28,1345,7800,4,19,0,19,1,1.297
2006/12/29,945,7813,3,22,2,20,0.998,1.163
2006/12/29,1045,7847,34,53,19,34,0.994,0.62
2006/12/29,1145,7848,2,21,8,13,0.994,1.712
2006/12/29,1245,7876,28,34,7,27,0.991,0.993
2006/12/29,1345,7880,4,28,8,20,0.991,0.866
2007/1/2,945,7929,49,55,9,46,0.986,0.839
2007/1/2,1045,7965,34,65,21,44,0.983,0.727
2007/1/2,1145,7963,-2,23,15,8,0.986,1.843
2007/1/2,1245,7982,19,25,3,22,0.986,2.036
2007/1/2,1345,7988,9,26,4,22,0.987,0.983
2007/1/3,945,7988,-20,53,47,6,0.99,0.69
2007/1/3,1045,7986,-2,42,9,33,0.992,0.774
2007/1/3,1145,8003,17,23,7,16,0.992,1.43
2007/1/3,1245,7990,-13,41,23,18,0.995,1.112
2007/1/3,1345,7989,-1,32,11,21,0.997,1.005
2007/1/4,945,7980,7,40,16,24,0.999,0.928
2007/1/4,1045,7962,-18,42,16,26,1.002,0.781
2007/1/4,1145,7991,29,39,4,35,0.999,1.15
2007/1/4,1245,7977,-13,27,18,9,1.001,1.406
2007/1/4,1345,7976,-2,25,7,18,1.001,1.277
2007/1/5,945,7874,-101,132,115,17,1.013,0.408
2007/1/5,1045,7863,-11,34,21,13,1.013,0.887
2007/1/5,1145,7861,-2,52,19,33,1.012,0.833
2007/1/5,1245,7855,-6,24,21,3,1.011,1.808
2007/1/5,1345,7830,-27,27,27,0,1.012,1.188
2007/1/8,945,7787,-12,56,21,35,1.016,0.723
2007/1/8,1045,7780,-7,35,17,18,1.014,1.296
2007/1/8,1145,7776,-4,22,9,13,1.012,2.191
2007/1/8,1245,7750,-27,23,30,-7,1.013,2.361
2007/1/8,1345,7736,-14,51,41,10,1.012,0.864
2007/1/9,945,7807,57,41,-8,49,1,0.852
2007/1/9,1045,7824,17,32,11,21,0.997,0.907
2007/1/9,1145,7799,-24,38,36,2,1,1.125
2007/1/9,1245,7787,-12,41,22,19,1,1.035
2007/1/9,1345,7822,36,46,4,42,0.995,1.108
2007/1/10,945,7697,-42,86,64,22,1.01,0.41
2007/1/10,1045,7700,3,27,17,10,1.009,1.445
2007/1/10,1145,7701,0,36,5,31,1.008,1.168
2007/1/10,1245,7690,-11,19,15,4,1.008,2.301
2007/1/10,1345,7693,2,33,20,13,1.007,1.122
2007/1/11,945,7725,0,27,13,14,1.002,0.849
2007/1/11,1045,7675,-50,79,54,25,1.008,0.751
2007/1/11,1145,7698,23,39,11,28,1.003,1.385
2007/1/11,1245,7602,-95,93,97,-4,1.014,0.771
2007/1/11,1345,7626,26,24,0,24,1.009,0.99
2007/1/12,945,7714,25,34,11,23,0.996,0.696
2007/1/12,1045,7763,50,65,3,62,0.99,0.851
2007/1/12,1145,7772,7,30,14,16,0.99,1.131
2007/1/12,1245,7779,7,31,14,17,0.99,1.521
2007/1/12,1345,7786,7,21,9,12,0.99,1.314
2007/1/15,945,7805,-11,49,28,21,0.989,0.993
2007/1/15,1045,7769,-36,62,39,23,0.995,0.968
2007/1/15,1145,7782,13,36,15,21,0.994,1.349
2007/1/15,1245,7794,12,23,4,19,0.994,2.023
2007/1/15,1345,7804,11,22,0,22,0.995,1.403
2007/1/16,945,7832,8,60,13,47,0.993,0.828
2007/1/16,1045,7820,-12,37,27,10,0.996,0.966
2007/1/16,1145,7805,-15,32,30,2,0.999,1.068
2007/1/16,1245,7805,-1,26,11,15,0.999,1.112
2007/1/16,1345,7815,11,27,0,27,0.998,1.572
2007/1/17,945,7769,13,32,-3,35,1.003,0.904
2007/1/17,1045,7799,32,44,10,34,0.999,1.366
2007/1/17,1145,7837,38,44,2,42,0.995,1.498
2007/1/17,1245,7848,11,27,8,19,0.994,1.476
2007/1/17,1345,7835,-13,28,14,14,0.996,1.498
2007/1/18,945,7857,-7,45,28,17,0.994,0.496
2007/1/18,1045,7895,38,60,11,49,0.989,0.659
2007/1/18,1145,7882,-13,30,28,2,0.992,1.083
2007/1/18,1245,7890,7,29,0,29,0.992,1.005
2007/1/18,1345,7922,31,54,8,46,0.989,0.709
2007/1/19,945,7886,6,35,18,17,0.995,0.814
2007/1/19,1045,7877,-9,27,12,15,0.998,1.03
2007/1/19,1145,7882,5,20,5,15,0.998,1.937
2007/1/19,1245,7893,11,39,28,11,0.997,0.846
2007/1/19,1345,7862,-32,46,40,6,1.002,0.932
2007/1/22,945,7806,-60,105,79,26,1.009,0.529
2007/1/22,1045,7818,13,33,7,26,1.007,1.096
2007/1/22,1145,7857,39,51,-8,59,1.001,1
2007/1/22,1245,7879,19,48,24,24,0.998,0.832
2007/1/22,1345,7885,6,21,0,21,0.997,1.66
2007/1/23,945,7859,10,49,16,33,1,0.939
2007/1/23,1045,7854,-4,47,38,9,1,1.112
2007/1/23,1145,7866,11,27,3,24,0.998,1.854
2007/1/23,1245,7855,-11,29,20,9,1,2.357
2007/1/23,1345,7885,31,36,3,33,0.995,1.485
2007/1/24,945,7968,8,24,22,2,0.986,0.686
2007/1/24,1045,7963,-5,16,11,5,0.989,1.641
2007/1/24,1145,7969,6,24,9,15,0.99,1.81
2007/1/24,1245,7987,18,26,9,17,0.989,1.641
2007/1/24,1345,7993,6,16,-2,18,0.989,1.235
2007/1/25,945,7993,-37,46,33,13,0.992,0.578
2007/1/25,1045,7986,-8,26,17,9,0.994,1.253
2007/1/25,1145,7991,6,16,8,8,0.995,1.93
2007/1/25,1245,7973,-18,32,29,3,0.999,1.224
2007/1/25,1345,7975,3,16,1,15,1,0.886
2007/1/26,945,7910,10,40,5,35,1.008,0.498
2007/1/26,1045,7890,-20,23,21,2,1.01,1.094
2007/1/26,1145,7857,-34,46,29,17,1.013,0.519
2007/1/26,1245,7839,-17,43,15,28,1.014,0.805
2007/1/26,1345,7837,-3,22,15,7,1.012,1.09
2007/1/29,945,7847,22,32,10,22,1.008,1.367
2007/1/29,1045,7805,-42,60,48,12,1.012,0.869
2007/1/29,1145,7800,-5,35,0,35,1.01,0.954
2007/1/29,1245,7782,-18,24,19,5,1.01,2.507
2007/1/29,1345,7787,5,38,7,31,1.007,1.051
2007/1/30,945,7770,-28,43,35,8,1.008,0.937
2007/1/30,1045,7770,-1,31,13,18,1.006,0.98
2007/1/30,1145,7793,23,33,5,28,1.002,1.193
2007/1/30,1245,7788,-4,26,16,10,1.001,1.43
2007/1/30,1345,7769,-19,29,23,6,1.003,0.902
2007/1/31,945,7775,6,32,18,14,1.002,0.892
2007/1/31,1045,7728,-47,58,51,7,1.007,0.636
2007/1/31,1145,7691,-37,47,46,1,1.011,0.708
2007/1/31,1245,7675,-19,55,18,37,1.011,0.61
2007/1/31,1345,7734,58,80,8,72,1.002,0.841
2007/2/1,945,7769,-5,35,17,18,0.998,0.969
2007/2/1,1045,7742,-24,43,38,5,1.001,1.381
2007/2/1,1145,7736,-7,36,21,15,1.001,1.248
2007/2/1,1245,7709,-28,54,37,17,1.004,0.957
2007/2/1,1345,7740,32,41,4,37,0.999,1.217
2007/2/2,945,7818,33,49,12,37,0.989,0.704
2007/2/2,1045,7822,5,33,17,16,0.989,1.097
2007/2/2,1145,7822,0,20,10,10,0.991,2.22
2007/2/2,1245,7805,-17,32,20,12,0.994,1.323
2007/2/2,1345,7810,3,22,10,12,0.995,1.427
2007/2/5,945,7802,32,40,6,34,0.996,1.075
2007/2/5,1045,7806,4,32,14,18,0.996,1.569
2007/2/5,1145,7810,4,31,26,5,0.997,1.139
2007/2/5,1245,7798,-12,40,17,23,0.999,0.908
2007/2/5,1345,7779,-19,25,23,2,1.003,1.386
2007/2/6,945,7805,14,25,20,5,0.999,0.747
2007/2/6,1045,7814,8,23,5,18,0.998,1.419
2007/2/6,1145,7851,37,45,11,34,0.993,0.543
2007/2/6,1245,7856,4,15,0,15,0.993,1.59
2007/2/6,1345,7889,34,41,7,34,0.99,0.668
2007/2/7,945,7872,-14,34,27,7,0.993,1.052
2007/2/7,1045,7885,13,27,5,22,0.992,1.846
2007/2/7,1145,7875,-9,16,9,7,0.995,1.792
2007/2/7,1245,7870,-6,23,14,9,0.996,1.482
2007/2/7,1345,7868,-2,14,6,8,0.997,1.429
2007/2/8,945,7893,3,19,14,5,0.995,0.781
2007/2/8,1045,7832,-59,72,60,12,1.004,0.483
2007/2/8,1145,7836,6,26,12,14,1.004,1.059
2007/2/8,1245,7830,-7,43,16,27,1.004,0.768
2007/2/8,1345,7870,40,65,11,54,0.999,0.743
2007/2/9,945,7860,-15,38,23,15,1,0.968
2007/2/9,1045,7902,43,69,23,46,0.995,0.657
2007/2/9,1145,7877,-26,27,32,-5,0.998,1.834
2007/2/9,1245,7887,10,33,21,12,0.997,1.343
2007/2/9,1345,7884,0,20,6,14,0.997,1.268
2007/2/12,945,7815,-25,39,29,10,1.006,0.78
2007/2/12,1045,7806,-9,34,12,22,1.006,0.912
2007/2/12,1145,7807,0,19,9,10,1.005,1.966
2007/2/12,1245,7807,-1,25,10,15,1.005,1.593
2007/2/12,1345,7792,-15,19,23,-4,1.007,1.328
2007/2/13,945,7815,30,29,15,14,1.003,1.11
2007/2/13,1045,7770,-45,46,51,-5,1.008,0.948
2007/2/13,1145,7760,-9,31,13,18,1.007,0.756
2007/2/13,1245,7801,41,57,9,48,1.001,0.911
2007/2/13,1345,7743,-57,54,61,-7,1.007,0.79
2007/2/14,945,7793,-16,36,19,17,1,0.803
2007/2/14,1045,7794,0,14,6,8,1,1.524
2007/2/14,1145,7813,19,28,6,22,0.997,1.448
2007/2/14,1245,7829,17,33,12,21,0.995,1.096
2007/2/14,1345,7833,4,26,8,18,0.995,1.224
2007/2/26,945,7933,32,23,12,11,0.984,1.069
2007/2/26,1045,7933,-2,11,1,10,0.985,2.736
2007/2/26,1145,7932,0,9,5,4,0.987,2.272
2007/2/26,1245,7914,-19,16,17,-1,0.992,2.846
2007/2/26,1345,7899,-15,16,21,-5,0.995,1.897
2007/2/27,945,7959,34,51,9,42,0.989,0.467
2007/2/27,1045,7947,-12,33,23,10,0.993,0.583
2007/2/27,1145,7932,-14,30,24,6,0.997,0.952
2007/2/27,1245,7926,-5,22,7,15,0.999,0.724
2007/2/27,1345,7925,-1,21,13,8,1,1.049
2007/3/1,945,7739,-7,35,32,3,1.022,0.38
2007/3/1,1045,7679,-61,68,49,19,1.028,0.467
2007/3/1,1145,7680,2,47,23,24,1.024,1.019
2007/3/1,1245,7678,-2,26,9,17,1.021,1.428
2007/3/1,1345,7660,-19,43,35,8,1.021,1.095
2007/3/2,945,7645,24,45,12,33,1.019,0.923
2007/3/2,1045,7659,15,30,16,14,1.013,1.247
2007/3/2,1145,7687,27,38,6,32,1.005,1.577
2007/3/2,1245,7672,-15,29,22,7,1.004,1.633
2007/3/2,1345,7668,-4,22,9,13,1.001,1.615
2007/3/3,945,7602,-13,52,38,14,1.008,0.757
2007/3/3,1045,7616,14,25,1,24,1.004,1.274
2007/3/3,1145,7588,-29,39,29,10,1.007,1.274
2007/3/3,1245,7566,-22,38,28,10,1.009,0.756
2007/3/3,1345,7589,23,41,17,24,1.005,0.914
2007/3/5,945,7502,-43,45,33,12,1.015,0.657
2007/3/5,1045,7502,1,33,10,23,1.013,0.853
2007/3/5,1145,7430,-73,80,73,7,1.021,0.692
2007/3/5,1245,7354,-75,162,78,84,1.028,0.458
2007/3/5,1345,7285,-70,97,84,13,1.033,0.73
2007/3/6,945,7362,27,55,13,42,1.019,0.85
2007/3/6,1045,7352,-8,32,17,15,1.017,1.627
2007/3/6,1145,7379,27,43,8,35,1.01,1.582
2007/3/6,1245,7397,18,34,3,31,1.004,1.985
2007/3/6,1345,7409,11,32,16,16,1,1.268
2007/3/7,945,7387,-56,66,62,4,1.002,0.778
2007/3/7,1045,7415,28,30,0,30,0.997,1.535
2007/3/7,1145,7466,51,46,1,45,0.989,1.1
2007/3/7,1245,7447,-17,32,22,10,0.992,1.054
2007/3/7,1345,7427,-19,42,30,12,0.996,1.116
2007/3/8,945,7474,43,68,11,57,0.991,0.817
2007/3/8,1045,7456,-19,36,23,13,0.995,1.193
2007/3/8,1145,7475,19,27,5,22,0.993,1.751
2007/3/8,1245,7490,15,28,14,14,0.993,0.931
2007/3/8,1345,7523,31,49,11,38,0.99,0.77
2007/3/9,945,7514,-18,59,52,7,0.992,0.79
2007/3/9,1045,7502,-13,40,30,10,0.995,1.115
2007/3/9,1145,7513,12,28,7,21,0.995,1.721
2007/3/9,1245,7511,-2,31,26,5,0.996,1.492
2007/3/9,1345,7517,6,29,16,13,0.996,1.519
2007/3/12,945,7556,-4,36,21,15,0.992,1.019
2007/3/12,1045,7585,29,35,6,29,0.99,1.029
2007/3/12,1145,7576,-8,19,10,9,0.993,1.778
2007/3/12,1245,7573,-3,16,10,6,0.994,2.16
2007/3/12,1345,7595,21,32,0,32,0.993,1.055
2007/3/13,945,7612,12,44,13,31,0.991,0.666
2007/3/13,1045,7613,0,26,20,6,0.992,0.924
2007/3/13,1145,7618,4,11,7,4,0.993,2.064
2007/3/13,1245,7625,7,20,3,17,0.994,1.548
2007/3/13,1345,7624,-1,20,19,1,0.995,0.877
2007/3/14,945,7465,-53,61,31,30,1.016,0.337
2007/3/14,1045,7469,6,26,5,21,1.014,1.042
2007/3/14,1145,7471,3,20,15,5,1.012,1.277
2007/3/14,1245,7472,1,20,11,9,1.011,1.578
2007/3/14,1345,7469,-3,18,8,10,1.01,0.906
2007/3/15,945,7618,86,98,17,81,0.989,0.491
2007/3/15,1045,7654,34,43,16,27,0.985,0.813
2007/3/15,1145,7662,7,34,15,19,0.984,1.675
2007/3/15,1245,7662,1,18,12,6,0.985,2.295
2007/3/15,1345,7652,-11,25,24,1,0.986,1.472
2007/3/16,945,7654,57,63,9,54,0.987,0.838
2007/3/16,1045,7624,-30,37,28,9,0.994,1.15
2007/3/16,1145,7658,34,33,0,33,0.991,1.623
2007/3/16,1245,7710,51,61,14,47,0.987,0.656
2007/3/16,1345,7666,-44,51,47,4,0.996,1.042
2007/3/19,945,7672,-26,49,37,12,0.997,0.957
2007/3/19,1045,7701,28,34,11,23,0.994,1.018
2007/3/19,1145,7726,25,32,4,28,0.991,1.035
2007/3/19,1245,7714,-13,23,17,6,0.994,1.683
2007/3/19,1345,7710,-4,31,19,12,0.995,1.187
2007/3/20,945,7748,-2,30,24,6,0.992,0.835
2007/3/20,1045,7747,-2,27,10,17,0.993,1.158
2007/3/20,1145,7749,1,16,7,9,0.995,1.962
2007/3/20,1245,7731,-18,34,21,13,0.998,1.316
2007/3/20,1345,7721,-10,34,16,18,1,1.27
2007/3/21,945,7739,-11,31,22,9,0.998,1.402
2007/3/21,1045,7731,-8,30,14,16,1,1.736
2007/3/21,1145,7734,3,19,12,7,1,1.722
2007/3/21,1245,7741,6,12,4,8,0.999,2.438
2007/3/21,1345,7753,12,17,-1,18,0.998,0.986
2007/3/22,945,7835,9,43,21,22,0.989,0.321
2007/3/22,1045,7831,-4,18,13,5,0.99,1.007
2007/3/22,1145,7821,-10,16,14,2,0.993,1.135
2007/3/22,1245,7832,12,15,4,11,0.992,1.44
2007/3/22,1345,7829,-3,16,12,4,0.994,0.963
2007/3/23,945,7814,-26,30,21,9,0.997,0.844
2007/3/23,1045,7864,50,70,9,61,0.991,0.665
2007/3/23,1145,7880,16,37,14,23,0.991,0.622
2007/3/23,1245,7874,-6,20,9,11,0.994,1.51
2007/3/23,1345,7855,-19,45,22,23,0.998,0.87
2007/3/26,945,7881,7,39,2,37,0.995,0.951
2007/3/26,1045,7872,-9,31,19,12,0.997,1.484
2007/3/26,1145,7888,15,19,-3,22,0.995,1.944
2007/3/26,1245,7880,-8,16,7,9,0.997,2.129
2007/3/26,1345,7883,4,9,-1,10,0.997,2.499
2007/3/27,945,7923,65,73,10,63,0.993,0.608
2007/3/27,1045,7922,-1,34,18,16,0.994,0.669
2007/3/27,1145,7914,-9,20,15,5,0.996,1.373
2007/3/27,1245,7861,-54,76,55,21,1.003,0.45
2007/3/27,1345,7824,-37,48,36,12,1.008,0.655
2007/3/28,945,7789,-27,55,44,11,1.011,0.611
2007/3/28,1045,7789,-1,22,18,4,1.01,1.555
2007/3/28,1145,7766,-24,49,39,10,1.012,0.801
2007/3/28,1245,7740,-27,34,30,4,1.014,1.024
2007/3/28,1345,7750,8,23,13,10,1.011,1.433
2007/3/29,945,7750,15,65,19,46,1.009,0.785
2007/3/29,1045,7778,27,44,6,38,1.003,1.142
2007/3/29,1145,7796,18,29,-1,30,0.999,1.78
2007/3/29,1245,7822,26,51,27,24,0.994,0.823
2007/3/29,1345,7838,15,42,17,25,0.992,0.886
2007/3/30,945,7861,11,33,17,16,0.989,0.933
2007/3/30,1045,7848,-12,43,20,23,0.992,1.322
2007/3/30,1145,7803,-44,61,52,9,0.998,0.982
2007/3/30,1245,7816,13,25,12,13,0.997,1.569
2007/3/30,1345,7834,18,38,19,19,0.996,1.118
2007/4/2,945,7861,-2,63,14,49,0.994,0.863
2007/4/2,1045,7906,48,59,9,50,0.99,0.64
2007/4/2,1145,7900,-6,25,14,11,0.992,1.948
2007/4/2,1245,7879,-18,33,20,13,0.996,1.182
2007/4/2,1345,7849,-30,50,37,13,1.001,0.898
2007/4/3,945,7877,10,63,11,52,0.997,0.802
2007/4/3,1045,7866,-12,23,19,4,0.999,1.623
2007/4/3,1145,7860,-6,38,13,25,1,1.07
2007/4/3,1245,7890,29,43,5,38,0.997,1.176
2007/4/3,1345,7919,32,43,2,41,0.994,0.927
2007/4/4,945,7978,-2,31,22,9,0.988,0.633
2007/4/4,1045,7969,-8,26,13,13,0.991,1.327
2007/4/4,1145,7996,27,31,-2,33,0.988,1.66
2007/4/4,1245,7997,4,25,11,14,0.989,0.901
2007/4/4,1345,7999,1,23,13,10,0.991,0.868
2007/4/9,945,8050,11,33,15,18,0.986,0.816
2007/4/9,1045,8051,0,27,2,25,0.988,1.345
2007/4/9,1145,8058,6,17,6,11,0.99,1.662
2007/4/9,1245,8054,-5,16,15,1,0.993,2.109
2007/4/9,1345,8072,18,26,0,26,0.993,1.133
2007/4/10,945,8050,-4,26,12,14,0.996,1.098
2007/4/10,1045,8036,-14,32,18,14,0.999,1.047
2007/4/10,1145,8028,-7,32,9,23,1.001,0.843
2007/4/10,1245,8043,15,29,10,19,0.999,0.918
2007/4/10,1345,8053,10,28,13,15,0.999,0.949
2007/4/11,945,8099,24,41,6,35,0.993,0.702
2007/4/11,1045,8088,-12,19,15,4,0.995,1.304
2007/4/11,1145,8091,3,21,15,6,0.995,1.202
2007/4/11,1245,8072,-18,55,28,27,0.998,0.655
2007/4/11,1345,8095,22,29,0,29,0.996,1.092
2007/4/12,945,8063,25,33,12,21,0.999,0.91
2007/4/12,1045,8076,13,27,6,21,0.998,1.301
2007/4/12,1145,8085,9,22,9,13,0.997,1.24
2007/4/12,1245,8082,-4,18,2,16,0.998,1.405
2007/4/12,1345,8077,-5,16,13,3,1,1.152
2007/4/13,945,8045,-51,67,53,14,1.004,0.497
2007/4/13,1045,8050,4,31,21,10,1.002,1.024
2007/4/13,1145,8026,-24,36,25,11,1.005,0.752
2007/4/13,1245,8006,-19,42,22,20,1.007,0.652
2007/4/13,1345,7990,-16,34,17,17,1.008,0.998
2007/4/14,945,8015,-5,27,21,6,1.004,1.217
2007/4/14,1045,8027,11,17,3,14,1.002,3.233
2007/4/14,1145,8038,12,17,-3,20,1,3.822
2007/4/14,1245,8034,-3,10,6,4,1,2.921
2007/4/14,1345,8067,32,30,-3,33,0.996,1.401
2007/4/16,945,8083,5,31,12,19,0.993,0.72
2007/4/16,1045,8041,-42,68,49,19,0.999,0.666
2007/4/16,1145,8047,6,23,15,8,0.998,1.175
2007/4/16,1245,8068,21,45,8,37,0.996,0.793
2007/4/16,1345,8057,-11,21,14,7,0.998,0.846
2007/4/17,945,8094,-6,32,14,18,0.994,0.602
2007/4/17,1045,8046,-48,57,47,10,1.001,0.707
2007/4/17,1145,7978,-67,82,58,24,1.01,0.559
2007/4/17,1245,7968,-10,25,22,3,1.011,1.197
2007/4/17,1345,7964,-4,30,21,9,1.01,1.052
2007/4/18,945,7973,-19,46,16,30,1.008,1.589
2007/4/18,1045,7970,-2,30,11,19,1.007,1.608
2007/4/18,1145,7983,12,29,16,13,1.005,2.074
2007/4/18,1245,7972,-11,23,18,5,1.005,3.761
2007/4/18,1345,8010,37,39,0,39,0.999,1.514
2007/4/19,945,7925,-42,71,56,15,1.008,0.42
2007/4/19,1045,7866,-60,62,56,6,1.014,0.53
2007/4/19,1145,7866,0,33,22,11,1.011,1.11
2007/4/19,1245,7859,-7,38,16,22,1.011,0.883
2007/4/19,1345,7839,-19,38,26,12,1.012,0.854
2007/4/20,945,7891,-4,30,8,22,1.004,0.844
2007/4/20,1045,7897,6,24,7,17,1.002,1.837
2007/4/20,1145,7882,-15,27,25,2,1.003,1.806
2007/4/20,1245,7891,10,17,6,11,1.001,2.798
2007/4/20,1345,7887,-6,20,24,-4,1,1.791
2007/4/23,945,7996,16,22,8,14,0.987,0.796
2007/4/23,1045,8051,56,67,8,59,0.981,0.517
2007/4/23,1145,8040,-11,20,14,6,0.985,2.045
2007/4/23,1245,8016,-23,39,26,13,0.99,0.816
2007/4/23,1345,8016,-1,25,9,16,0.992,1.026
2007/4/24,945,8014,14,37,10,27,0.993,0.699
2007/4/24,1045,7983,-31,50,35,15,0.999,0.786
2007/4/24,1145,8007,23,28,1,27,0.997,1.601
2007/4/24,1245,8025,17,22,8,14,0.996,0.983
2007/4/24,1345,8038,13,28,7,21,0.996,1.085
2007/4/25,945,7972,-29,46,37,9,1.005,0.782
2007/4/25,1045,7993,22,57,15,42,1.002,0.703
2007/4/25,1145,7978,-16,27,17,10,1.003,1.358
2007/4/25,1245,7973,-5,28,16,12,1.003,1.42
2007/4/25,1345,7960,-13,19,12,7,1.004,1.276
2007/4/26,945,8016,-21,30,19,11,0.997,0.91
2007/4/26,1045,7997,-19,34,27,7,1,1.351
2007/4/26,1145,8003,8,36,6,30,0.999,0.919
2007/4/26,1245,8002,-1,17,13,4,0.999,1.756
2007/4/26,1345,8002,0,16,9,7,0.999,1.49
2007/4/27,945,7973,-28,51,44,7,1.003,0.66
2007/4/27,1045,7961,-13,27,9,18,1.004,0.746
2007/4/27,1145,7939,-22,40,21,19,1.006,0.839
2007/4/27,1245,7939,1,29,14,15,1.006,1.542
2007/4/27,1345,7946,6,23,4,19,1.005,1.144
2007/4/30,945,7864,-62,95,71,24,1.014,0.512
2007/4/30,1045,7839,-25,41,35,6,1.015,0.936
2007/4/30,1145,7835,-5,26,16,10,1.014,1.161
2007/4/30,1245,7844,9,24,11,13,1.01,2.347
2007/4/30,1345,7850,7,30,10,20,1.007,1.281
2007/5/2,945,7883,29,40,9,31,1.001,0.849
2007/5/2,1045,7911,29,30,13,17,0.997,0.793
2007/5/2,1145,7905,-7,28,13,15,0.997,1.491
2007/5/2,1245,7895,-10,27,24,3,0.998,1.62
2007/5/2,1345,7896,1,14,11,3,0.997,1.805
2007/5/3,945,7933,-10,37,26,11,0.992,0.628
2007/5/3,1045,7939,6,22,14,8,0.993,1.105
2007/5/3,1145,7866,-72,99,76,23,1.003,0.458
2007/5/3,1245,7884,19,29,3,26,1.001,1.433
2007/5/3,1345,7936,51,58,-3,61,0.995,0.859
2007/5/4,945,8005,32,45,8,37,0.988,0.609
2007/5/4,1045,8005,1,31,24,7,0.99,0.878
2007/5/4,1145,8015,11,17,3,14,0.989,2.48
2007/5/4,1245,8028,14,23,6,17,0.989,1.565
2007/5/4,1345,8057,29,55,23,32,0.987,0.821
2007/5/7,945,8089,-12,35,28,7,0.985,0.921
2007/5/7,1045,8105,16,32,9,23,0.985,1.719
2007/5/7,1145,8132,28,31,-3,34,0.984,1.34
2007/5/7,1245,8119,-11,24,13,11,0.989,1.726
2007/5/7,1345,8114,-4,26,6,20,0.992,1.32
2007/5/8,945,8091,-23,38,19,19,0.997,0.659
2007/5/8,1045,8085,-6,30,8,22,0.999,1.256
2007/5/8,1145,8082,-4,22,15,7,1,1.647
2007/5/8,1245,8117,34,41,6,35,0.997,0.985
2007/5/8,1345,8072,-43,52,45,7,1.003,0.833
2007/5/9,945,8059,-21,38,29,9,1.005,0.734
2007/5/9,1045,8071,12,30,13,17,1.003,1.401
2007/5/9,1145,8050,-22,54,44,10,1.005,0.746
2007/5/9,1245,8062,13,21,9,12,1.003,1.151
2007/5/9,1345,8068,7,21,-2,23,1.001,1.115
2007/5/10,945,8095,-3,25,20,5,0.998,0.967
2007/5/10,1045,8083,-11,27,16,11,0.999,1.052
2007/5/10,1145,8086,2,13,6,7,0.999,2.347
2007/5/10,1245,8095,8,14,7,7,0.998,1.512
2007/5/10,1345,8109,14,30,1,29,0.996,0.938
2007/5/11,945,8031,2,26,14,12,1.005,0.565
2007/5/11,1045,8024,-5,29,8,21,1.005,0.753
2007/5/11,1145,8026,2,23,14,9,1.004,1.527
2007/5/11,1245,8025,-1,18,11,7,1.004,1.432
2007/5/11,1345,8021,-5,20,19,1,1.004,1.213
2007/5/14,945,8032,-31,62,51,11,1.002,0.578
2007/5/14,1045,8051,21,22,2,20,0.999,1.049
2007/5/14,1145,8067,15,30,7,23,0.997,1.165
2007/5/14,1245,8054,-14,21,14,7,0.998,1.893
2007/5/14,1345,8044,-11,23,17,6,0.999,1.414
2007/5/15,945,8013,-11,43,26,17,1.003,0.678
2007/5/15,1045,7999,-14,31,16,15,1.004,0.622
2007/5/15,1145,7995,-5,14,13,1,1.005,1.342
2007/5/15,1245,7971,-26,37,24,13,1.007,0.713
2007/5/15,1345,7969,-1,26,7,19,1.007,0.966
2007/5/16,945,7987,55,36,6,30,1.003,1.354
2007/5/16,1045,7979,-7,16,10,6,1.003,2.853
2007/5/16,1145,7979,0,11,4,7,1.002,3.702
2007/5/16,1245,7984,4,10,1,9,1.001,2.469
2007/5/16,1345,7991,7,14,4,10,0.999,1.164
2007/5/17,945,8039,39,43,6,37,0.993,0.469
2007/5/17,1045,8046,7,17,12,5,0.992,0.571
2007/5/17,1145,8042,-4,9,9,0,0.993,2.054
2007/5/17,1245,8031,-11,11,9,2,0.995,1.387
2007/5/17,1345,8015,-17,22,20,2,0.998,0.776
2007/5/18,945,8019,4,24,17,7,0.998,0.842
2007/5/18,1045,8012,-7,16,5,11,1,1.105
2007/5/18,1145,8013,2,17,10,7,1,2.148
2007/5/18,1245,7996,-16,28,24,4,1.003,1.779
2007/5/18,1345,8030,35,58,-1,59,0.998,0.577
2007/5/21,945,8039,-11,57,34,23,0.998,0.664
2007/5/21,1045,8070,31,42,15,27,0.994,0.526
2007/5/21,1145,8112,43,44,2,42,0.989,0.649
2007/5/21,1245,8119,7,18,10,8,0.989,1.125
2007/5/21,1345,8122,4,20,13,7,0.99,1.142
2007/5/22,945,8169,37,46,-4,50,0.986,0.758
2007/5/22,1045,8160,-9,23,17,6,0.989,1.186
2007/5/22,1145,8139,-22,27,25,2,0.993,1.733
2007/5/22,1245,8145,6,25,12,13,0.994,1.959
2007/5/22,1345,8176,30,35,2,33,0.992,1.034
2007/5/23,945,8202,3,33,19,14,0.991,0.816
2007/5/23,1045,8198,-2,30,10,20,0.993,0.975
2007/5/23,1145,8200,2,15,5,10,0.994,2.082
2007/5/23,1245,8202,2,14,6,8,0.995,2.612
2007/5/23,1345,8204,2,26,2,24,0.996,1.039
2007/5/24,945,8199,11,31,0,31,0.997,0.664
2007/5/24,1045,8189,-5,33,24,9,0.999,0.798
2007/5/24,1145,8177,-13,23,19,4,1.001,1.649
2007/5/24,1245,8181,5,26,7,19,1.001,1.181
2007/5/24,1345,8170,-11,16,24,-8,1.002,1.507
2007/5/25,945,8109,-6,29,15,14,1.009,0.543
2007/5/25,1045,8117,8,15,3,12,1.007,1.469
2007/5/25,1145,8127,9,26,10,16,1.004,1.441
2007/5/25,1245,8130,4,16,12,4,1.003,1.363
2007/5/25,1345,8134,4,14,4,10,1.002,1.444
2007/5/28,945,8164,13,18,9,9,0.998,0.898
2007/5/28,1045,8155,-9,23,14,9,0.998,1.126
2007/5/28,1145,8150,-5,17,7,10,0.999,1.346
2007/5/28,1245,8155,5,17,9,8,0.998,2.242
2007/5/28,1345,8154,-2,18,10,8,0.997,1.42
2007/5/29,945,8196,43,60,12,48,0.993,0.442
2007/5/29,1045,8199,3,13,5,8,0.994,1.186
2007/5/29,1145,8179,-19,27,20,7,0.997,0.75
2007/5/29,1245,8146,-34,33,41,-8,1.002,0.933
2007/5/29,1345,8168,22,43,0,43,0.999,0.577
2007/5/30,945,8114,-49,77,48,29,1.006,0.394
2007/5/30,1045,8102,-11,24,21,3,1.007,1.192
2007/5/30,1145,8093,-8,26,20,6,1.007,1.214
2007/5/30,1245,8081,-10,21,17,4,1.008,1.13
2007/5/30,1345,8111,30,45,7,38,1.003,0.822
2007/5/31,945,8185,-14,25,14,11,0.995,0.671
2007/5/31,1045,8185,0,17,5,12,0.995,1.709
2007/5/31,1145,8189,4,12,4,8,0.994,2.859
2007/5/31,1245,8189,0,15,9,6,0.994,2.904
2007/5/31,1345,8171,-18,50,24,26,0.997,0.813
2007/6/1,945,8214,13,20,18,2,0.992,0.791
2007/6/1,1045,8216,2,17,8,9,0.993,2.504
2007/6/1,1145,8221,6,12,2,10,0.994,2.155
2007/6/1,1245,8243,23,29,4,25,0.993,0.884
2007/6/1,1345,8232,-10,24,20,4,0.996,0.834
2007/6/4,945,8272,7,25,15,10,0.992,0.737
2007/6/4,1045,8254,-18,33,19,14,0.995,0.801
2007/6/4,1145,8258,4,15,5,10,0.996,1.911
2007/6/4,1245,8258,1,12,11,1,0.996,2.779
2007/6/4,1345,8257,-1,14,8,6,0.997,1.277
2007/6/5,945,8258,11,41,13,28,0.998,0.569
2007/6/5,1045,8255,-3,20,9,11,0.999,1.726
2007/6/5,1145,8242,-13,31,14,17,1.001,0.814
2007/6/5,1245,8223,-19,31,24,7,1.003,1.063
2007/6/5,1345,8254,31,39,3,36,0.999,0.778
2007/6/6,945,8291,38,61,7,54,0.995,0.519
2007/6/6,1045,8297,6,19,9,10,0.994,0.743
2007/6/6,1145,8298,1,38,35,3,0.995,0.711
2007/6/6,1245,8293,-5,24,12,12,0.996,1.09
2007/6/6,1345,8285,-8,21,10,11,0.997,1.172
2007/6/7,945,8241,19,44,14,30,1.002,0.649
2007/6/7,1045,8247,6,15,4,11,1.001,1.894
2007/6/7,1145,8265,18,20,2,18,0.999,1.343
2007/6/7,1245,8290,25,32,7,25,0.996,1.174
2007/6/7,1345,8336,46,48,2,46,0.992,0.735
2007/6/8,945,8249,13,29,6,23,1.002,0.582
2007/6/8,1045,8275,26,46,9,37,0.998,0.961
2007/6/8,1145,8261,-14,23,20,3,1,2.007
2007/6/8,1245,8267,7,19,12,7,0.998,2.278
2007/6/8,1345,8276,8,21,5,16,0.997,1.355
2007/6/11,945,8305,4,18,16,2,0.994,0.958
2007/6/11,1045,8314,8,23,1,22,0.994,1.572
2007/6/11,1145,8303,-9,21,15,6,0.996,2.213
2007/6/11,1245,8303,0,13,6,7,0.997,2.529
2007/6/11,1345,8313,10,23,12,11,0.996,1.091
2007/6/12,945,8336,6,35,9,26,0.994,0.691
2007/6/12,1045,8323,-13,35,27,8,0.997,0.728
2007/6/12,1145,8321,0,21,4,17,0.997,1.054
2007/6/12,1245,8342,21,30,6,24,0.996,0.975
2007/6/12,1345,8338,-4,15,12,3,0.997,0.879
2007/6/13,945,8335,24,34,7,27,0.998,0.703
2007/6/13,1045,8342,7,29,11,18,0.997,0.877
2007/6/13,1145,8331,-11,18,16,2,0.999,1.856
2007/6/13,1245,8326,-5,18,17,1,1,1.941
2007/6/13,1345,8331,5,25,17,8,0.999,1.02
2007/6/14,945,8398,1,23,8,15,0.992,0.583
2007/6/14,1045,8394,-5,14,8,6,0.993,1.078
2007/6/14,1145,8408,14,20,5,15,0.993,1.134
2007/6/14,1245,8429,21,31,5,26,0.991,0.834
2007/6/14,1345,8443,14,24,10,14,0.991,0.701
2007/6/15,945,8496,5,26,4,22,0.986,0.785
2007/6/15,1045,8515,17,40,25,15,0.986,0.73
2007/6/15,1145,8528,12,22,7,15,0.987,1.313
2007/6/15,1245,8554,25,33,5,28,0.986,0.903
2007/6/15,1345,8595,41,44,-1,45,0.984,0.776
2007/6/20,945,8635,-8,42,40,2,0.982,0.866
2007/6/20,1045,8652,15,29,12,17,0.983,1.4
2007/6/20,1145,8665,13,16,0,16,0.985,1.952
2007/6/20,1245,8731,66,91,27,64,0.98,1.162
2007/6/20,1345,8770,39,84,46,38,0.979,0.548
2007/6/21,945,8716,-52,83,60,23,0.988,0.464
2007/6/21,1045,8754,38,49,6,43,0.987,1.215
2007/6/21,1145,8820,66,83,9,74,0.982,0.785
2007/6/21,1245,8861,38,112,36,76,0.981,0.503
2007/6/21,1345,8862,1,71,9,62,0.984,0.917
2007/6/22,945,8843,-37,55,42,13,0.989,0.913
2007/6/22,1045,8847,6,31,23,8,0.991,1.638
2007/6/22,1145,8848,2,22,17,5,0.993,3.337
2007/6/22,1245,8812,-33,69,39,30,0.999,0.845
2007/6/22,1345,8825,9,43,10,33,0.998,1.612
2007/6/23,945,8785,23,30,10,20,1.003,1.72
2007/6/23,1045,8791,6,22,6,16,1.003,3.52
2007/6/23,1145,8773,-18,28,22,6,1.005,2.586
2007/6/23,1245,8784,11,21,5,16,1.004,2.187
2007/6/23,1345,8770,-13,13,19,-6,1.004,2.382
2007/6/25,945,8889,99,124,26,98,0.99,0.42
2007/6/25,1045,8921,32,75,29,46,0.987,0.635
2007/6/25,1145,8941,21,46,15,31,0.985,1.223
2007/6/25,1245,8954,14,31,5,26,0.985,1.102
2007/6/25,1345,8913,-41,72,52,20,0.991,0.654
2007/6/26,945,8877,-24,83,58,25,0.997,0.503
2007/6/26,1045,8875,-2,32,12,20,0.998,1.403
2007/6/26,1145,8868,-6,36,15,21,1,1.176
2007/6/26,1245,8830,-39,60,48,12,1.005,1.431
2007/6/26,1345,8840,5,35,3,32,1.005,0.989
2007/6/27,945,8828,36,68,29,39,1.006,0.71
2007/6/27,1045,8798,-29,64,47,17,1.009,1.055
2007/6/27,1145,8800,2,36,28,8,1.007,1.343
2007/6/27,1245,8768,-31,48,44,4,1.009,1.12
2007/6/27,1345,8776,8,32,8,24,1.006,0.925
2007/6/28,945,8837,7,35,23,12,0.998,0.661
2007/6/28,1045,8830,-8,32,13,19,0.999,1.379
2007/6/28,1145,8814,-16,28,16,12,1,2.165
2007/6/28,1245,8833,20,42,1,41,0.997,1.193
2007/6/28,1345,8838,6,34,12,22,0.997,0.88
2007/6/29,945,8847,-21,44,41,3,0.996,0.914
2007/6/29,1045,8799,-48,69,55,14,1.002,0.746
2007/6/29,1145,8800,1,24,10,14,1.002,1.564
2007/6/29,1245,8813,18,47,12,35,1.001,1.169
2007/6/29,1345,8808,-5,49,22,27,1.002,0.967
2007/7/2,945,8773,-27,63,45,18,1.005,0.657
2007/7/2,1045,8803,33,44,2,42,1.001,1.51
2007/7/2,1145,8810,8,26,16,10,1,1.168
2007/7/2,1245,8850,38,58,16,42,0.995,0.934
2007/7/2,1345,8895,44,54,1,53,0.991,1.05
2007/7/3,945,8951,10,35,29,6,0.985,0.648
2007/7/3,1045,8965,13,24,14,10,0.985,1.311
2007/7/3,1145,8982,16,28,12,16,0.985,1.103
2007/7/3,1245,8965,-16,35,20,15,0.989,1.23
2007/7/3,1345,8972,6,22,8,14,0.99,1.518
2007/7/4,945,9061,33,53,19,34,0.982,0.534
2007/7/4,1045,9017,-45,84,72,12,0.991,0.606
2007/7/4,1145,9025,10,26,17,9,0.992,1.587
2007/7/4,1245,9050,25,38,2,36,0.992,1.582
2007/7/4,1345,9053,3,26,1,25,0.993,1.045
2007/7/5,945,9079,-44,61,30,31,0.993,0.759
2007/7/5,1045,9076,-3,29,19,10,0.994,1.279
2007/7/5,1145,9076,0,27,6,21,0.996,1.621
2007/7/5,1245,9094,20,24,6,18,0.995,1.464
2007/7/5,1345,9123,29,37,0,37,0.993,0.977
2007/7/6,945,9120,20,47,19,28,0.994,0.795
2007/7/6,1045,9117,-3,35,28,7,0.995,0.953
2007/7/6,1145,9096,-21,50,19,31,0.998,0.696
2007/7/6,1245,9117,22,39,11,28,0.997,1.171
2007/7/6,1345,9142,25,39,7,32,0.995,0.923
2007/7/9,945,9207,27,28,1,27,0.988,0.928
2007/7/9,1045,9248,41,58,16,42,0.985,0.824
2007/7/9,1145,9290,42,53,-5,58,0.983,1.272
2007/7/9,1245,9316,27,42,-1,43,0.982,0.97
2007/7/9,1345,9376,61,66,9,57,0.978,0.69
2007/7/10,945,9332,-56,78,50,28,0.986,0.636
2007/7/10,1045,9335,2,63,40,23,0.988,0.816
2007/7/10,1145,9328,-7,43,27,16,0.991,1.335
2007/7/10,1245,9351,23,23,-1,24,0.991,1.731
2007/7/10,1345,9336,-14,36,33,3,0.995,1.162
2007/7/11,945,9282,7,32,16,16,1.002,0.92
2007/7/11,1045,9266,-14,42,13,29,1.005,0.949
2007/7/11,1145,9279,12,19,-3,22,1.003,2.586
2007/7/11,1245,9277,-3,30,15,15,1.004,2.027
2007/7/11,1345,9226,-52,71,64,7,1.009,0.96
2007/7/12,945,9303,28,59,27,32,0.999,0.661
2007/7/12,1045,9317,15,55,18,37,0.997,0.825
2007/7/12,1145,9315,-2,43,30,13,0.997,1.035
2007/7/12,1245,9357,42,52,7,45,0.993,1.057
2007/7/12,1345,9323,-35,63,53,10,0.996,0.877
2007/7/13,945,9424,-64,89,81,8,0.988,0.537
2007/7/13,1045,9446,22,43,26,17,0.987,0.981
2007/7/13,1145,9469,23,50,11,39,0.987,1.54
2007/7/13,1245,9475,5,27,8,19,0.988,1.993
2007/7/13,1345,9458,-17,51,27,24,0.992,0.882
2007/7/16,945,9479,14,54,5,49,0.992,1.039
2007/7/16,1045,9503,25,44,5,39,0.991,1.303
2007/7/16,1145,9475,-26,55,35,20,0.996,1.09
2007/7/16,1245,9447,-29,66,45,21,1.001,1.001
2007/7/16,1345,9372,-75,85,83,2,1.01,0.659
2007/7/17,945,9343,-47,77,57,20,1.012,0.679
2007/7/17,1045,9403,59,64,-8,72,1.004,0.888
2007/7/17,1145,9410,8,28,4,24,1.003,1.054
2007/7/17,1245,9434,25,64,25,39,1,1.309
2007/7/17,1345,9524,89,98,9,89,0.99,0.898
2007/7/18,945,9537,57,96,8,88,0.989,1.407
2007/7/18,1045,9511,-24,67,39,28,0.992,1.477
2007/7/18,1145,9528,17,36,20,16,0.991,1.894
2007/7/18,1245,9489,-39,44,43,1,0.995,1.411
2007/7/18,1345,9480,-7,54,40,14,0.997,1.249
2007/7/19,945,9426,1,81,18,63,1.003,0.479
2007/7/19,1045,9436,10,40,16,24,1.002,0.852
2007/7/19,1145,9423,-13,34,37,-3,1.004,1.118
2007/7/19,1245,9398,-27,74,42,32,1.007,0.702
2007/7/19,1345,9419,21,44,2,42,1.004,1.13
2007/7/20,945,9445,-15,43,31,12,1.001,0.762
2007/7/20,1045,9455,11,35,15,20,0.999,1.326
2007/7/20,1145,9486,31,44,2,42,0.996,1.316
2007/7/20,1245,9482,-7,31,27,4,0.996,1.194
2007/7/20,1345,9545,63,57,0,57,0.989,0.848
2007/7/23,945,9528,23,51,12,39,0.992,0.844
2007/7/23,1045,9555,27,45,5,40,0.99,1.115
2007/7/23,1145,9546,-8,35,22,13,0.992,1.251
2007/7/23,1245,9540,-5,34,15,19,0.994,1.681
2007/7/23,1345,9549,9,32,15,17,0.994,1.326
2007/7/24,945,9578,28,46,17,29,0.992,0.823
2007/7/24,1045,9661,83,84,2,82,0.985,0.669
2007/7/24,1145,9677,15,48,17,31,0.986,1.052
2007/7/24,1245,9654,-23,80,44,36,0.99,0.707
2007/7/24,1345,9674,20,59,9,50,0.99,0.892
2007/7/25,945,9635,29,48,7,41,0.995,0.72
2007/7/25,1045,9650,17,41,6,35,0.994,1.209
2007/7/25,1145,9682,33,60,15,45,0.992,1.125
2007/7/25,1245,9700,17,45,15,30,0.992,1.257
2007/7/25,1345,9739,39,55,16,39,0.989,0.725
2007/7/26,945,9783,44,77,46,31,0.987,0.768
2007/7/26,1045,9764,-18,68,25,43,0.991,0.729
2007/7/26,1145,9711,-55,95,66,29,0.997,0.866
2007/7/26,1245,9649,-60,159,61,98,1.004,0.572
2007/7/26,1345,9546,-103,115,94,21,1.015,0.797
2007/7/27,945,9251,-69,132,47,85,1.044,0.543
2007/7/27,1045,9285,33,84,29,55,1.036,1.27
2007/7/27,1145,9266,-17,80,57,23,1.034,1.403
2007/7/27,1245,9234,-31,74,42,32,1.033,1.517
2007/7/27,1345,8981,-254,280,260,20,1.057,0.612
2007/7/30,945,8985,43,131,36,95,1.048,0.857
2007/7/30,1045,8968,-17,97,65,32,1.041,1.213
2007/7/30,1145,8975,7,59,34,25,1.031,1.747
2007/7/30,1245,8950,-23,122,32,90,1.026,0.935
2007/7/30,1345,8990,42,94,24,70,1.014,1.293
2007/7/31,945,9110,100,90,-4,94,0.997,0.871
2007/7/31,1045,9112,2,47,18,29,0.995,1.498
2007/7/31,1145,9167,57,63,3,60,0.987,1.529
2007/7/31,1245,9138,-32,74,58,16,0.989,1.38
2007/7/31,1345,9176,40,80,27,53,0.984,1.363
2007/8/1,945,9069,4,103,39,64,0.997,0.814
2007/8/1,1045,9104,34,54,25,29,0.994,1.568
2007/8/1,1145,8959,-146,192,153,39,1.012,0.646
2007/8/1,1245,8811,-147,335,184,151,1.029,0.455
2007/8/1,1345,8695,-115,195,140,55,1.041,0.766
2007/8/2,945,8804,-78,129,135,-6,1.026,0.829
2007/8/2,1045,8831,27,141,74,67,1.02,1.043
2007/8/2,1145,8720,-114,220,153,67,1.03,0.841
2007/8/2,1245,8759,39,180,-13,193,1.02,0.824
2007/8/2,1345,8880,123,213,43,170,1.002,1.021
2007/8/3,945,8985,17,57,38,19,0.989,1.332
2007/8/3,1045,9003,18,58,36,22,0.986,2.152
2007/8/3,1145,8975,-28,87,12,75,0.988,1.113
2007/8/3,1245,8989,14,55,8,47,0.987,2.408
2007/8/3,1345,8985,-4,62,22,40,0.989,1.713
2007/8/6,945,8812,112,120,28,92,1.006,1.362
2007/8/6,1045,8757,-55,107,57,50,1.013,1.404
2007/8/6,1145,8796,39,76,16,60,1.008,2.047
2007/8/6,1245,8806,12,68,18,50,1.007,1.606
2007/8/6,1345,8860,54,104,40,64,1.002,0.968
2007/8/7,945,8960,-39,63,45,18,0.991,1.037
2007/8/7,1045,8953,-7,47,19,28,0.991,1.375
2007/8/7,1145,8939,-14,35,21,14,0.992,1.915
2007/8/7,1245,8790,-148,153,144,9,1.009,0.571
2007/8/7,1345,8767,-21,108,109,-1,1.009,0.72
2007/8/8,945,8904,54,85,24,61,0.995,0.892
2007/8/8,1045,8927,22,51,31,20,0.994,1.164
2007/8/8,1145,8949,20,66,19,47,0.993,1.32
2007/8/8,1245,8990,41,52,15,37,0.99,1.125
2007/8/8,1345,9078,86,93,10,83,0.983,0.838
2007/8/9,945,9156,-4,53,32,21,0.976,0.938
2007/8/9,1045,9116,-40,76,38,38,0.983,0.938
2007/8/9,1145,9180,64,72,5,67,0.978,1.115
2007/8/9,1245,9159,-19,64,20,44,0.982,1.12
2007/8/9,1345,9136,-24,47,27,20,0.989,1.319
2007/8/10,945,8808,-52,83,61,22,1.026,0.604
2007/8/10,1045,8818,11,94,9,85,1.024,0.781
2007/8/10,1145,8793,-26,56,36,20,1.025,1.587
2007/8/10,1245,8883,90,103,14,89,1.013,1.17
2007/8/10,1345,8800,-82,97,85,12,1.021,0.939
2007/8/13,945,8928,32,85,32,53,1.004,0.93
2007/8/13,1045,8899,-29,44,40,4,1.005,1.71
2007/8/13,1145,8868,-31,77,51,26,1.006,1.163
2007/8/13,1245,8943,72,117,17,100,0.994,1.025
2007/8/13,1345,8925,-20,59,25,34,0.993,1.304
2007/8/14,945,8850,-10,70,45,25,1.002,0.91
2007/8/14,1045,8941,90,239,134,105,0.992,0.671
2007/8/14,1145,8961,24,66,43,23,0.991,1.216
2007/8/14,1245,8931,-31,71,52,19,0.996,1.055
2007/8/14,1345,8885,-46,63,60,3,1.002,0.963
2007/8/15,945,8750,40,71,24,47,1.015,1.504
2007/8/15,1045,8701,-46,50,63,-13,1.019,2.752
2007/8/15,1145,8680,-22,71,46,25,1.019,1.517
2007/8/15,1245,8627,-52,102,66,36,1.023,1.485
2007/8/15,1345,8570,-58,82,63,19,1.026,1.332
2007/8/16,945,8182,-118,158,137,21,1.068,0.461
2007/8/16,1045,8198,16,230,22,208,1.058,0.388
2007/8/16,1145,8120,-78,128,96,32,1.059,0.76
2007/8/16,1245,8130,16,124,66,58,1.047,0.868
2007/8/16,1345,8154,32,66,3,63,1.034,1.031
2007/8/17,945,8170,69,122,40,82,1.025,0.694
2007/8/17,1045,8140,-30,118,79,39,1.022,1.118
2007/8/17,1145,8023,-117,184,131,53,1.029,0.895
2007/8/17,1245,7842,-178,228,196,32,1.045,0.903
2007/8/17,1345,7885,45,200,145,55,1.029,1.044
2007/8/20,945,8297,82,85,20,65,0.977,0.986
2007/8/20,1045,8308,11,50,2,48,0.977,1.851
2007/8/20,1145,8387,79,132,41,91,0.969,0.998
2007/8/20,1245,8415,28,49,10,39,0.969,2.277
2007/8/20,1345,8428,13,45,7,38,0.971,1.393
2007/8/21,945,8407,-13,85,53,32,0.977,0.868
2007/8/21,1045,8470,68,117,45,72,0.973,0.838
2007/8/21,1145,8442,-30,106,40,66,0.98,0.942
2007/8/21,1245,8331,-114,120,109,11,0.998,1.011
2007/8/21,1345,8365,32,87,34,53,1,1.109
2007/8/22,945,8385,19,53,38,15,0.999,1.271
2007/8/22,1045,8390,3,88,45,43,1,0.991
2007/8/22,1145,8383,-8,60,32,28,1.002,1.733
2007/8/22,1245,8405,22,46,8,38,0.999,2.198
2007/8/22,1345,8437,32,45,13,32,0.995,1.16
2007/8/23,945,8676,-24,45,27,18,0.971,0.831
2007/8/23,1045,8655,-23,55,40,15,0.977,1.37
2007/8/23,1145,8649,-7,43,29,14,0.979,1.992
2007/8/23,1245,8643,-6,31,24,7,0.982,2.4
2007/8/23,1345,8687,42,58,10,48,0.981,1.116
2007/8/24,945,8628,-32,64,33,31,0.991,0.828
2007/8/24,1045,8615,-12,38,32,6,0.995,1.484
2007/8/24,1145,8595,-20,42,37,5,1,1.713
2007/8/24,1245,8619,23,40,5,35,1,1.53
2007/8/24,1345,8600,-19,35,42,-7,1.005,0.888
2007/8/27,945,8740,-10,53,38,15,0.989,0.783
2007/8/27,1045,8753,14,29,3,26,0.988,1.283
2007/8/27,1145,8715,-40,49,42,7,0.994,1.243
2007/8/27,1245,8686,-29,48,36,12,0.998,1.007
2007/8/27,1345,8637,-50,64,47,17,1.004,0.847
2007/8/28,945,8671,28,69,15,54,1,0.708
2007/8/28,1045,8692,22,49,3,46,0.998,0.951
2007/8/28,1145,8670,-18,50,40,10,1.001,0.97
2007/8/28,1245,8612,-58,58,56,2,1.009,0.869
2007/8/28,1345,8680,68,80,-5,85,1.001,0.85
2007/8/29,945,8460,-10,57,43,14,1.024,0.644
2007/8/29,1045,8478,18,53,12,41,1.018,1.146
2007/8/29,1145,8479,-2,32,15,17,1.015,1.663
2007/8/29,1245,8500,21,40,16,24,1.01,1.215
2007/8/29,1345,8549,49,68,19,49,1.002,0.76
2007/8/30,945,8705,8,56,19,37,0.984,0.682
2007/8/30,1045,8695,-11,35,15,20,0.986,1.586
2007/8/30,1145,8694,-2,34,23,11,0.986,1.659
2007/8/30,1245,8715,21,56,11,45,0.984,1.266
2007/8/30,1345,8700,-13,67,62,5,0.987,0.67
2007/8/31,945,8764,4,42,6,36,0.983,1.03
2007/8/31,1045,8790,26,42,17,25,0.983,0.879
2007/8/31,1145,8843,53,71,15,56,0.981,0.916
2007/8/31,1245,8877,33,72,33,39,0.981,0.84
2007/8/31,1345,8976,99,104,6,98,0.975,0.691
2007/9/3,945,8948,-28,50,45,5,0.981,1.131
2007/9/3,1045,8972,24,52,1,51,0.981,1.337
2007/9/3,1145,8969,-3,48,29,19,0.984,1.594
2007/9/3,1245,8979,9,48,5,43,0.986,1.888
2007/9/3,1345,8956,-23,47,33,14,0.992,1.372
2007/9/4,945,8922,-40,89,86,3,0.998,0.791
2007/9/4,1045,8896,-28,64,39,25,1.003,0.653
2007/9/4,1145,8890,-8,40,16,24,1.005,1.475
2007/9/4,1245,8927,37,57,18,39,1.001,1.005
2007/9/4,1345,8890,-36,65,68,-3,1.006,0.818
2007/9/5,945,8982,-18,44,22,22,0.996,1.155
2007/9/5,1045,8925,-57,71,59,12,1.002,1.03
2007/9/5,1145,8928,2,49,17,32,1.001,1.062
2007/9/5,1245,8887,-41,51,48,3,1.006,1.233
2007/9/5,1345,8821,-66,111,98,13,1.012,0.803
2007/9/6,945,8781,-11,67,38,29,1.015,0.708
2007/9/6,1045,8938,157,200,40,160,0.995,0.571
2007/9/6,1145,8909,-29,68,47,21,0.999,1.077
2007/9/6,1245,8962,53,66,-1,67,0.993,1.202
2007/9/6,1345,9017,57,79,-12,91,0.988,0.893
2007/9/7,945,9045,45,55,5,50,0.985,1.033
2007/9/7,1045,9017,-27,61,28,33,0.988,1.257
2007/9/7,1145,9039,22,32,6,26,0.987,1.956
2007/9/7,1245,8992,-47,58,63,-5,0.993,1.268
2007/9/7,1345,8982,-11,47,8,39,0.996,0.91
2007/9/10,945,8790,40,60,15,45,1.017,0.841
2007/9/10,1045,8908,117,137,10,127,1.004,0.819
2007/9/10,1145,8915,8,70,20,50,1.002,1.1
2007/9/10,1245,8889,-26,92,46,46,1.005,1.045
2007/9/10,1345,8890,1,56,30,26,1.005,1.167
2007/9/11,945,8908,39,59,22,37,1.001,1.08
2007/9/11,1045,8970,62,82,18,64,0.993,0.8
2007/9/11,1145,8971,2,34,5,29,0.992,1.675
2007/9/11,1245,8948,-25,50,27,23,0.994,1.308
2007/9/11,1345,9002,53,55,3,52,0.987,1.202
2007/9/12,945,9035,23,42,27,15,0.987,0.811
2007/9/12,1045,8984,-52,74,60,14,0.995,0.869
2007/9/12,1145,8983,1,39,20,19,0.996,1.273
2007/9/12,1245,8984,2,87,66,21,0.996,0.763
2007/9/12,1345,8936,-47,76,76,0,1.003,1.044
2007/9/13,945,8973,-25,43,40,3,1,1.074
2007/9/13,1045,8936,-39,59,51,8,1.005,1
2007/9/13,1145,8935,2,56,10,46,1.005,0.766
2007/9/13,1245,8911,-24,51,44,7,1.007,1.307
2007/9/13,1345,8921,11,57,16,41,1.006,1.142
2007/9/14,945,8975,-16,51,33,18,0.999,0.861
2007/9/14,1045,8977,2,44,17,27,0.998,1.052
2007/9/14,1145,9046,68,81,9,72,0.991,0.904
2007/9/14,1245,9038,-7,33,26,7,0.992,1.002
2007/9/14,1345,9030,-8,33,24,9,0.994,1.071
2007/9/17,945,8999,-44,87,54,33,0.998,0.956
2007/9/17,1045,8964,-35,41,48,-7,1.002,1.347
2007/9/17,1145,8865,-100,75,95,-20,1.013,0.619
2007/9/17,1245,8893,24,84,15,69,1.009,0.91
2007/9/17,1345,8888,-2,50,21,29,1.01,1.076
2007/9/19,945,9017,-93,118,112,6,0.997,0.701
2007/9/19,1045,8970,-48,143,66,77,1.002,0.807
2007/9/19,1145,8984,14,54,15,39,1.001,1.411
2007/9/19,1245,9012,27,42,9,33,0.997,1.315
2007/9/19,1345,8923,-89,104,93,11,1.007,1.269
2007/9/20,945,9110,88,117,10,107,0.986,0.606
2007/9/20,1045,9092,-17,55,47,8,0.989,1.014
2007/9/20,1145,9062,-30,66,45,21,0.994,1.04
2007/9/20,1245,9033,-28,73,30,43,0.999,0.881
2007/9/20,1345,9016,-15,72,21,51,1.002,1.103
2007/9/21,945,9068,47,73,16,57,0.996,1.058
2007/9/21,1045,9075,8,72,45,27,0.995,0.906
2007/9/21,1145,9068,-8,43,37,6,0.997,1.841
2007/9/21,1245,9103,34,63,12,51,0.994,1.342
2007/9/21,1345,9132,31,47,5,42,0.992,1.064
2007/9/26,945,9200,19,76,47,29,0.987,0.868
2007/9/26,1045,9240,40,61,20,41,0.983,1.329
2007/9/26,1145,9264,24,42,10,32,0.982,1.649
2007/9/26,1245,9272,8,27,16,11,0.984,1.568
2007/9/26,1345,9275,2,35,25,10,0.986,1.434
2007/9/27,945,9317,-21,47,36,11,0.985,0.909
2007/9/27,1045,9349,29,63,15,48,0.984,0.934
2007/9/27,1145,9381,31,52,7,45,0.984,0.922
2007/9/27,1245,9405,23,46,11,35,0.985,0.984
2007/9/27,1345,9410,5,46,17,29,0.987,1.004
2007/9/28,945,9422,2,37,16,21,0.989,0.807
2007/9/28,1045,9416,-6,40,12,28,0.992,0.986
2007/9/28,1145,9450,36,52,6,46,0.99,1.077
2007/9/28,1245,9442,-8,31,30,1,0.993,1.097
2007/9/28,1345,9380,-62,71,63,8,1.001,0.708
2007/9/29,945,9469,49,67,9,58,0.992,1.034
2007/9/29,1045,9467,-2,39,20,19,0.994,1.146
2007/9/29,1145,9456,-10,41,25,16,0.997,1.11
2007/9/29,1245,9455,-1,34,10,24,0.998,1.336
2007/9/29,1345,9492,36,35,0,35,0.994,1.321
2007/10/1,945,9505,-22,68,46,22,0.994,0.672
2007/10/1,1045,9507,1,44,28,16,0.995,1.314
2007/10/1,1145,9520,15,47,26,21,0.994,1.333
2007/10/1,1245,9510,-10,30,25,5,0.996,1.783
2007/10/1,1345,9501,-12,39,11,28,0.998,0.719
2007/10/2,945,9596,-25,52,36,16,0.99,0.65
2007/10/2,1045,9643,45,62,13,49,0.986,0.761
2007/10/2,1145,9628,-14,52,27,25,0.99,1.073
2007/10/2,1245,9657,27,44,10,34,0.989,1.136
2007/10/2,1345,9669,11,29,15,14,0.989,0.791
2007/10/3,945,9674,13,42,15,27,0.99,0.874
2007/10/3,1045,9701,27,48,3,45,0.989,1.286
2007/10/3,1145,9832,131,128,-7,135,0.978,0.558
2007/10/3,1245,9718,-114,125,112,13,0.993,0.64
2007/10/3,1345,9771,54,106,1,105,0.99,0.786
2007/10/4,945,9704,-8,57,13,44,0.997,0.793
2007/10/4,1045,9685,-20,40,25,15,1,1.226
2007/10/4,1145,9672,-13,52,14,38,1.002,0.841
2007/10/4,1245,9653,-19,32,33,-1,1.005,1.903
2007/10/4,1345,9678,25,43,12,31,1.002,1.49
2007/10/5,945,9670,19,53,38,15,1.003,1.3
2007/10/5,1045,9663,-6,35,28,7,1.003,1.919
2007/10/5,1145,9618,-42,69,39,30,1.008,0.808
2007/10/5,1245,9673,55,71,8,63,1,1.11
2007/10/5,1345,9617,-56,75,70,5,1.005,1.184
2007/10/8,945,9730,28,32,8,24,0.993,0.996
2007/10/8,1045,9760,30,40,8,32,0.99,1.247
2007/10/8,1145,9771,11,32,3,29,0.99,1.952
2007/10/8,1245,9740,-30,32,35,-3,0.994,1.817
2007/10/8,1345,9739,2,35,9,26,0.995,1.019
2007/10/9,945,9676,-79,96,92,4,1.003,0.704
2007/10/9,1045,9653,-25,72,34,38,1.005,0.745
2007/10/9,1145,9632,-22,59,18,41,1.007,0.901
2007/10/9,1245,9631,-1,52,29,23,1.008,1.406
2007/10/9,1345,9654,24,43,14,29,1.005,0.858
2007/10/11,945,9734,52,55,16,39,0.996,0.754
2007/10/11,1045,9716,-19,23,22,1,0.998,1.344
2007/10/11,1145,9697,-23,74,40,34,1,0.943
2007/10/11,1245,9720,24,35,6,29,0.997,1.272
2007/10/11,1345,9750,30,49,-5,54,0.993,1.175
2007/10/12,945,9716,28,71,12,59,0.996,0.823
2007/10/12,1045,9680,-36,55,43,12,1,0.98
2007/10/12,1145,9592,-87,105,87,18,1.01,0.48
2007/10/12,1245,9548,-45,74,40,34,1.014,0.737
2007/10/12,1345,9450,-98,121,118,3,1.024,0.608
2007/10/15,945,9446,-102,130,92,38,1.023,0.763
2007/10/15,1045,9500,59,97,15,82,1.014,1.147
2007/10/15,1145,9459,-41,71,54,17,1.016,1.518
2007/10/15,1245,9496,37,72,24,48,1.009,1.586
2007/10/15,1345,9502,5,41,25,16,1.006,1.627
2007/10/16,945,9471,35,54,6,48,1.007,1.426
2007/10/16,1045,9590,120,139,9,130,0.992,0.772
2007/10/16,1145,9564,-26,65,67,-2,0.994,0.936
2007/10/16,1245,9571,6,50,16,34,0.993,1.143
2007/10/16,1345,9563,-9,44,32,12,0.994,1.301
2007/10/17,945,9505,0,84,72,12,0.999,1.133
2007/10/17,1045,9522,17,59,8,51,0.998,1.563
2007/10/17,1145,9610,90,90,1,89,0.989,1.853
2007/10/17,1245,9547,-65,97,73,24,0.997,1.964
2007/10/17,1345,9556,9,54,2,52,0.997,1.446
2007/10/18,945,9681,81,64,-14,78,0.986,0.51
2007/10/18,1045,9651,-30,58,43,15,0.991,0.69
2007/10/18,1145,9660,9,38,5,33,0.991,0.947
2007/10/18,1245,9674,15,33,4,29,0.99,1.377
2007/10/18,1345,9677,3,28,8,20,0.991,1.006
2007/10/19,945,9657,37,69,18,51,0.994,0.817
2007/10/19,1045,9651,-7,33,8,25,0.997,1.101
2007/10/19,1145,9627,-24,47,32,15,1,1.433
2007/10/19,1245,9641,13,32,3,29,0.999,1.694
2007/10/19,1345,9613,-28,40,32,8,1.003,1.251
2007/10/22,945,9282,-76,61,37,24,1.036,0.53
2007/10/22,1045,9277,-6,55,12,43,1.032,0.801
2007/10/22,1145,9330,53,75,16,59,1.023,0.867
2007/10/22,1245,9316,-15,62,52,10,1.021,0.997
2007/10/22,1345,9327,12,41,22,19,1.015,0.99
2007/10/23,945,9417,28,59,13,46,1.003,0.745
2007/10/23,1045,9443,25,45,12,33,0.998,1.181
2007/10/23,1145,9470,28,47,5,42,0.993,1.409
2007/10/23,1245,9514,44,61,14,47,0.987,1.062
2007/10/23,1345,9514,0,38,28,10,0.985,1.217
2007/10/24,945,9600,20,55,20,35,0.979,0.825
2007/10/24,1045,9611,11,59,43,16,0.981,0.828
2007/10/24,1145,9558,-53,73,65,8,0.99,0.964
2007/10/24,1245,9513,-43,69,46,23,0.997,0.865
2007/10/24,1345,9455,-55,108,65,43,1.005,0.759
2007/10/25,945,9538,-30,60,50,10,0.998,0.974
2007/10/25,1045,9555,15,70,45,25,0.998,0.969
2007/10/25,1145,9517,-38,71,70,1,1.003,1.232
2007/10/25,1245,9544,27,47,-1,48,1.001,1.157
2007/10/25,1345,9598,52,60,0,60,0.995,1.047
2007/10/26,945,9652,8,55,28,27,0.99,0.899
2007/10/26,1045,9618,-34,60,50,10,0.994,1.243
2007/10/26,1145,9647,29,56,11,45,0.992,1.162
2007/10/26,1245,9669,22,39,6,33,0.99,1.586
2007/10/26,1345,9677,7,38,6,32,0.991,1.247
2007/10/29,945,9771,-9,48,32,16,0.984,0.906
2007/10/29,1045,9782,10,23,8,15,0.985,1.719
2007/10/29,1145,9825,44,59,16,43,0.983,0.755
2007/10/29,1245,9848,23,36,12,24,0.984,1.157
2007/10/29,1345,9860,12,39,4,35,0.986,0.886
2007/10/30,945,9809,-26,47,44,3,0.993,0.815
2007/10/30,1045,9824,16,36,9,27,0.993,1.305
2007/10/30,1145,9801,-24,57,48,9,0.997,0.987
2007/10/30,1245,9799,-1,47,14,33,0.999,0.998
2007/10/30,1345,9786,-11,43,30,13,1.002,1.073
2007/10/31,945,9794,5,60,17,43,1.001,0.919
2007/10/31,1045,9721,-74,84,93,-9,1.009,0.755
2007/10/31,1145,9768,47,70,20,50,1.003,0.963
2007/10/31,1245,9747,-25,38,33,5,1.005,1.351
2007/10/31,1345,9780,35,58,-2,60,1,0.846
2007/11/1,945,9789,-26,57,46,11,0.999,0.601
2007/11/1,1045,9737,-53,96,70,26,1.004,0.644
2007/11/1,1145,9639,-98,174,97,77,1.014,0.563
2007/11/1,1245,9633,-5,62,37,25,1.013,1.089
2007/11/1,1345,9657,24,39,18,21,1.008,1.11
2007/11/2,945,9411,-46,110,79,31,1.031,0.648
2007/11/2,1045,9444,34,61,10,51,1.024,1.414
2007/11/2,1145,9399,-45,68,63,5,1.026,1.372
2007/11/2,1245,9351,-48,99,73,26,1.027,0.951
2007/11/2,1345,9230,-121,161,134,27,1.036,0.733
2007/11/5,945,9201,-9,92,49,43,1.033,0.976
2007/11/5,1045,9193,-11,73,50,23,1.027,1.763
2007/11/5,1145,9096,-99,114,108,6,1.032,0.886
2007/11/5,1245,9222,123,124,12,112,1.012,1.221
2007/11/5,1345,9275,54,102,45,57,1.002,0.988
2007/11/6,945,9344,24,92,4,88,0.993,1.059
2007/11/6,1045,9305,-37,73,41,32,0.997,1.151
2007/11/6,1145,9326,22,73,8,65,0.993,1.323
2007/11/6,1245,9305,-21,36,24,12,0.994,2.516
2007/11/6,1345,9305,0,60,48,12,0.994,1.109
2007/11/7,945,9379,16,39,20,19,0.988,0.807
2007/11/7,1045,9361,-19,53,42,11,0.991,1.297
2007/11/7,1145,9344,-21,55,40,15,0.995,1.471
2007/11/7,1245,9345,3,52,7,45,0.998,1.024
2007/11/7,1345,9270,-75,87,82,5,1.007,0.875
2007/11/8,945,9031,-32,86,51,35,1.031,0.559
2007/11/8,1045,9003,-30,64,31,33,1.031,0.828
2007/11/8,1145,9001,-3,45,19,26,1.027,1.372
2007/11/8,1245,8901,-101,118,107,11,1.035,0.734
2007/11/8,1345,8925,24,99,-6,105,1.028,0.672
2007/11/9,945,8923,-48,85,72,13,1.024,0.814
2007/11/9,1045,8957,33,119,18,101,1.015,0.723
2007/11/9,1145,8972,15,84,12,72,1.009,1.178
2007/11/9,1245,8994,23,69,30,39,1.002,1.315
2007/11/9,1345,8969,-27,57,51,6,1.001,1.534
2007/11/12,945,8714,-1,81,25,56,1.026,0.842
2007/11/12,1045,8712,-3,53,21,32,1.023,1.233
2007/11/12,1145,8635,-76,89,70,19,1.029,1.005
2007/11/12,1245,8630,-4,92,35,57,1.025,1.041
2007/11/12,1345,8683,56,67,5,62,1.016,1.002
2007/11/13,945,8682,7,48,34,14,1.012,0.991
2007/11/13,1045,8709,28,61,14,47,1.006,1.187
2007/11/13,1145,8632,-77,104,96,8,1.012,1.044
2007/11/13,1245,8659,29,93,-6,99,1.005,0.814
2007/11/13,1345,8749,89,103,15,88,0.991,0.829
2007/11/14,945,8929,-31,49,38,11,0.974,1.029
2007/11/14,1045,8938,8,42,14,28,0.975,1.562
2007/11/14,1145,8946,6,38,18,20,0.977,1.671
2007/11/14,1245,8946,-1,38,30,8,0.98,1.823
2007/11/14,1345,8941,-5,38,10,28,0.985,1.267
2007/11/15,945,8905,-17,49,32,17,0.991,1.143
2007/11/15,1045,8909,4,38,11,27,0.993,1.397
2007/11/15,1145,8907,-1,43,21,22,0.996,1.848
2007/11/15,1245,8901,-6,38,11,27,1,1.42
2007/11/15,1345,8867,-34,36,32,4,1.006,1.113
2007/11/16,945,8718,55,72,14,58,1.02,0.583
2007/11/16,1045,8696,-23,44,25,19,1.02,1.057
2007/11/16,1145,8656,-40,79,46,33,1.022,0.786
2007/11/16,1245,8722,67,79,7,72,1.011,0.94
2007/11/16,1345,8756,35,53,23,30,1.004,0.753
2007/11/19,945,8799,19,45,26,19,0.998,0.903
2007/11/19,1045,8787,-11,52,9,43,0.998,0.927
2007/11/19,1145,8776,-12,38,24,14,0.998,1.681
2007/11/19,1245,8762,-14,60,34,26,0.998,1.05
2007/11/19,1345,8620,-142,137,140,-3,1.013,0.665
2007/11/20,945,8404,-16,43,45,-2,1.036,0.731
2007/11/20,1045,8384,-18,77,35,42,1.035,0.713
2007/11/20,1145,8442,59,99,23,76,1.024,1.099
2007/11/20,1245,8562,120,121,5,116,1.007,0.783
2007/11/20,1345,8721,158,150,-3,153,0.987,0.626
2007/11/21,945,8637,-10,76,55,21,0.995,0.67
2007/11/21,1045,8634,-2,65,35,30,0.993,1.025
2007/11/21,1145,8603,-26,113,47,66,0.995,1.02
2007/11/21,1245,8528,-73,100,76,24,1.002,1.138
2007/11/21,1345,8438,-90,158,144,14,1.01,0.823
2007/11/22,945,8405,-75,138,54,84,1.015,0.719
2007/11/22,1045,8477,72,134,52,82,1.006,0.79
2007/11/22,1145,8531,56,115,25,90,1.001,1.173
2007/11/22,1245,8510,-19,109,82,27,1.004,1.085
2007/11/22,1345,8471,-41,109,83,26,1.008,1.122
2007/11/23,945,8483,-15,95,34,61,1.005,1.052
2007/11/23,1045,8469,-13,93,26,67,1.005,0.98
2007/11/23,1145,8403,-66,91,76,15,1.011,1.372
2007/11/23,1245,8380,-23,97,60,37,1.011,1.095
2007/11/23,1345,8326,-51,90,79,11,1.016,1.001
2007/11/26,945,8437,7,52,25,27,1.002,1.217
2007/11/26,1045,8516,79,108,22,86,0.993,0.904
2007/11/26,1145,8510,-1,57,19,38,0.994,1.619
2007/11/26,1245,8526,18,50,15,35,0.992,1.47
2007/11/26,1345,8533,7,40,27,13,0.991,1.213
2007/11/27,945,8238,-65,77,62,15,1.025,0.798
2007/11/27,1045,8242,5,61,7,54,1.021,0.846
2007/11/27,1145,8450,211,261,42,219,0.993,0.547
2007/11/27,1245,8382,-62,150,92,58,1.002,0.777
2007/11/27,1345,8397,15,64,30,34,1,0.917
2007/11/28,945,8382,-58,93,58,35,1.002,1.009
2007/11/28,1045,8317,-63,114,88,26,1.009,1.017
2007/11/28,1145,8299,-18,69,47,22,1.009,1.403
2007/11/28,1245,8375,77,136,56,80,0.997,0.973
2007/11/28,1345,8244,-131,153,151,2,1.011,1.023
2007/11/29,945,8447,-28,44,21,23,0.989,1.363
2007/11/29,1045,8449,3,44,1,43,0.991,1.653
2007/11/29,1145,8425,-21,37,31,6,0.997,1.71
2007/11/29,1245,8414,-12,61,32,29,0.998,1.339
2007/11/29,1345,8426,14,79,59,20,0.997,0.855
2007/11/30,945,8567,68,90,16,74,0.981,0.682
2007/11/30,1045,8575,10,45,32,13,0.982,1.171
2007/11/30,1145,8594,19,49,0,49,0.983,1.338
2007/11/30,1245,8582,-4,43,22,21,0.988,1.788
2007/11/30,1345,8608,25,50,15,35,0.987,1.022
2007/12/3,945,8567,-41,57,56,1,0.993,1.176
2007/12/3,1045,8583,18,33,17,16,0.993,1.774
2007/12/3,1145,8608,25,54,29,25,0.992,1.297
2007/12/3,1245,8589,-20,41,20,21,0.996,1.29
2007/12/3,1345,8596,7,47,4,43,0.997,1.056
2007/12/4,945,8550,-30,54,35,19,1.004,0.763
2007/12/4,1045,8577,29,47,13,34,1,1.045
2007/12/4,1145,8617,41,53,15,38,0.996,0.841
2007/12/4,1245,8623,6,40,13,27,0.995,1.217
2007/12/4,1345,8621,1,36,28,8,0.996,0.899
2007/12/5,945,8588,-10,51,21,30,1,0.639
2007/12/5,1045,8624,37,54,22,32,0.996,0.833
2007/12/5,1145,8591,-33,66,59,7,1,0.789
2007/12/5,1245,8673,83,87,2,85,0.99,0.852
2007/12/5,1345,8709,37,43,4,39,0.987,0.884
2007/12/6,945,8776,-9,36,30,6,0.982,1.056
2007/12/6,1045,8758,-17,37,32,5,0.987,1.512
2007/12/6,1145,8740,-16,38,34,4,0.991,1.431
2007/12/6,1245,8712,-26,48,42,6,0.995,1.258
2007/12/6,1345,8739,28,72,3,69,0.993,0.86
2007/12/7,945,8780,2,37,17,20,0.991,1.149
2007/12/7,1045,8756,-24,82,64,18,0.995,0.806
2007/12/7,1145,8775,21,49,10,39,0.995,1.009
2007/12/7,1245,8770,-6,43,25,18,0.998,1.21
2007/12/7,1345,8706,-64,72,63,9,1.006,0.901
2007/12/10,945,8668,-27,45,27,18,1.009,1.028
2007/12/10,1045,8697,32,42,10,32,1.005,1.547
2007/12/10,1145,8711,12,37,16,21,1.002,1.101
2007/12/10,1245,8655,-57,77,62,15,1.009,1.029
2007/12/10,1345,8561,-91,106,93,13,1.019,0.59
2007/12/11,945,8598,-10,69,39,30,1.013,0.905
2007/12/11,1045,8627,30,57,17,40,1.007,0.914
2007/12/11,1145,8620,-7,48,16,32,1.006,1.323
2007/12/11,1245,8627,6,53,8,45,1.004,1.285
2007/12/11,1345,8640,12,65,20,45,1.001,0.933
2007/12/12,945,8511,31,65,19,46,1.013,0.85
2007/12/12,1045,8480,-30,37,42,-5,1.015,1.246
2007/12/12,1145,8451,-26,49,43,6,1.016,1.024
2007/12/12,1245,8481,31,65,16,49,1.009,1.101
2007/12/12,1345,8501,21,77,49,28,1.005,0.694
2007/12/13,945,8484,36,64,21,43,1.005,0.858
2007/12/13,1045,8421,-62,82,66,16,1.011,0.725
2007/12/13,1145,8382,-37,64,54,10,1.014,0.93
2007/12/13,1245,8261,-121,157,119,38,1.025,0.611
2007/12/13,1345,8110,-149,159,152,7,1.04,0.625
2007/12/14,945,8151,1,100,4,96,1.031,0.863
2007/12/14,1045,8100,-50,125,72,53,1.033,0.79
2007/12/14,1145,7966,-134,178,174,4,1.045,0.875
2007/12/14,1245,7979,16,154,35,119,1.038,0.701
2007/12/14,1345,8060,84,204,70,134,1.021,0.827
2007/12/17,945,8049,32,82,30,52,1.017,1.471
2007/12/17,1045,7960,-91,120,96,24,1.023,1.233
2007/12/17,1145,7943,-12,92,25,67,1.019,1.131
2007/12/17,1245,7890,-52,118,90,28,1.021,1.214
2007/12/17,1345,7748,-136,180,180,0,1.034,0.929
2007/12/18,945,7746,66,97,28,69,1.029,0.906
2007/12/18,1045,7753,5,94,59,35,1.023,1.18
2007/12/18,1145,7905,153,153,8,145,0.998,1.038
2007/12/18,1245,7886,-17,84,49,35,1,1.158
2007/12/18,1345,7814,-66,144,95,49,1.008,1.002
2007/12/19,945,7921,73,120,22,98,0.992,1.553
2007/12/19,1045,7974,53,81,14,67,0.984,1.909
2007/12/19,1145,7985,13,71,29,42,0.983,2.402
2007/12/19,1245,7970,-16,57,40,17,0.985,2.706
2007/12/19,1345,8015,45,69,12,57,0.981,2.189
2007/12/20,945,7962,-35,67,62,5,0.991,0.726
2007/12/20,1045,7954,-8,45,26,19,0.995,1
2007/12/20,1145,7933,-21,59,62,-3,1,0.868
2007/12/20,1245,7920,-11,46,39,7,1.002,1.018
2007/12/20,1345,7846,-67,133,77,56,1.012,0.518
2007/12/21,945,7909,96,112,9,103,1.004,0.594
2007/12/21,1045,7998,91,106,20,86,0.992,0.56
2007/12/21,1145,7971,-28,73,59,14,0.996,0.96
2007/12/21,1245,7930,-40,89,75,14,1.001,0.971
2007/12/21,1345,7972,44,80,22,58,0.995,1.076
2007/12/24,945,8098,-7,36,14,22,0.981,1.589
2007/12/24,1045,8089,-8,32,8,24,0.984,2.601
2007/12/24,1145,8112,23,61,22,39,0.983,1.588
2007/12/24,1245,8099,-11,54,26,28,0.986,1.983
2007/12/24,1345,8131,31,52,6,46,0.985,1.247
2007/12/25,945,8140,-19,53,23,30,0.988,1.086
2007/12/25,1045,8132,-4,34,22,12,0.992,1.575
2007/12/25,1145,8120,-12,38,23,15,0.995,1.624
2007/12/25,1245,8132,11,21,11,10,0.995,1.727
2007/12/25,1345,8149,16,29,3,26,0.996,1.228
2007/12/26,945,8087,-33,49,32,17,1.004,0.636
2007/12/26,1045,8065,-21,37,22,15,1.006,0.9
2007/12/26,1145,8085,23,33,4,29,1.003,1.738
2007/12/26,1245,8090,5,31,14,17,1.002,1.162
2007/12/26,1345,8187,97,113,7,106,0.99,0.531
2007/12/27,945,8273,113,152,26,126,0.98,0.481
2007/12/27,1045,8312,36,64,23,41,0.977,0.75
2007/12/27,1145,8349,38,42,0,42,0.975,1.391
2007/12/27,1245,8293,-56,78,60,18,0.984,0.966
2007/12/27,1345,8334,43,69,-2,71,0.981,0.835
2007/12/28,945,8345,68,116,35,81,0.982,0.835
2007/12/28,1045,8286,-61,202,151,51,0.992,0.469
2007/12/28,1145,8346,60,78,7,71,0.988,1.296
2007/12/28,1245,8358,13,64,20,44,0.989,1.349
2007/12/28,1345,8396,39,50,4,46,0.988,1.052
2007/12/31,945,8443,43,63,15,48,0.985,1.398
2007/12/31,1045,8435,-9,29,15,14,0.988,1.904
2007/12/31,1145,8452,17,36,8,28,0.988,2.247
2007/12/31,1245,8473,20,31,0,31,0.987,2.138
2007/12/31,1345,8482,10,38,21,17,0.988,1.089
2008/1/2,945,8460,10,42,18,24,0.992,0.98
2008/1/2,1045,8464,7,28,11,17,0.993,1.296
2008/1/2,1145,8497,33,41,9,32,0.991,0.897
2008/1/2,1245,8373,-125,145,130,15,1.008,0.482
2008/1/2,1345,8285,-89,108,94,14,1.019,0.484
2008/1/3,945,8144,-56,106,56,50,1.034,0.578
2008/1/3,1045,8094,-49,73,62,11,1.037,0.762
2008/1/3,1145,8176,85,129,44,85,1.022,0.631
2008/1/3,1245,8197,22,57,0,57,1.016,1.295
2008/1/3,1345,8144,-52,88,85,3,1.019,0.896
2008/1/4,945,8065,-35,61,26,35,1.025,0.895
2008/1/4,1045,8103,38,72,22,50,1.015,1.204
2008/1/4,1145,8214,113,147,29,118,0.997,0.853
2008/1/4,1245,8211,-3,63,34,29,0.994,1.36
2008/1/4,1345,8209,-3,65,31,34,0.992,1.208
2008/1/7,945,7968,17,53,30,23,1.019,1.06
2008/1/7,1045,7893,-74,135,87,48,1.027,0.813
2008/1/7,1145,7867,-25,96,67,29,1.028,1.188
2008/1/7,1245,7819,-47,70,68,2,1.03,1.37
2008/1/7,1345,7833,18,77,44,33,1.023,0.932
2008/1/8,945,7914,74,105,6,99,1.009,1.045
2008/1/8,1045,7941,30,50,3,47,1.004,1.42
2008/1/8,1145,7941,1,48,23,25,1.002,1.324
2008/1/8,1245,7894,-45,71,42,29,1.004,0.978
2008/1/8,1345,7920,27,63,15,48,0.997,1.414
2008/1/9,945,7913,162,207,29,178,0.996,0.716
2008/1/9,1045,7952,40,113,56,57,0.99,0.726
2008/1/9,1145,7969,19,79,18,61,0.989,1.104
2008/1/9,1245,8028,55,106,6,100,0.983,0.847
2008/1/9,1345,8092,66,78,12,66,0.977,0.803
2008/1/10,945,8126,36,63,29,34,0.976,0.941
2008/1/10,1045,8141,16,49,13,36,0.977,1.419
2008/1/10,1145,8107,-34,60,38,22,0.984,1.145
2008/1/10,1245,8117,12,97,31,66,0.985,0.889
2008/1/10,1345,8070,-47,74,63,11,0.993,1.102
2008/1/11,945,8110,-11,48,48,0,0.993,1.125
2008/1/11,1045,8129,21,43,9,34,0.993,1.498
2008/1/11,1145,8070,-59,44,54,-10,1.002,1.356
2008/1/11,1245,8017,-48,100,59,41,1.01,0.588
2008/1/11,1345,7965,-50,84,84,0,1.017,0.859
2008/1/14,945,8171,67,146,86,60,0.991,0.558
2008/1/14,1045,8135,-35,101,76,25,0.996,0.97
2008/1/14,1145,8091,-41,101,54,47,1.001,0.939
2008/1/14,1245,8188,98,110,15,95,0.989,1.036
2008/1/14,1345,8248,65,112,4,108,0.983,0.841
2008/1/15,945,8486,223,233,34,199,0.957,0.731
2008/1/15,1045,8557,71,143,79,64,0.954,0.841
2008/1/15,1145,8559,5,73,41,32,0.958,1.473
2008/1/15,1245,8492,-66,93,63,30,0.972,1.056
2008/1/15,1345,8505,13,73,-5,78,0.976,1.246
2008/1/16,945,8400,100,108,-40,148,0.99,1.275
2008/1/16,1045,8306,-94,101,92,9,1.004,1.75
2008/1/16,1145,8285,-17,72,48,24,1.009,2.533
2008/1/16,1245,8254,-29,100,81,19,1.015,2.395
2008/1/16,1345,8149,-107,122,98,24,1.029,1.572
2008/1/17,945,8209,-41,99,74,25,1.021,0.77
2008/1/17,1045,8144,-63,145,91,54,1.026,0.663
2008/1/17,1145,8014,-131,168,145,23,1.038,0.619
2008/1/17,1245,8015,5,98,35,63,1.031,0.745
2008/1/17,1345,8098,86,99,27,72,1.014,0.735
2008/1/18,945,7900,-1,83,37,46,1.035,0.903
2008/1/18,1045,7980,80,137,17,120,1.018,0.956
2008/1/18,1145,8035,54,97,13,84,1.007,1.094
2008/1/18,1245,8158,123,122,-5,127,0.989,0.993
2008/1/18,1345,8216,61,92,21,71,0.98,1.097
2008/1/21,945,8140,27,97,64,33,0.988,1.086
2008/1/21,1045,8143,7,80,17,63,0.987,1.138
2008/1/21,1145,8160,18,63,13,50,0.985,1.471
2008/1/21,1245,8146,-12,39,19,20,0.988,2.381
2008/1/21,1345,8115,-31,77,32,45,0.994,1.039
2008/1/22,945,7652,-48,116,7,109,1.051,0.607
2008/1/22,1045,7604,-46,120,72,48,1.054,1.139
2008/1/22,1145,7543,-59,53,53,0,1.058,1.739
2008/1/22,1345,7543,0,0,0,0,1.051,9.725
2008/1/23,945,7665,-57,175,55,120,1.029,0.549
2008/1/23,1045,7589,-76,109,71,38,1.033,1.008
2008/1/23,1145,7493,-92,237,99,138,1.039,0.552
2008/1/23,1245,7368,-124,150,119,31,1.048,0.903
2008/1/23,1345,7331,-36,147,137,10,1.043,0.827
2008/1/24,945,7572,-28,81,75,6,1.002,0.869
2008/1/24,1045,7412,-158,192,168,24,1.022,0.689
2008/1/24,1145,7530,124,133,18,115,1.003,0.986
2008/1/24,1245,7515,-14,90,63,27,1.004,1.09
2008/1/24,1345,7540,27,86,19,67,1,1.393
2008/1/25,945,7674,44,52,21,31,0.981,1.138
2008/1/25,1045,7699,24,60,39,21,0.978,1.186
2008/1/25,1145,7678,-22,56,40,16,0.983,1.672
2008/1/25,1245,7712,34,78,18,60,0.981,1.679
2008/1/25,1345,7777,65,59,-10,69,0.977,1.121
2008/1/28,945,7639,-47,72,71,1,0.996,1.171
2008/1/28,1045,7610,-26,56,33,23,1,1.107
2008/1/28,1145,7555,-47,75,45,30,1.01,1
2008/1/28,1245,7534,-16,82,44,38,1.013,0.946
2008/1/28,1345,7445,-86,133,93,40,1.026,0.892
2008/1/29,945,7495,-96,102,96,6,1.018,0.879
2008/1/29,1045,7495,2,102,39,63,1.016,0.744
2008/1/29,1145,7472,-23,110,56,54,1.016,0.957
2008/1/29,1245,7535,65,85,15,70,1.005,0.942
2008/1/29,1345,7533,-1,41,32,9,1.003,1.095
2008/1/30,945,7610,110,145,25,120,0.99,0.734
2008/1/30,1045,7599,-9,69,56,13,0.991,1.005
2008/1/30,1145,7534,-64,81,54,27,1,1.017
2008/1/30,1245,7475,-56,119,95,24,1.008,0.887
2008/1/30,1345,7519,48,78,16,62,1.001,1.128
2008/1/31,945,7468,3,103,97,6,1.006,0.847
2008/1/31,1045,7480,12,67,46,21,1.004,1.088
2008/1/31,1145,7376,-97,148,108,40,1.018,0.857
2008/1/31,1245,7507,127,128,0,128,0.999,0.874
2008/1/31,1345,7468,-38,81,65,16,1.004,1.182
2008/2/1,945,7585,33,93,49,44,0.989,0.996
2008/2/1,1045,7605,20,48,15,33,0.986,1.742
2008/2/1,1145,7594,-11,64,48,16,0.988,1.209
2008/2/1,1245,7660,66,72,0,72,0.98,1.482
2008/2/1,1345,7673,14,33,5,28,0.981,1.218
2008/2/12,945,7518,-29,97,70,27,1.002,0.924
2008/2/12,1045,7522,6,81,22,59,1.002,1.222
2008/2/12,1145,7544,23,62,11,51,1,1.44
2008/2/12,1245,7518,-27,57,45,12,1.005,1.618
2008/2/12,1345,7508,-3,61,27,34,1.007,1.133
2008/2/13,945,7598,10,43,9,34,0.995,1.041
2008/2/13,1045,7574,-24,54,31,23,0.999,1.374
2008/2/13,1145,7577,2,46,27,19,0.998,1.58
2008/2/13,1245,7539,-38,64,47,17,1.003,1.022
2008/2/13,1345,7488,-44,60,55,5,1.008,0.886
2008/2/14,945,7719,19,53,16,37,0.98,0.664
2008/2/14,1045,7742,25,36,13,23,0.979,0.988
2008/2/14,1145,7774,33,34,-4,38,0.978,1.281
2008/2/14,1245,7802,28,34,3,31,0.978,1.051
2008/2/14,1345,7899,96,112,11,101,0.969,0.691
2008/2/15,945,7805,9,77,32,45,0.984,0.772
2008/2/15,1045,7859,55,86,15,71,0.98,1.044
2008/2/15,1145,7836,-21,56,48,8,0.986,1.094
2008/2/15,1245,7809,-28,45,19,26,0.993,0.967
2008/2/15,1345,7891,83,92,4,88,0.986,0.854
2008/2/18,945,7954,-6,51,27,24,0.981,0.921
2008/2/18,1045,7925,-28,67,55,12,0.988,1.218
2008/2/18,1145,7896,-27,55,31,24,0.994,0.959
2008/2/18,1245,7899,3,67,7,60,0.995,0.885
2008/2/18,1345,7917,23,69,6,63,0.994,1.122
2008/2/19,945,7959,-1,44,33,11,0.991,1.017
2008/2/19,1045,7974,16,46,10,36,0.991,1.339
2008/2/19,1145,8012,38,63,10,53,0.988,1.053
2008/2/19,1245,8009,-2,37,21,16,0.99,1.281
2008/2/19,1345,8024,14,55,9,46,0.991,1.121
2008/2/20,945,7990,40,57,15,42,0.995,1.567
2008/2/20,1045,7984,-5,34,15,19,0.996,2.253
2008/2/20,1145,7972,-12,48,31,17,0.998,2.047
2008/2/20,1245,7865,-107,105,103,2,1.013,0.992
2008/2/20,1345,7877,12,56,3,53,1.011,1.114
2008/2/21,945,7945,27,36,11,25,1.002,0.594
2008/2/21,1045,7977,31,39,8,31,0.998,0.771
2008/2/21,1145,7972,-3,52,23,29,0.998,0.769
2008/2/21,1245,8035,63,53,-5,58,0.99,0.627
2008/2/21,1345,8032,0,30,24,6,0.991,0.752
2008/2/22,945,7970,20,49,6,43,0.998,0.81
2008/2/22,1045,7983,14,38,15,23,0.996,0.956
2008/2/22,1145,7975,-6,73,33,40,0.997,0.94
2008/2/22,1245,7982,8,56,20,36,0.997,1.226
2008/2/22,1345,8037,54,71,17,54,0.991,0.995
2008/2/25,945,8224,61,60,12,48,0.972,0.889
2008/2/25,1045,8226,3,48,18,30,0.975,1.228
2008/2/25,1145,8204,-22,42,31,11,0.98,1.599
2008/2/25,1245,8238,36,48,2,46,0.979,1.527
2008/2/25,1345,8226,-11,48,47,1,0.983,0.865
2008/2/26,945,8272,-17,76,44,32,0.982,0.795
2008/2/26,1045,8291,19,41,3,38,0.983,1.275
2008/2/26,1145,8247,-44,59,43,16,0.992,1.092
2008/2/26,1245,8259,12,31,16,15,0.994,1.468
2008/2/26,1345,8280,21,79,2,77,0.995,0.723
2008/2/27,945,8327,-38,70,53,17,0.992,0.924
2008/2/27,1045,8352,26,41,13,28,0.99,1.178
2008/2/27,1145,8360,7,55,39,16,0.99,0.845
2008/2/27,1245,8396,38,64,14,50,0.988,1.116
2008/2/27,1345,8376,-19,44,39,5,0.992,0.745
2008/2/29,945,8344,23,62,11,51,0.996,0.875
2008/2/29,1045,8355,11,31,14,17,0.996,1.245
2008/2/29,1145,8394,38,52,11,41,0.992,1.223
2008/2/29,1245,8407,13,40,8,32,0.992,1.442
2008/2/29,1345,8340,-68,112,110,2,1.002,0.599
2008/3/3,945,8155,-5,48,21,27,1.022,0.793
2008/3/3,1045,8134,-20,57,28,29,1.023,1.104
2008/3/3,1145,8190,56,63,4,59,1.013,1.007
2008/3/3,1245,8209,20,54,23,31,1.009,1.06
2008/3/3,1345,8250,41,57,3,54,1.002,0.779
2008/3/4,945,8333,63,91,-9,100,0.991,0.792
2008/3/4,1045,8405,74,78,20,58,0.982,0.592
2008/3/4,1145,8425,22,52,19,33,0.981,1.088
2008/3/4,1245,8397,-28,49,27,22,0.984,1.191
2008/3/4,1345,8492,94,91,-5,96,0.973,0.782
2008/3/5,945,8480,-32,105,78,27,0.979,0.769
2008/3/5,1045,8506,26,65,14,51,0.979,0.984
2008/3/5,1145,8440,-66,84,85,-1,0.991,1.339
2008/3/5,1245,8483,49,65,-2,67,0.989,1.126
2008/3/5,1345,8520,38,35,-12,47,0.988,1.131
2008/3/6,945,8588,70,82,27,55,0.983,0.844
2008/3/6,1045,8534,-54,57,58,-1,0.993,1.01
2008/3/6,1145,8585,52,66,20,46,0.988,1.116
2008/3/6,1245,8633,48,61,5,56,0.985,1.189
2008/3/6,1345,8689,56,69,-4,73,0.981,0.899
2008/3/7,945,8606,56,73,9,64,0.991,0.928
2008/3/7,1045,8636,32,75,10,65,0.989,1.022
2008/3/7,1145,8555,-79,127,87,40,1,0.74
2008/3/7,1245,8578,24,60,12,48,0.998,1.264
2008/3/7,1345,8526,-51,68,63,5,1.006,1.075
2008/3/10,945,8473,-12,103,74,29,1.011,0.888
2008/3/10,1045,8362,-109,102,106,-4,1.023,0.807
2008/3/10,1145,8313,-49,85,61,24,1.027,0.958
2008/3/10,1245,8299,-10,82,47,35,1.026,1.184
2008/3/10,1345,8314,14,77,16,61,1.02,1.135
2008/3/11,945,8324,81,143,2,141,1.015,0.782
2008/3/11,1045,8324,0,80,21,59,1.012,1.126
2008/3/11,1145,8306,-17,85,34,51,1.01,1.139
2008/3/11,1245,8330,26,49,2,47,1.004,1.707
2008/3/11,1345,8374,48,75,16,59,0.996,1.008
2008/3/12,945,8577,-19,43,33,10,0.974,0.895
2008/3/12,1045,8538,-39,56,49,7,0.979,1.266
2008/3/12,1145,8491,-45,52,45,7,0.987,1.049
2008/3/12,1245,8446,-44,82,41,41,0.994,0.999
2008/3/12,1345,8468,26,61,30,31,0.993,0.894
2008/3/13,945,8383,-43,79,67,12,1.006,0.912
2008/3/13,1045,8390,10,44,-4,48,1.005,1.107
2008/3/13,1145,8303,-87,96,88,8,1.017,0.977
2008/3/13,1245,8260,-40,59,54,5,1.022,1.039
2008/3/13,1345,8190,-67,91,62,29,1.03,0.747
2008/3/14,945,8278,18,36,19,17,1.015,1.277
2008/3/14,1045,8207,-71,106,80,26,1.02,0.928
2008/3/14,1145,8220,12,77,62,15,1.014,1.064
2008/3/14,1245,8090,-133,152,145,7,1.027,0.71
2008/3/14,1345,8117,27,124,100,24,1.02,0.76
2008/3/17,945,7977,15,88,27,61,1.032,0.857
2008/3/17,1045,7892,-83,112,72,40,1.038,0.836
2008/3/17,1145,7952,67,92,3,89,1.024,1.053
2008/3/17,1245,8030,78,117,15,102,1.009,0.908
2008/3/17,1345,7977,-53,90,78,12,1.013,1.162
2008/3/18,945,8018,-10,56,38,18,1.005,1.249
2008/3/18,1045,7971,-50,69,66,3,1.008,1.395
2008/3/18,1145,7976,5,71,9,62,1.004,1.076
2008/3/18,1245,8032,56,104,15,89,0.994,1.176
2008/3/18,1345,8059,27,55,9,46,0.99,1.36
2008/3/19,945,8200,-50,103,70,33,0.977,1.315
2008/3/19,1045,8227,27,63,12,51,0.976,2.427
2008/3/19,1145,8225,-3,41,10,31,0.981,2.681
2008/3/19,1245,8175,-49,79,55,24,0.99,1.785
2008/3/19,1345,8169,-6,62,15,47,0.992,1.438
2008/3/20,945,8111,50,69,18,51,1,0.561
2008/3/20,1045,8074,-36,113,89,24,1.006,0.599
2008/3/20,1145,8124,53,65,1,64,1.001,1.029
2008/3/20,1245,8240,117,138,13,125,0.988,0.559
2008/3/20,1345,8340,103,144,20,124,0.979,0.611
2008/3/21,945,8430,32,81,26,55,0.97,0.83
2008/3/21,1045,8466,41,55,14,41,0.969,0.871
2008/3/21,1145,8488,22,61,38,23,0.969,0.939
2008/3/21,1245,8507,20,73,4,69,0.97,1.064
2008/3/21,1345,8620,113,139,-6,145,0.961,0.884
2008/3/24,945,8897,-100,243,216,27,0.942,0.492
2008/3/24,1045,8880,-17,102,53,49,0.952,0.848
2008/3/24,1145,8824,-51,97,80,17,0.967,1.146
2008/3/24,1245,8891,66,102,13,89,0.968,1.098
2008/3/24,1345,8890,-1,59,30,29,0.976,1.227
2008/3/25,945,8878,-73,255,92,163,0.983,0.829
2008/3/25,1045,8758,-118,148,142,6,1.002,1.082
2008/3/25,1145,8828,70,73,5,68,0.997,1.229
2008/3/25,1245,8814,-13,90,34,56,1.002,1.309
2008/3/25,1345,8760,-54,93,64,29,1.012,1.309
2008/3/26,945,8783,12,70,27,43,1.007,1.14
2008/3/26,1045,8817,34,60,7,53,1.002,1.25
2008/3/26,1145,8773,-45,77,64,13,1.006,1.115
2008/3/26,1245,8732,-38,86,47,39,1.01,1.021
2008/3/26,1345,8721,-11,57,21,36,1.01,1.18
2008/3/27,945,8625,-60,88,85,3,1.018,0.878
2008/3/27,1045,8573,-49,83,55,28,1.021,0.817
2008/3/27,1145,8593,22,70,-3,73,1.017,1.027
2008/3/27,1245,8594,4,61,39,22,1.014,1.054
2008/3/27,1345,8558,-36,61,36,25,1.015,0.959
2008/3/28,945,8574,61,110,56,54,1.01,0.974
2008/3/28,1045,8635,61,100,30,70,1.001,0.936
2008/3/28,1145,8670,35,52,-10,62,0.995,1.52
2008/3/28,1245,8645,-23,58,25,33,0.996,1.515
2008/3/28,1345,8623,-20,50,43,7,0.998,1.019
2008/3/31,945,8504,-75,143,101,42,1.011,0.849
2008/3/31,1045,8478,-26,68,41,27,1.012,1.203
2008/3/31,1145,8506,30,40,9,31,1.008,1.665
2008/3/31,1245,8484,-23,71,69,2,1.01,1.189
2008/3/31,1345,8524,41,61,4,57,1.004,1.163
2008/4/1,945,8577,17,53,18,35,0.998,1.007
2008/4/1,1045,8550,-27,48,32,16,1.001,1.268
2008/4/1,1145,8536,-15,41,27,14,1.002,1.53
2008/4/1,1245,8467,-69,73,62,11,1.008,0.948
2008/4/1,1345,8330,-133,119,120,-1,1.023,0.589
2008/4/2,945,8493,-35,75,46,29,1.003,0.642
2008/4/2,1045,8521,29,43,8,35,0.999,1.296
2008/4/2,1145,8585,65,85,23,62,0.992,0.766
2008/4/2,1245,8574,-11,39,25,14,0.994,1.612
2008/4/2,1345,8570,1,55,48,7,0.996,1.022
2008/4/3,945,8552,-51,76,51,25,0.998,1.036
2008/4/3,1045,8588,37,73,27,46,0.994,1.047
2008/4/3,1145,8572,-17,73,40,33,0.996,1.216
2008/4/3,1245,8570,3,42,15,27,0.997,1.771
2008/4/3,1345,8576,8,42,11,31,0.997,1.201
2008/4/7,945,8645,45,60,10,50,0.99,0.952
2008/4/7,1045,8682,42,56,6,50,0.988,1.154
2008/4/7,1145,8681,1,33,4,29,0.99,1.585
2008/4/7,1245,8701,21,34,3,31,0.988,1.468
2008/4/7,1345,8709,9,40,34,6,0.989,0.865
2008/4/8,945,8680,37,52,13,39,0.993,0.797
2008/4/8,1045,8671,-8,33,14,19,0.995,1.221
2008/4/8,1145,8669,-2,35,36,-1,0.996,1.247
2008/4/8,1245,8677,10,38,19,19,0.997,1.51
2008/4/8,1345,8636,-41,62,59,3,1.003,0.866
2008/4/9,945,8735,73,79,7,72,0.992,0.653
2008/4/9,1045,8767,39,62,8,54,0.989,0.782
2008/4/9,1145,8739,-29,37,41,-4,0.994,1.137
2008/4/9,1245,8636,-102,128,103,25,1.006,0.495
2008/4/9,1345,8677,41,88,-1,89,1.001,0.722
2008/4/10,945,8763,116,122,7,115,0.991,0.7
2008/4/10,1045,8782,19,58,10,48,0.99,0.873
2008/4/10,1145,8750,-33,56,46,10,0.995,1.168
2008/4/10,1245,8789,39,46,2,44,0.991,1.482
2008/4/10,1345,8819,30,63,8,55,0.989,0.843
2008/4/11,945,8865,35,83,20,63,0.986,0.897
2008/4/11,1045,8856,-9,47,11,36,0.988,1.261
2008/4/11,1145,8860,3,39,11,28,0.989,1.733
2008/4/11,1245,8921,61,73,13,60,0.983,0.861
2008/4/11,1345,8912,-6,46,16,30,0.988,0.974
2008/4/14,945,8865,37,86,33,53,0.995,0.891
2008/4/14,1045,8885,17,52,25,27,0.994,1.44
2008/4/14,1145,8847,-40,58,42,16,0.999,1.182
2008/4/14,1245,8845,-2,56,13,43,1.001,1.102
2008/4/14,1345,8871,22,62,15,47,0.998,1.083
2008/4/15,945,8892,18,63,23,40,0.996,0.93
2008/4/15,1045,8891,-2,43,40,3,0.997,1.059
2008/4/15,1145,8877,-15,37,27,10,0.999,1.189
2008/4/15,1245,8931,54,75,14,61,0.993,1.336
2008/4/15,1345,8918,-13,39,14,25,0.995,1.383
2008/4/16,945,8990,-10,38,19,19,0.989,1.099
2008/4/16,1045,8990,0,26,17,9,0.99,2.478
2008/4/16,1145,9012,24,31,8,23,0.989,2.359
2008/4/16,1245,9039,27,37,4,33,0.988,1.645
2008/4/16,1345,9086,46,44,-1,45,0.984,0.976
2008/4/17,945,9098,-36,62,37,25,0.986,0.466
2008/4/17,1045,9098,0,57,18,39,0.988,0.728
2008/4/17,1145,9124,25,36,6,30,0.988,0.872
2008/4/17,1245,9061,-63,74,63,11,0.997,0.774
2008/4/17,1345,9060,2,36,14,22,0.999,0.792
2008/4/18,945,9077,-6,43,11,32,0.998,0.953
2008/4/18,1045,9035,-42,60,50,10,1.004,1.116
2008/4/18,1145,9017,-18,40,30,10,1.006,1.083
2008/4/18,1245,9018,-1,40,21,19,1.006,1.519
2008/4/18,1345,9081,63,77,18,59,0.999,0.788
2008/4/21,945,9138,-30,47,27,20,0.993,0.843
2008/4/21,1045,9121,-18,42,10,32,0.995,1
2008/4/21,1145,9093,-29,50,32,18,0.999,1.367
2008/4/21,1245,9065,-25,59,38,21,1.001,1.178
2008/4/21,1345,9082,16,39,8,31,0.999,1.057
2008/4/22,945,9030,-26,70,46,24,1.005,0.822
2008/4/22,1045,9000,-30,61,38,23,1.008,0.85
2008/4/22,1145,9011,10,44,16,28,1.006,1.312
2008/4/22,1245,9040,27,50,-1,51,1.003,1.491
2008/4/22,1345,9030,-10,20,15,5,1.004,1.077
2008/4/23,945,8973,-82,125,97,28,1.009,0.586
2008/4/23,1045,9035,65,64,-7,71,1.001,0.958
2008/4/23,1145,9062,27,58,31,27,0.997,0.65
2008/4/23,1245,9061,0,25,17,8,0.996,1.556
2008/4/23,1345,8984,-78,108,94,14,1.005,0.785
2008/4/24,945,9018,52,67,12,55,1,0.917
2008/4/24,1045,9003,-16,51,42,9,1.002,1.014
2008/4/24,1145,9002,-1,38,13,25,1.002,1.477
2008/4/24,1245,8976,-26,53,37,16,1.005,1.344
2008/4/24,1345,8978,1,49,41,8,1.004,1.159
2008/4/25,945,9035,-17,32,17,15,0.997,1.084
2008/4/25,1045,8998,-37,78,70,8,1.002,0.815
2008/4/25,1145,8976,-22,47,21,26,1.004,0.811
2008/4/25,1245,8986,12,35,14,21,1.002,1.602
2008/4/25,1345,8988,-1,35,5,30,1.001,1.185
2008/4/28,945,9004,6,42,24,18,1,1.078
2008/4/28,1045,8990,-15,34,17,17,1.001,1.449
2008/4/28,1145,9070,80,88,2,86,0.992,0.665
2008/4/28,1245,9041,-29,55,44,11,0.996,0.941
2008/4/28,1345,9090,49,51,2,49,0.991,0.931
2008/4/29,945,9061,-29,49,36,13,0.995,1.162
2008/4/29,1045,9080,18,33,13,20,0.993,1.428
2008/4/29,1145,9039,-41,62,46,16,0.998,0.801
2008/4/29,1245,8900,-137,172,144,28,1.015,0.588
2008/4/29,1345,8920,28,44,14,30,1.011,0.792
2008/4/30,945,8911,1,53,37,16,1.011,1.029
2008/4/30,1045,8939,28,62,30,32,1.007,1.156
2008/4/30,1145,8980,41,50,4,46,1.002,1.51
2008/4/30,1245,8950,-29,41,36,5,1.004,1.569
2008/4/30,1345,8937,-14,47,12,35,1.005,0.995
2008/5/2,945,9010,-11,45,30,15,0.996,0.854
2008/5/2,1045,9006,-2,22,19,3,0.996,2.112
2008/5/2,1145,8955,-52,87,68,19,1.001,1.117
2008/5/2,1245,8979,24,38,5,33,0.997,1.499
2008/5/2,1345,9009,30,47,3,44,0.995,0.953
2008/5/5,945,8976,-44,50,30,20,1,0.921
2008/5/5,1045,8904,-71,93,77,16,1.008,0.565
2008/5/5,1145,8846,-54,87,72,15,1.015,0.816
2008/5/5,1245,8853,8,42,17,25,1.012,1.431
2008/5/5,1345,8847,-7,41,16,25,1.012,0.983
2008/5/6,945,8829,-31,46,40,6,1.012,0.894
2008/5/6,1045,8824,-5,63,19,44,1.011,0.865
2008/5/6,1145,8866,42,102,22,80,1.004,0.741
2008/5/6,1245,8864,-3,34,7,27,1.003,1.63
2008/5/6,1345,8870,5,39,10,29,1.001,1.352
2008/5/7,945,8918,15,49,12,37,0.994,0.912
2008/5/7,1045,8955,40,44,6,38,0.99,0.852
2008/5/7,1145,8937,-19,47,39,8,0.992,0.998
2008/5/7,1245,8929,-10,39,15,24,0.994,1.077
2008/5/7,1345,8918,-11,24,21,3,0.996,1.356
2008/5/8,945,8858,3,34,11,23,1.003,0.873
2008/5/8,1045,8863,6,32,22,10,1.003,1.62
2008/5/8,1145,8822,-44,70,57,13,1.008,0.884
2008/5/8,1245,8838,17,38,0,38,1.005,1.1
2008/5/8,1345,8894,56,82,9,73,0.999,0.856
2008/5/9,945,8835,-15,49,42,7,1.005,0.906
2008/5/9,1045,8826,-11,42,7,35,1.005,0.881
2008/5/9,1145,8821,-6,40,18,22,1.004,1.312
2008/5/9,1245,8841,19,60,27,33,1.001,0.983
2008/5/9,1345,8773,-68,77,70,7,1.007,0.669
2008/5/12,945,8789,13,51,18,33,1.005,1.146
2008/5/12,1045,8804,14,40,21,19,1.002,1.358
2008/5/12,1145,8815,10,48,-3,51,1,1.137
2008/5/12,1245,8835,20,57,11,46,0.998,1.085
2008/5/12,1345,8864,30,38,4,34,0.995,1.015
2008/5/13,945,8906,44,47,-8,55,0.99,0.914
2008/5/13,1045,8949,43,49,1,48,0.986,0.824
2008/5/13,1145,8974,26,56,34,22,0.985,0.733
2008/5/13,1245,8994,18,36,19,17,0.984,1.267
2008/5/13,1345,9030,37,52,14,38,0.982,0.816
2008/5/14,945,9085,55,63,-7,70,0.979,0.859
2008/5/14,1045,9056,-32,40,27,13,0.985,1.191
2008/5/14,1145,9040,-17,66,28,38,0.99,0.917
2008/5/14,1245,9028,-12,40,22,18,0.993,1.712
2008/5/14,1345,9058,30,47,13,34,0.992,1.112
2008/5/15,945,9132,44,57,21,36,0.987,0.818
2008/5/15,1045,9130,-2,45,27,18,0.989,1.182
2008/5/15,1145,9132,2,18,11,7,0.991,1.934
2008/5/15,1245,9181,47,41,4,37,0.988,0.932
2008/5/15,1345,9182,2,32,27,5,0.99,0.837
2008/5/16,945,9211,-9,36,16,20,0.989,0.885
2008/5/16,1045,9252,41,50,-2,52,0.985,1.138
2008/5/16,1145,9240,-12,46,41,5,0.989,0.855
2008/5/16,1245,9282,42,43,-5,48,0.987,1.32
2008/5/16,1345,9248,-34,50,36,14,0.993,0.849
2008/5/19,945,9265,-4,43,29,14,0.993,1.01
2008/5/19,1045,9262,-4,34,15,19,0.995,1.495
2008/5/19,1145,9280,18,30,3,27,0.994,1.402
2008/5/19,1245,9284,4,31,7,24,0.995,1.585
2008/5/19,1345,9370,86,89,4,85,0.987,0.69
2008/5/20,945,9300,-56,121,88,33,0.996,0.611
2008/5/20,1045,9274,-29,79,28,51,1,0.822
2008/5/20,1145,9165,-107,145,140,5,1.012,0.589
2008/5/20,1245,9106,-59,85,54,31,1.018,0.801
2008/5/20,1345,9074,-33,84,69,15,1.02,0.909
2008/5/21,945,9006,-29,63,54,9,1.025,1.345
2008/5/21,1045,9020,15,57,-4,61,1.02,2.098
2008/5/21,1145,9083,62,85,5,80,1.01,2.289
2008/5/21,1245,9035,-50,62,52,10,1.014,2.184
2008/5/21,1345,8998,-35,60,56,4,1.015,2.117
2008/5/22,945,8911,36,61,15,46,1.02,0.697
2008/5/22,1045,8905,-6,40,10,30,1.016,1.082
2008/5/22,1145,8941,36,77,14,63,1.008,0.877
2008/5/22,1245,8935,-5,31,21,10,1.006,1.076
2008/5/22,1345,9018,83,85,1,84,0.995,0.649
2008/5/23,945,8975,-25,60,52,8,0.999,0.732
2008/5/23,1045,8932,-42,77,52,25,1.004,0.655
2008/5/23,1145,8886,-44,97,56,41,1.008,0.774
2008/5/23,1245,8918,33,73,27,46,1.002,1.006
2008/5/23,1345,8786,-128,144,136,8,1.016,0.723
2008/5/26,945,8742,6,78,48,30,1.019,0.866
2008/5/26,1045,8711,-33,74,55,19,1.021,1.11
2008/5/26,1145,8729,18,73,39,34,1.016,1.327
2008/5/26,1245,8743,13,50,42,8,1.012,1.54
2008/5/26,1345,8699,-44,66,63,3,1.015,1.113
2008/5/27,945,8737,36,38,28,10,1.007,1.102
2008/5/27,1045,8750,14,32,4,28,1.003,1.902
2008/5/27,1145,8747,-3,33,22,11,1.002,1.639
2008/5/27,1245,8751,5,46,1,45,1,1.155
2008/5/27,1345,8776,26,41,9,32,0.995,0.99
2008/5/28,945,8715,-75,75,70,5,1.002,0.677
2008/5/28,1045,8718,3,42,19,23,1.002,1.081
2008/5/28,1145,8771,53,69,14,55,0.996,0.866
2008/5/28,1245,8685,-87,115,92,23,1.006,0.629
2008/5/28,1345,8646,-39,52,31,21,1.01,0.773
2008/5/29,945,8744,15,49,27,22,0.999,0.874
2008/5/29,1045,8738,-6,59,17,42,1,1.081
2008/5/29,1145,8687,-49,76,49,27,1.005,1.129
2008/5/29,1245,8708,21,62,4,58,1.002,1.154
2008/5/29,1345,8720,12,58,0,58,1,0.995
2008/5/30,945,8705,-60,73,75,-2,1.002,0.988
2008/5/30,1045,8565,-140,139,145,-6,1.018,0.653
2008/5/30,1145,8587,25,68,17,51,1.014,0.931
2008/5/30,1245,8618,31,65,17,48,1.008,1.044
2008/5/30,1345,8648,30,84,38,46,1.004,0.788
2008/6/2,945,8667,32,69,17,52,1,1.124
2008/6/2,1045,8670,3,51,25,26,0.999,1.557
2008/6/2,1145,8632,-39,53,56,-3,1.003,1.555
2008/6/2,1245,8628,-4,39,21,18,1.003,1.52
2008/6/2,1345,8700,72,89,9,80,0.993,0.976
2008/6/3,945,8616,-28,47,41,6,1.002,1.185
2008/6/3,1045,8610,-6,40,8,32,1.001,1.037
2008/6/3,1145,8609,-1,38,14,24,1.002,1.386
2008/6/3,1245,8526,-83,107,91,16,1.012,0.687
2008/6/3,1345,8540,14,41,24,17,1.009,1.026
2008/6/4,945,8555,15,54,25,29,1.006,0.98
2008/6/4,1045,8582,28,60,29,31,1.002,1.032
2008/6/4,1145,8599,16,32,-1,33,0.999,1.322
2008/6/4,1245,8579,-21,52,40,12,1.001,1.317
2008/6/4,1345,8592,13,41,23,18,0.999,1.425
2008/6/5,945,8520,-51,99,69,30,1.006,0.644
2008/6/5,1045,8505,-15,58,25,33,1.007,0.872
2008/6/5,1145,8553,48,74,6,68,1,0.934
2008/6/5,1245,8639,87,114,16,98,0.99,0.714
2008/6/5,1345,8725,86,114,40,74,0.981,0.526
2008/6/6,945,8750,-38,57,48,9,0.981,0.911
2008/6/6,1045,8752,2,46,42,4,0.983,1.461
2008/6/6,1145,8771,20,65,6,59,0.983,1.175
2008/6/6,1245,8764,-6,43,11,32,0.986,1.703
2008/6/6,1345,8756,-8,33,12,21,0.989,1.585
2008/6/9,945,8519,-1,41,14,27,1.016,0.73
2008/6/9,1045,8520,2,23,10,13,1.015,2.078
2008/6/9,1145,8529,8,33,19,14,1.015,2.102
2008/6/9,1245,8542,13,45,13,32,1.013,1.76
2008/6/9,1345,8529,-12,30,26,4,1.013,1.118
2008/6/10,945,8521,-8,97,44,53,1.011,0.526
2008/6/10,1045,8425,-98,112,99,13,1.02,0.637
2008/6/10,1145,8434,8,58,19,39,1.015,0.937
2008/6/10,1245,8381,-54,91,86,5,1.017,0.909
2008/6/10,1345,8340,-43,84,65,19,1.018,0.662
2008/6/11,945,8332,-33,68,50,18,1.017,0.759
2008/6/11,1045,8361,29,87,17,70,1.011,0.852
2008/6/11,1145,8370,9,62,34,28,1.008,1.216
2008/6/11,1245,8350,-20,66,46,20,1.009,1.507
2008/6/11,1345,8316,-34,52,49,3,1.01,1.453
2008/6/12,945,8130,-69,94,74,20,1.03,0.657
2008/6/12,1045,8118,-12,70,25,45,1.026,0.949
2008/6/12,1145,8129,8,59,20,39,1.021,1.428
2008/6/12,1245,8077,-52,84,56,28,1.024,0.985
2008/6/12,1345,8043,-34,85,41,44,1.024,0.748
2008/6/13,945,8041,-27,58,42,16,1.021,1.008
2008/6/13,1045,8041,0,42,34,8,1.017,1.465
2008/6/13,1145,8077,37,94,19,75,1.009,0.901
2008/6/13,1245,8094,18,66,14,52,1.003,1.217
2008/6/13,1345,8043,-50,108,97,11,1.006,0.864
2008/6/16,945,8153,32,56,14,42,0.992,0.916
2008/6/16,1045,8178,26,27,-21,48,0.989,1.891
2008/6/16,1145,8186,10,38,5,33,0.989,1.501
2008/6/16,1245,8151,-34,45,33,12,0.994,1.393
2008/6/16,1345,8133,-18,52,19,33,0.997,0.995
2008/6/17,945,8087,-46,76,59,17,1.003,0.894
2008/6/17,1045,8057,-30,49,26,23,1.007,0.971
2008/6/17,1145,8107,50,122,32,90,1.001,0.686
2008/6/17,1245,8151,43,80,9,71,0.996,1.061
2008/6/17,1345,8147,-3,56,30,26,0.998,1.075
2008/6/18,945,8151,11,63,34,29,0.997,1.281
2008/6/18,1045,8163,13,45,18,27,0.996,1.966
2008/6/18,1145,8244,81,77,-6,83,0.986,1.395
2008/6/18,1245,8247,3,36,12,24,0.986,1.99
2008/6/18,1345,8219,-27,44,29,15,0.991,1.306
2008/6/19,945,7910,-70,85,65,20,1.028,0.511
2008/6/19,1045,7934,24,50,11,39,1.022,1.107
2008/6/19,1145,7928,-2,41,23,18,1.021,1.16
2008/6/19,1245,7923,-5,36,15,21,1.02,1.405
2008/6/19,1345,7890,-34,46,43,3,1.021,0.891
2008/6/20,945,7868,-42,85,52,33,1.021,0.596
2008/6/20,1045,7932,69,78,-2,80,1.009,0.929
2008/6/20,1145,7885,-48,64,49,15,1.012,1.118
2008/6/20,1245,7759,-130,157,136,21,1.024,0.608
2008/6/20,1345,7778,20,66,11,55,1.016,0.798
2008/6/23,945,7712,52,95,13,82,1.02,0.748
2008/6/23,1045,7758,46,95,17,78,1.011,1.097
2008/6/23,1145,7721,-37,76,65,11,1.014,1.022
2008/6/23,1245,7776,52,66,4,62,1.004,1.286
2008/6/23,1345,7754,-22,64,51,13,1.005,1.019
2008/6/24,945,7742,27,62,40,22,1.004,1.059
2008/6/24,1045,7685,-59,87,68,19,1.01,0.813
2008/6/24,1145,7688,5,51,32,19,1.007,1.321
2008/6/24,1245,7695,6,64,14,50,1.003,0.993
2008/6/24,1345,7693,-2,51,12,39,1.002,1.069
2008/6/25,945,7620,-51,90,80,10,1.012,0.8
2008/6/25,1045,7703,83,122,24,98,1,0.739
2008/6/25,1145,7707,5,48,32,16,0.999,1.211
2008/6/25,1245,7730,23,62,5,57,0.996,1.221
2008/6/25,1345,7753,23,38,6,32,0.992,0.98
2008/6/26,945,7754,1,68,24,44,0.992,0.914
2008/6/26,1045,7776,26,52,16,36,0.99,1.08
2008/6/26,1145,7763,-13,58,35,23,0.993,1.033
2008/6/26,1245,7747,-18,44,27,17,0.996,1.572
2008/6/26,1345,7693,-54,59,56,3,1.003,0.98
2008/6/27,945,7421,40,51,26,25,1.036,0.762
2008/6/27,1045,7388,-33,86,39,47,1.038,0.853
2008/6/27,1145,7380,-9,49,45,4,1.035,1.494
2008/6/27,1245,7430,50,85,30,55,1.024,1.175
2008/6/27,1345,7416,-14,69,21,48,1.022,0.871
2008/6/30,945,7465,-5,48,25,23,1.011,1.107
2008/6/30,1045,7418,-46,70,68,2,1.014,1.416
2008/6/30,1145,7451,36,47,2,45,1.004,1.378
2008/6/30,1245,7412,-40,41,44,-3,1.005,1.555
2008/6/30,1345,7416,0,58,24,34,1,0.827
2008/7/1,945,7446,36,57,31,26,0.997,0.823
2008/7/1,1045,7419,-27,50,38,12,1.001,1.081
2008/7/1,1145,7345,-74,96,84,12,1.011,0.764
2008/7/1,1245,7377,32,60,17,43,1.006,0.919
2008/7/1,1345,7291,-87,88,92,-4,1.017,0.9
2008/7/2,945,7370,62,112,24,88,1.004,0.584
2008/7/2,1045,7334,-35,50,48,2,1.008,1.191
2008/7/2,1145,7331,-2,49,33,16,1.007,1.065
2008/7/2,1245,7298,-33,80,47,33,1.01,0.924
2008/7/2,1345,7245,-53,94,97,-3,1.016,0.865
2008/7/3,945,7114,-26,92,33,59,1.031,0.725
2008/7/3,1045,7106,-8,54,28,26,1.027,1.071
2008/7/3,1145,7158,53,94,24,70,1.015,1.002
2008/7/3,1245,7303,145,175,17,158,0.993,0.822
2008/7/3,1345,7299,-1,100,78,22,0.992,0.742
2008/7/4,945,7269,-13,69,54,15,0.996,1.107
2008/7/4,1045,7280,11,72,35,37,0.993,1.173
2008/7/4,1145,7248,-30,46,31,15,0.997,1.565
2008/7/4,1245,7178,-70,85,84,1,1.005,1.211
2008/7/4,1345,7100,-78,95,97,-2,1.015,0.865
2008/7/7,945,7090,-6,79,64,15,1.015,1.101
2008/7/7,1045,7154,62,82,20,62,1.006,1.032
2008/7/7,1145,7175,22,55,10,45,1.004,1.509
2008/7/7,1245,7171,-4,42,24,18,1.005,1.691
2008/7/7,1345,7258,87,108,21,87,0.991,0.838
2008/7/8,945,7149,-50,59,43,16,1.005,0.854
2008/7/8,1045,7094,-55,77,71,6,1.011,0.868
2008/7/8,1145,7052,-44,80,64,16,1.014,0.954
2008/7/8,1245,6984,-68,79,71,8,1.021,0.858
2008/7/8,1345,6988,1,100,4,96,1.018,0.612
2008/7/9,945,7130,35,80,17,63,0.998,0.924
2008/7/9,1045,7162,33,71,23,48,0.994,0.958
2008/7/9,1145,7117,-45,75,66,9,1,1.074
2008/7/9,1245,7030,-86,151,71,80,1.012,0.613
2008/7/9,1345,7011,-20,99,48,51,1.012,0.923
2008/7/10,945,6965,7,107,83,24,1.016,1.016
2008/7/10,1045,6933,-34,72,32,40,1.018,1.012
2008/7/10,1145,7007,76,92,27,65,1.005,1.103
2008/7/10,1245,7045,38,116,71,45,0.999,0.854
2008/7/10,1345,7010,-35,75,45,30,1.004,1.139
2008/7/11,945,7055,82,114,22,92,0.996,0.952
2008/7/11,1045,7023,-31,58,65,-7,1,1.247
2008/7/11,1145,7032,9,77,39,38,0.996,1.088
2008/7/11,1245,7152,122,122,3,119,0.979,0.822
2008/7/11,1345,7181,29,61,25,36,0.976,0.895
2008/7/14,945,7204,4,55,6,49,0.976,1.299
2008/7/14,1045,7184,-19,73,54,19,0.982,1.27
2008/7/14,1145,7143,-42,66,47,19,0.992,1.146
2008/7/14,1245,7112,-31,78,54,24,0.998,1.169
2008/7/14,1345,7152,42,57,10,47,0.993,1.196
2008/7/15,945,6955,-95,118,90,28,1.023,0.861
2008/7/15,1045,6899,-56,64,57,7,1.029,1.211
2008/7/15,1145,6830,-68,143,57,86,1.038,0.823
2008/7/15,1245,6844,14,102,62,40,1.033,1.019
2008/7/15,1345,6790,-54,89,81,8,1.037,0.904
2008/7/16,945,6796,-24,75,70,5,1.03,1.309
2008/7/16,1045,6788,-7,102,22,80,1.025,1.009
2008/7/16,1145,6780,-7,79,48,31,1.021,1.721
2008/7/16,1245,6764,-17,69,57,12,1.018,1.66
2008/7/16,1345,6678,-85,97,96,1,1.026,1.354
2008/7/17,945,6745,45,55,10,45,1.01,0.717
2008/7/17,1045,6760,15,33,15,18,1.005,1.056
2008/7/17,1145,6760,1,34,4,30,1.003,1.385
2008/7/17,1245,6812,52,66,15,51,0.994,0.904
2008/7/17,1345,6797,-17,51,51,0,0.996,0.873
2008/7/18,945,6840,-20,57,30,27,0.99,0.837
2008/7/18,1045,6827,-16,68,61,7,0.993,0.878
2008/7/18,1145,6805,-21,43,18,25,0.997,1.015
2008/7/18,1245,6668,-136,131,142,-11,1.017,0.787
2008/7/18,1345,6681,11,94,12,82,1.014,0.737
2008/7/21,945,6931,86,85,18,67,0.98,0.841
2008/7/21,1045,6928,-1,56,30,26,0.983,1.366
2008/7/21,1145,6931,3,45,34,11,0.985,1.664
2008/7/21,1245,6958,29,64,16,48,0.983,1.215
2008/7/21,1345,7007,52,88,13,75,0.978,0.811
2008/7/22,945,6932,-11,56,34,22,0.99,1.063
2008/7/22,1045,6951,21,77,12,65,0.989,1.029
2008/7/22,1145,6954,2,60,56,4,0.99,0.9
2008/7/22,1245,6957,2,72,20,52,0.992,0.98
2008/7/22,1345,6967,10,43,16,27,0.995,1.237
2008/7/23,945,7107,7,43,11,32,0.979,0.875
2008/7/23,1045,7145,40,55,10,45,0.976,1.038
2008/7/23,1145,7174,29,58,11,47,0.975,1.098
2008/7/23,1245,7220,46,71,27,44,0.972,0.941
2008/7/23,1345,7186,-34,72,64,8,0.98,0.861
2008/7/24,945,7248,-14,69,29,40,0.976,0.979
2008/7/24,1045,7227,-21,52,48,4,0.984,1.101
2008/7/24,1145,7248,21,40,21,19,0.985,1.649
2008/7/24,1245,7280,29,61,9,52,0.984,1.276
2008/7/24,1345,7304,23,41,2,39,0.985,1.062
2008/7/25,945,7153,-35,40,28,12,1.007,0.94
2008/7/25,1045,7159,7,42,16,26,1.007,1.156
2008/7/25,1145,7140,-16,33,20,13,1.01,1.626
2008/7/25,1245,7101,-39,63,44,19,1.015,1.058
2008/7/25,1345,7170,68,69,1,68,1.004,0.842
2008/7/29,945,6929,-21,56,23,33,1.034,0.807
2008/7/29,1045,6888,-41,59,37,22,1.036,1.175
2008/7/29,1145,6897,11,44,21,23,1.029,1.59
2008/7/29,1245,6924,26,52,13,39,1.02,1.172
2008/7/29,1345,6916,-8,55,38,17,1.016,0.885
2008/7/30,945,7034,-36,50,51,-1,0.998,0.89
2008/7/30,1045,6983,-50,74,57,17,1.003,0.791
2008/7/30,1145,7014,31,60,24,36,0.996,1.088
2008/7/30,1245,7024,7,57,34,23,0.993,1.018
2008/7/30,1345,7022,-2,61,27,34,0.992,0.887
2008/7/31,945,7104,6,55,43,12,0.983,0.67
2008/7/31,1045,7066,-38,51,30,21,0.991,0.917
2008/7/31,1145,6952,-111,131,109,22,1.009,0.712
2008/7/31,1245,6923,-29,104,71,33,1.014,0.982
2008/7/31,1345,6998,76,103,11,92,1.004,0.871
2008/8/1,945,6925,24,83,9,74,1.012,0.928
2008/8/1,1045,6903,-22,70,33,37,1.013,1.124
2008/8/1,1145,6903,2,46,15,31,1.012,1.491
2008/8/1,1245,6940,37,88,29,59,1.005,1.039
2008/8/1,1345,6914,-30,42,43,-1,1.008,1.39
2008/8/4,945,6938,86,89,6,83,1.001,0.989
2008/8/4,1045,6931,-7,41,33,8,0.999,1.398
2008/8/4,1145,6922,-9,68,36,32,0.999,1.232
2008/8/4,1245,6940,18,50,7,43,0.996,1.599
2008/8/4,1345,6934,-6,31,19,12,0.997,1.339
2008/8/5,945,6894,-79,108,99,9,1.004,0.675
2008/8/5,1045,6760,-133,118,120,-2,1.023,0.596
2008/8/5,1145,6828,68,65,-1,66,1.011,0.891
2008/8/5,1245,6794,-34,66,53,13,1.015,0.977
2008/8/5,1345,6778,-17,53,53,0,1.015,1.018
2008/8/6,945,6949,-21,59,20,39,0.992,0.8
2008/8/6,1045,6935,-14,38,27,11,0.994,1.321
2008/8/6,1145,6948,13,41,10,31,0.992,1.4
2008/8/6,1245,6985,37,37,-16,53,0.987,1.913
2008/8/6,1345,7017,32,45,13,32,0.983,0.804
2008/8/7,945,7038,36,73,10,63,0.981,0.875
2008/8/7,1045,6995,-44,62,60,2,0.989,0.97
2008/8/7,1145,6991,-4,34,23,11,0.993,1.177
2008/8/7,1245,7002,11,50,8,42,0.994,1.076
2008/8/7,1345,7006,4,38,18,20,0.996,1.081
2008/8/8,945,7060,119,135,15,120,0.988,0.627
2008/8/8,1045,7151,90,123,7,116,0.977,0.702
2008/8/8,1145,7186,34,80,24,56,0.975,0.826
2008/8/8,1245,7210,24,55,7,48,0.975,1.41
2008/8/8,1345,7189,-20,53,45,8,0.981,0.848
2008/8/11,945,7285,17,52,33,19,0.972,1.065
2008/8/11,1045,7268,-14,57,39,18,0.978,1.339
2008/8/11,1145,7286,19,28,8,20,0.979,1.906
2008/8/11,1245,7326,42,48,9,39,0.978,1.138
2008/8/11,1345,7289,-36,54,50,4,0.987,1.027
2008/8/12,945,7277,-11,48,37,11,0.993,1.029
2008/8/12,1045,7300,22,40,2,38,0.993,1.42
2008/8/12,1145,7270,-29,48,33,15,0.999,1.213
2008/8/12,1245,7319,47,68,14,54,0.994,0.937
2008/8/12,1345,7270,-50,57,55,2,1.002,1.032
2008/8/13,945,7276,18,85,32,53,1.001,0.611
2008/8/13,1045,7249,-30,45,36,9,1.005,0.868
2008/8/13,1145,7224,-24,75,41,34,1.008,0.819
2008/8/13,1245,7252,26,52,6,46,1.003,1.307
2008/8/13,1345,7299,47,44,-5,49,0.996,0.986
2008/8/14,945,7263,-17,56,36,20,1.001,0.9
2008/8/14,1045,7272,9,52,10,42,0.999,1.033
2008/8/14,1145,7269,-3,30,19,11,0.999,1.611
2008/8/14,1245,7342,73,73,-3,76,0.989,1.007
2008/8/14,1345,7363,21,28,1,27,0.987,0.968
2008/8/15,945,7333,-29,56,49,7,0.992,1.019
2008/8/15,1045,7333,1,34,6,28,0.993,1.095
2008/8/15,1145,7358,25,35,-3,38,0.991,2.187
2008/8/15,1245,7182,-176,205,178,27,1.017,0.524
2008/8/15,1345,7216,38,62,16,46,1.011,0.752
2008/8/18,945,7116,-64,110,106,4,1.024,0.88
2008/8/18,1045,7091,-24,42,29,13,1.025,0.986
2008/8/18,1145,7017,-74,103,81,22,1.034,0.853
2008/8/18,1245,6988,-30,81,55,26,1.034,1.021
2008/8/18,1345,6980,-9,55,31,24,1.03,0.99
2008/8/19,945,6909,53,112,16,96,1.034,0.759
2008/8/19,1045,6937,29,74,16,58,1.023,1.12
2008/8/19,1145,6947,8,62,31,31,1.016,1.276
2008/8/19,1245,6936,-12,68,22,46,1.012,1.211
2008/8/19,1345,6936,0,60,27,33,1.008,1.457
2008/8/20,945,6900,-4,49,39,10,1.01,1.417
2008/8/20,1045,6948,48,84,10,74,1,1.546
2008/8/20,1145,6994,44,57,15,42,0.991,1.354
2008/8/20,1245,7019,24,60,33,27,0.987,1.513
2008/8/20,1345,7041,24,44,10,34,0.984,1.525
2008/8/21,945,6906,-32,70,52,18,1.005,0.683
2008/8/21,1045,6893,-11,50,32,18,1.007,0.852
2008/8/21,1145,6905,12,54,23,31,1.004,1.037
2008/8/21,1245,6880,-24,49,24,25,1.007,0.923
2008/8/21,1345,6878,-3,55,38,17,1.007,0.91
2008/8/22,945,6870,25,136,105,31,1.007,0.555
2008/8/22,1045,6802,-69,94,73,21,1.017,0.659
2008/8/22,1145,6811,6,59,14,45,1.013,0.917
2008/8/22,1245,6869,55,95,24,71,1.002,0.862
2008/8/22,1345,6865,-7,75,53,22,1.001,1.024
2008/8/25,945,6915,-41,52,39,13,0.994,1.252
2008/8/25,1045,6936,20,49,9,40,0.991,1.599
2008/8/25,1145,7007,72,94,18,76,0.981,0.895
2008/8/25,1245,7013,9,51,24,27,0.982,1.298
2008/8/25,1345,6988,-25,47,40,7,0.987,1.276
2008/8/26,945,6917,8,49,17,32,0.998,1.058
2008/8/26,1045,6941,23,40,8,32,0.996,1.199
2008/8/26,1145,6926,-16,44,29,15,1,1.48
2008/8/26,1245,6953,27,44,6,38,0.998,1.405
2008/8/26,1345,6946,-7,26,16,10,1,1.488
2008/8/27,945,7025,96,131,3,128,0.988,0.599
2008/8/27,1045,7085,60,71,23,48,0.981,0.688
2008/8/27,1145,7086,-2,48,34,14,0.983,1.042
2008/8/27,1245,7093,6,38,15,23,0.983,1.455
2008/8/27,1345,7082,-9,37,18,19,0.986,1.097
2008/8/28,945,7059,-21,88,79,9,0.992,0.684
2008/8/28,1045,7062,3,48,26,22,0.993,0.988
2008/8/28,1145,7060,-2,30,26,4,0.995,1.553
2008/8/28,1245,7040,-19,46,41,5,1,1.245
2008/8/28,1345,7041,1,26,19,7,1.001,1.359
2008/8/29,945,7113,13,45,25,20,0.993,0.8
2008/8/29,1045,7058,-54,67,59,8,1.002,0.833
2008/8/29,1145,7040,-18,48,19,29,1.004,0.876
2008/8/29,1245,7033,-6,40,28,12,1.005,1.501
2008/8/29,1345,7054,19,33,9,24,1.001,1.237
2008/9/1,945,6883,-97,111,89,22,1.024,0.549
2008/9/1,1045,6825,-58,53,35,18,1.031,0.809
2008/9/1,1145,6816,-10,40,27,13,1.028,1.542
2008/9/1,1245,6761,-57,75,54,21,1.033,0.906
2008/9/1,1345,6756,-7,30,23,7,1.03,1.028
2008/9/2,945,6766,-24,67,31,36,1.024,0.764
2008/9/2,1045,6760,-5,42,26,16,1.02,1.512
2008/9/2,1145,6706,-53,91,60,31,1.023,0.774
2008/9/2,1245,6726,20,104,30,74,1.015,0.766
2008/9/2,1345,6698,-27,89,50,39,1.015,0.936
2008/9/3,945,6711,-3,69,45,24,1.009,0.833
2008/9/3,1045,6613,-100,117,89,28,1.021,0.663
2008/9/3,1145,6612,0,45,25,20,1.018,1.191
2008/9/3,1245,6567,-47,66,63,3,1.022,1.021
2008/9/3,1345,6588,21,28,0,28,1.016,1.245
2008/9/4,945,6581,20,95,49,46,1.014,0.784
2008/9/4,1045,6509,-74,90,83,7,1.022,1.036
2008/9/4,1145,6498,-11,46,26,20,1.02,1.294
2008/9/4,1245,6350,-149,155,155,0,1.04,0.828
2008/9/4,1345,6397,47,65,13,52,1.027,1.023
2008/9/5,945,6316,81,124,14,110,1.032,0.79
2008/9/5,1045,6288,-29,56,31,25,1.031,1.137
2008/9/5,1145,6302,7,53,2,51,1.023,1.568
2008/9/5,1245,6257,-45,65,53,12,1.026,1.496
2008/9/5,1345,6244,-15,45,41,4,1.023,1.338
2008/9/8,945,6610,123,122,0,122,0.965,0.574
2008/9/8,1045,6643,33,62,34,28,0.961,0.994
2008/9/8,1145,6670,26,38,0,38,0.959,2.699
2008/9/8,1245,6677,8,30,0,30,0.961,1.947
2008/9/8,1345,6677,0,0,0,0,0.965,33.332
2008/9/9,945,6483,-111,163,135,28,1,0.496
2008/9/9,1045,6443,-41,91,71,20,1.009,0.841
2008/9/9,1145,6412,-26,71,53,18,1.016,1.122
2008/9/9,1245,6416,5,63,37,26,1.017,1.335
2008/9/9,1345,6466,51,54,-16,70,1.011,1.246
2008/9/10,945,6418,67,171,98,73,1.017,0.453
2008/9/10,1045,6446,28,101,35,66,1.009,0.768
2008/9/10,1145,6470,24,46,15,31,1.003,1.158
2008/9/10,1245,6409,-60,78,65,13,1.009,1.187
2008/9/10,1345,6453,45,86,7,79,0.998,1.037
2008/9/11,945,6335,-102,166,77,89,1.014,0.609
2008/9/11,1045,6284,-49,78,66,12,1.02,1.003
2008/9/11,1145,6220,-64,75,58,17,1.028,1.019
2008/9/11,1245,6232,13,65,48,17,1.023,1.416
2008/9/11,1345,6230,0,49,35,14,1.02,1.303
2008/9/12,945,6254,-100,100,86,14,1.016,0.916
2008/9/12,1045,6190,-65,112,75,37,1.024,0.794
2008/9/12,1145,6258,68,113,31,82,1.009,0.907
2008/9/12,1245,6312,53,72,5,67,0.997,1.085
2008/9/12,1345,6288,-23,65,57,8,0.999,1.109
2008/9/15,945,6128,-2,103,62,41,1.02,0.916
2008/9/15,1045,6099,-31,39,41,-2,1.022,1.953
2008/9/15,1145,6000,-100,72,70,2,1.036,0.936
2008/9/15,1245,5977,-23,135,21,114,1.036,0.753
2008/9/15,1345,5967,-11,54,28,26,1.034,1.102
2008/9/16,945,5785,-64,130,70,60,1.057,0.602
2008/9/16,1045,5733,-52,94,56,38,1.059,0.884
2008/9/16,1145,5772,40,64,13,51,1.044,1.356
2008/9/16,1245,5712,-62,81,83,-2,1.046,1.556
2008/9/16,1345,5685,-27,55,49,6,1.041,1.181
2008/9/17,945,5901,-15,119,98,21,0.999,0.866
2008/9/17,1045,5870,-31,71,22,49,1,1.287
2008/9/17,1145,5781,-89,108,84,24,1.012,1.284
2008/9/17,1245,5770,-12,93,74,19,1.01,1.5
2008/9/17,1345,5767,-3,59,11,48,1.007,1.668
2008/9/18,945,5493,-58,99,97,2,1.052,0.583
2008/9/18,1045,5497,4,164,83,81,1.046,0.605
2008/9/18,1145,5479,-16,101,78,23,1.045,0.89
2008/9/18,1245,5460,-19,56,31,25,1.043,1.073
2008/9/18,1345,5522,62,99,27,72,1.027,0.849
2008/9/19,945,5908,102,123,0,123,0.958,0.616
2008/9/19,1045,5897,-11,16,11,5,0.96,3.656
2008/9/19,1145,5898,1,34,10,24,0.96,3.09
2008/9/19,1345,5908,0,6,0,6,0.96,7.364
2008/9/22,945,6019,-101,101,73,28,0.948,0.763
2008/9/22,1045,5981,-38,84,59,25,0.962,0.948
2008/9/22,1145,6020,38,73,15,58,0.964,1.15
2008/9/22,1245,6070,50,77,8,69,0.965,1.123
2008/9/22,1345,6089,20,56,0,56,0.972,0.92
2008/9/23,945,6040,10,60,15,45,0.989,0.693
2008/9/23,1045,6071,29,96,47,49,0.988,0.682
2008/9/23,1145,6085,14,49,25,24,0.988,1.209
2008/9/23,1245,6087,1,30,10,20,0.991,1.787
2008/9/23,1345,6135,49,66,15,51,0.986,1.089
2008/9/24,945,6132,15,71,14,57,0.986,0.896
2008/9/24,1045,6136,5,58,19,39,0.988,1.003
2008/9/24,1145,6177,41,47,1,46,0.984,1.152
2008/9/24,1245,6111,-66,112,84,28,0.997,0.721
2008/9/24,1345,6155,46,54,-1,55,0.99,1.123
2008/9/25,945,6059,59,64,9,55,1.006,0.865
2008/9/25,1045,6107,49,55,6,49,0.998,0.904
2008/9/25,1145,6100,-9,74,59,15,1,0.892
2008/9/25,1245,6085,-15,54,21,33,1.002,1.031
2008/9/25,1345,6058,-27,49,33,16,1.007,1.184
2008/9/26,945,5966,-84,156,95,61,1.021,0.639
2008/9/26,1045,5878,-88,118,100,18,1.034,0.864
2008/9/26,1145,5861,-16,50,39,11,1.032,1.406
2008/9/26,1245,5865,4,49,7,42,1.026,1.375
2008/9/26,1345,5866,2,54,7,47,1.022,1.115
2008/9/30,945,5459,0,16,16,0,1.088,1.63
2008/9/30,1045,5465,6,5,-1,6,1.076,3.761
2008/9/30,1145,5494,30,39,4,35,1.059,1.639
2008/9/30,1245,5497,3,101,90,11,1.047,0.835
2008/9/30,1345,5549,51,66,13,53,1.027,1.152
2008/10/1,945,5687,88,88,31,57,0.994,0.556
2008/10/1,1045,5660,-27,72,35,37,0.994,0.856
2008/10/1,1145,5635,-24,40,36,4,0.994,1.18
2008/10/1,1245,5692,54,67,6,61,0.98,1.155
2008/10/1,1345,5676,-15,43,35,8,0.98,1.071
2008/10/2,945,5645,-76,148,91,57,0.99,0.501
2008/10/2,1045,5620,-25,52,39,13,0.998,0.992
2008/10/2,1145,5639,20,55,11,44,0.997,1.227
2008/10/2,1245,5565,-74,86,76,10,1.013,1.067
2008/10/2,1345,5618,53,65,10,55,1.005,1.158
2008/10/3,945,5506,-44,88,72,16,1.024,0.748
2008/10/3,1045,5545,39,54,4,50,1.014,1.281
2008/10/3,1145,5609,64,71,18,53,1,0.877
2008/10/3,1245,5611,2,44,4,40,0.999,1.539
2008/10/3,1345,5645,32,70,40,30,0.992,0.817
2008/10/6,945,5443,-45,46,34,12,1.024,0.788
2008/10/6,1045,5430,-13,48,15,33,1.023,1.048
2008/10/6,1145,5467,36,60,17,43,1.013,1.248
2008/10/6,1245,5408,-59,72,75,-3,1.021,1.175
2008/10/6,1345,5387,-22,44,45,-1,1.022,1.1
2008/10/7,945,5387,137,137,1,136,1.016,0.625
2008/10/7,1045,5381,-5,52,21,31,1.015,1.148
2008/10/7,1145,5450,68,107,13,94,0.999,0.814
2008/10/7,1245,5448,-2,45,27,18,0.997,1.013
2008/10/7,1345,5445,-2,54,40,14,0.994,0.975
2008/10/8,945,5304,55,80,41,39,1.016,0.71
2008/10/8,1045,5287,-15,52,30,22,1.017,0.938
2008/10/8,1145,5218,-70,72,67,5,1.027,0.993
2008/10/8,1245,5139,-78,117,103,14,1.038,0.918
2008/10/8,1345,5112,-25,92,45,47,1.038,0.749
2008/10/9,945,5170,-16,74,24,50,1.025,0.781
2008/10/9,1045,5240,69,111,5,106,1.008,0.874
2008/10/9,1145,5240,0,43,14,29,1.005,1.315
2008/10/9,1245,5096,-143,155,146,9,1.029,0.867
2008/10/9,1345,5062,-35,76,72,4,1.029,0.993
2008/10/13,945,4922,37,87,56,31,1.051,1.118
2008/10/13,1045,4901,-22,40,29,11,1.048,2.004
2008/10/13,1145,4911,10,26,6,20,1.038,3.043
2008/10/13,1245,4931,17,44,22,22,1.028,1.684
2008/10/13,1345,4945,15,53,21,32,1.02,1.226
2008/10/14,945,5267,-19,50,19,31,0.96,0.839
2008/10/14,1045,5266,-2,32,21,11,0.962,1.235
2008/10/14,1145,5287,21,24,0,24,0.959,2.64
2008/10/14,1245,5287,0,0,0,0,0.96,27.269
2008/10/14,1345,5287,5287,0,0,0,0.863,52.058
2008/10/15,945,5216,-81,70,47,23,0.883,0.546
2008/10/15,1045,5189,-27,59,23,36,0.893,0.787
2008/10/15,1145,5202,12,51,23,28,0.896,1.144
2008/10/15,1245,5179,-24,43,37,6,0.906,1.215
2008/10/15,1345,5245,64,67,1,66,0.899,1.037
2008/10/16,945,4978,0,0,0,0,0.941,9.966
2008/10/17,945,4854,-40,167,124,43,0.958,0.315
2008/10/17,1045,4846,-8,37,19,18,0.951,0.821
2008/10/17,1145,4846,0,44,38,6,0.942,0.79
2008/10/17,1245,4804,-42,53,56,-3,1.051,0.983
2008/10/17,1345,4804,0,0,0,0,1.041,5.268
2008/10/20,945,4637,-167,149,148,1,1.069,0.482
2008/10/20,1045,4651,11,39,24,15,1.054,1.24
2008/10/20,1145,4666,12,38,19,19,1.039,1.588
2008/10/20,1245,4791,127,166,25,141,1.001,0.65
2008/10/20,1345,4823,32,73,4,69,0.991,0.766
2008/10/21,945,4890,-40,90,60,30,0.978,0.54
2008/10/21,1045,4806,-82,115,109,6,0.995,0.663
2008/10/21,1145,4819,11,72,28,44,0.992,0.858
2008/10/21,1245,4773,-45,87,49,38,1.001,0.89
2008/10/21,1345,4817,45,97,27,70,0.991,0.868
2008/10/22,945,4809,71,125,11,114,0.991,0.768
2008/10/22,1045,4796,-11,83,59,24,0.998,0.865
2008/10/22,1145,4732,-63,75,73,2,1.014,1.017
2008/10/22,1245,4724,-8,61,40,21,1.017,1.385
2008/10/22,1345,4656,-66,92,86,6,1.031,1.009
2008/10/23,945,4494,0,34,34,0,1.058,1.75
2008/10/23,1045,4496,2,8,6,2,1.049,4.436
2008/10/23,1245,4494,0,5,5,0,1.042,3.973
2008/10/23,1345,4494,0,15,15,0,1.035,2.771
2008/10/24,945,4348,-47,98,91,7,1.061,0.688
2008/10/24,1045,4337,-12,21,21,0,1.055,1.91
2008/10/27,945,4138,12,265,199,66,1.089,0.458
2008/10/27,1045,4088,-50,101,95,6,1.087,0.663
2008/10/27,1145,4044,-44,65,55,10,1.082,0.743
2008/10/27,1245,4034,-9,25,25,0,1.068,1.86
2008/10/27,1345,4034,-1,3,3,0,1.057,9.941
2008/10/28,945,3873,-48,174,112,62,1.086,0.461
2008/10/28,1045,4140,269,290,5,285,1.001,0.502
2008/10/28,1145,4115,-22,152,36,116,0.998,0.663
2008/10/28,1245,4302,186,255,13,242,0.948,0.64
2008/10/28,1345,4316,14,21,0,21,0.944,1.769
2008/10/29,945,4501,-117,155,114,41,0.916,0.737
2008/10/29,1045,4368,-132,138,120,18,0.953,0.792
2008/10/29,1145,4415,47,147,69,78,0.949,0.75
2008/10/29,1245,4290,-127,213,158,55,0.985,0.79
2008/10/29,1345,4288,0,98,22,76,0.992,1.243
2008/10/30,945,4548,172,233,46,187,0.945,0.682
2008/10/30,1045,4594,45,44,0,44,0.95,1.939
2008/10/30,1145,4594,0,9,0,9,0.96,5.659
2008/10/31,945,4679,85,220,71,149,0.953,0.668
2008/10/31,1045,4654,-25,113,50,63,0.966,0.919
2008/10/31,1145,4784,130,190,25,165,0.941,0.926
2008/10/31,1245,4884,101,155,26,129,0.927,0.989
2008/10/31,1345,4844,-42,98,51,47,0.945,1.226
2008/11/3,945,4850,-60,115,49,66,0.954,0.976
2008/11/3,1045,4951,101,98,5,93,0.946,0.933
2008/11/3,1145,4875,-77,123,100,23,0.973,1.107
2008/11/3,1245,4900,20,105,65,40,0.975,1.05
2008/11/3,1345,4992,95,96,2,94,0.963,1.156
2008/11/4,945,4873,-92,121,116,5,0.994,1.08
2008/11/4,1045,4848,-25,51,39,12,1.003,1.247
2008/11/4,1145,4922,73,91,11,80,0.992,1.172
2008/11/4,1245,4887,-38,83,80,3,1.002,1.043
2008/11/4,1345,4978,91,131,29,102,0.984,0.938
2008/11/5,945,4976,-104,155,124,31,0.987,0.801
2008/11/5,1045,5042,67,80,7,73,0.977,1.047
2008/11/5,1145,5014,-29,74,60,14,0.984,1.181
2008/11/5,1245,4965,-50,101,68,33,0.997,1.01
2008/11/5,1345,4900,-68,91,84,7,1.011,1.098
2008/11/6,945,4580,-100,140,120,20,1.076,0.729
2008/11/6,1045,4588,10,48,25,23,1.068,1.803
2008/11/6,1145,4557,-31,38,38,0,1.069,3.436
2008/11/6,1345,4557,0,0,0,0,1.061,111.711
2008/11/7,945,4450,140,183,5,178,1.074,0.573
2008/11/7,1045,4555,105,148,34,114,1.035,0.675
2008/11/7,1145,4560,5,141,43,98,1.025,0.667
2008/11/7,1245,4630,71,102,22,80,0.999,0.86
2008/11/7,1345,4633,1,85,29,56,0.99,1.022
2008/11/10,945,4630,-28,129,50,79,0.984,0.806
2008/11/10,1045,4661,34,74,25,49,0.976,0.971
2008/11/10,1145,4597,-66,75,53,22,0.991,1.032
2008/11/10,1245,4639,43,67,9,58,0.983,1.366
2008/11/10,1345,4632,-7,41,23,18,0.986,1.764
2008/11/11,945,4534,57,94,30,64,1.011,0.981
2008/11/11,1045,4506,-27,62,29,33,1.019,1.2
2008/11/11,1145,4598,94,129,31,98,0.997,0.846
2008/11/11,1245,4605,7,64,40,24,0.997,1.232
2008/11/11,1345,4474,-130,150,150,0,1.025,1.045
2008/11/12,945,4568,80,92,7,85,1.001,0.815
2008/11/12,1045,4520,-51,94,76,18,1.01,0.874
2008/11/12,1145,4512,-8,61,42,19,1.009,1.05
2008/11/12,1245,4524,12,113,9,104,1.004,0.901
2008/11/12,1345,4521,-1,65,29,36,1.002,1.234
2008/11/13,945,4270,-35,80,61,19,1.057,0.873
2008/11/13,1045,4280,10,74,25,49,1.048,1.279
2008/11/13,1145,4275,-2,53,23,30,1.044,1.586
2008/11/13,1245,4207,-70,69,68,1,1.054,1.346
2008/11/13,1345,4285,78,79,0,79,1.025,1.493
2008/11/14,945,4413,-86,89,72,17,0.996,0.752
2008/11/14,1045,4399,-14,60,33,27,0.995,0.934
2008/11/14,1145,4372,-24,69,51,18,0.999,1.016
2008/11/14,1245,4372,-1,60,37,23,0.995,1.083
2008/11/14,1345,4380,9,64,29,35,0.99,0.965
2008/11/17,945,4390,110,123,8,115,0.987,0.735
2008/11/17,1045,4385,-5,55,35,20,0.991,1.061
2008/11/17,1145,4411,26,98,18,80,0.988,0.973
2008/11/17,1245,4377,-34,56,55,1,0.998,1.219
2008/11/17,1345,4357,-19,59,63,-4,1.007,1.422
2008/11/18,945,4294,-57,66,37,29,1.018,0.867
2008/11/18,1045,4261,-32,81,70,11,1.023,0.993
2008/11/18,1145,4264,4,40,30,10,1.019,1.352
2008/11/18,1245,4228,-36,70,49,21,1.026,1.098
2008/11/18,1345,4244,14,60,31,29,1.018,1.115
2008/11/19,945,4262,24,84,27,57,1.013,0.95
2008/11/19,1045,4224,-38,56,45,11,1.019,1.492
2008/11/19,1145,4207,-17,50,26,24,1.019,1.469
2008/11/19,1245,4239,32,53,15,38,1.007,1.732
2008/11/19,1345,4261,22,54,19,35,0.999,1.457
2008/11/20,945,4008,55,72,17,55,1.052,0.73
2008/11/20,1045,3984,-24,53,43,10,1.051,0.918
2008/11/20,1145,3965,-19,53,49,4,1.049,1.093
2008/11/20,1245,3890,-75,98,80,18,1.061,0.745
2008/11/20,1345,3903,8,49,12,37,1.049,1
2008/11/21,945,3880,0,111,46,65,1.046,0.517
2008/11/21,1045,3874,-6,52,26,26,1.038,0.98
2008/11/21,1145,3924,49,71,20,51,1.016,0.853
2008/11/21,1245,4090,166,208,39,169,0.968,0.623
2008/11/21,1345,4121,32,40,-8,48,0.957,0.982
2008/11/24,945,4043,-38,86,65,21,0.979,0.948
2008/11/24,1045,4037,-6,60,5,55,0.981,1.028
2008/11/24,1145,3982,-55,63,53,10,0.996,1.4
2008/11/24,1245,4048,66,75,4,71,0.98,1.171
2008/11/24,1345,4045,-3,42,50,-8,0.984,1.075
2008/11/25,945,4205,-17,83,42,41,0.955,0.841
2008/11/25,1045,4270,65,97,15,82,0.948,0.853
2008/11/25,1145,4203,-68,72,72,0,0.973,1.162
2008/11/25,1245,4153,-51,74,52,22,0.991,0.86
2008/11/25,1345,4199,46,92,5,87,0.982,0.916
2008/11/26,945,4237,0,74,13,61,0.977,0.83
2008/11/26,1045,4248,14,63,20,43,0.979,1.002
2008/11/26,1145,4247,-2,74,17,57,0.984,1.156
2008/11/26,1245,4217,-30,70,38,32,0.997,1.116
2008/11/26,1345,4209,-4,47,38,9,1.003,1.336
2008/11/27,945,4363,33,83,12,71,0.97,0.866
2008/11/27,1045,4368,5,38,17,21,0.973,1.347
2008/11/27,1145,4455,87,109,14,95,0.956,1.046
2008/11/27,1245,4439,-14,39,26,13,0.965,1.223
2008/11/27,1345,4430,-9,68,58,10,0.973,0.918
2008/11/28,945,4404,-31,62,46,16,0.983,0.88
2008/11/28,1045,4426,23,71,37,34,0.982,1.154
2008/11/28,1145,4425,-1,32,23,9,0.987,1.474
2008/11/28,1245,4437,12,49,18,31,0.988,1.28
2008/11/28,1345,4460,24,33,-2,35,0.988,1.305
2008/12/1,945,4423,3,51,17,34,0.998,0.918
2008/12/1,1045,4528,105,120,7,113,0.976,0.7
2008/12/1,1145,4548,21,32,20,12,0.975,0.883
2008/12/1,1245,4568,18,31,12,19,0.973,1.219
2008/12/1,1345,4501,-69,78,77,1,0.991,0.912
2008/12/2,945,4296,-3,47,22,25,1.035,0.832
2008/12/2,1045,4300,3,36,24,12,1.031,1.202
2008/12/2,1145,4286,-14,39,29,10,1.032,1.339
2008/12/2,1245,4230,-57,84,60,24,1.042,0.955
2008/12/2,1345,4240,10,34,10,24,1.035,1.235
2008/12/3,945,4297,29,64,9,55,1.018,0.81
2008/12/3,1045,4267,-31,47,33,14,1.022,0.963
2008/12/3,1145,4242,-25,62,45,17,1.022,1.003
2008/12/3,1245,4236,-4,35,19,16,1.016,1.38
2008/12/3,1345,4188,-48,66,68,-2,1.02,1.071
2008/12/4,945,4252,6,38,21,17,1.003,0.927
2008/12/4,1045,4209,-43,82,75,7,1.012,0.971
2008/12/4,1145,4172,-39,48,42,6,1.019,0.942
2008/12/4,1245,4116,-56,81,69,12,1.03,0.857
2008/12/4,1345,4139,24,54,15,39,1.022,0.992
2008/12/5,945,4164,-6,68,24,44,1.013,0.883
2008/12/5,1045,4163,-2,48,17,31,1.01,1.055
2008/12/5,1145,4167,2,51,35,16,1.007,1.041
2008/12/5,1245,4120,-47,78,61,17,1.016,1.009
2008/12/5,1345,4179,59,64,0,64,0.999,1.267
2008/12/8,945,4350,105,119,7,112,0.96,0.633
2008/12/8,1045,4442,93,72,-8,80,0.942,0.891
2008/12/8,1145,4437,-7,29,15,14,0.949,1.294
2008/12/8,1245,4471,34,35,0,35,0.947,1.222
2008/12/8,1345,4471,0,3,0,3,0.955,5.095
2008/12/9,945,4462,-33,58,46,12,0.964,0.743
2008/12/9,1045,4497,33,33,-12,45,0.964,1.183
2008/12/9,1145,4458,-38,84,88,-4,0.979,0.693
2008/12/9,1245,4466,8,38,16,22,0.984,1.161
2008/12/9,1345,4460,-6,39,29,10,0.993,1.031
2008/12/10,945,4571,85,111,11,100,0.974,0.697
2008/12/10,1045,4598,25,61,15,46,0.974,0.853
2008/12/10,1145,4591,-8,49,34,15,0.978,1.026
2008/12/10,1245,4642,52,49,-4,53,0.971,1.037
2008/12/10,1345,4691,49,86,33,53,0.965,0.818
2008/12/11,945,4651,0,74,48,26,0.976,0.829
2008/12/11,1045,4679,28,40,6,34,0.974,1.117
2008/12/11,1145,4674,-6,64,30,34,0.979,1.063
2008/12/11,1245,4666,-6,52,18,34,0.986,1.441
2008/12/11,1345,4666,0,26,11,15,0.99,1.442
2008/12/12,945,4609,39,52,11,41,1.004,0.973
2008/12/12,1045,4629,21,42,14,28,1,1.132
2008/12/12,1145,4415,-219,219,218,1,1.05,0.579
2008/12/12,1245,4385,-28,71,29,42,1.053,0.861
2008/12/12,1345,4425,40,79,19,60,1.037,1.316
2008/12/15,945,4671,56,103,47,56,0.982,0.802
2008/12/15,1045,4667,-3,32,21,11,0.983,1.578
2008/12/15,1145,4580,-88,114,87,27,1.002,0.753
2008/12/15,1245,4621,42,70,19,51,0.991,1.065
2008/12/15,1345,4610,-7,48,35,13,0.992,1.259
2008/12/16,945,4538,-11,48,40,8,1.007,1.145
2008/12/16,1045,4551,12,59,40,19,1.003,1.252
2008/12/16,1145,4575,24,38,6,32,0.996,1.48
2008/12/16,1245,4569,-6,33,18,15,1.001,1.531
2008/12/16,1345,4585,15,57,29,28,1.001,1.233
2008/12/17,945,4682,-6,44,28,16,0.982,1.164
2008/12/17,1045,4721,41,58,13,45,0.974,1.54
2008/12/17,1145,4668,-52,75,57,18,0.986,1.205
2008/12/17,1245,4643,-25,46,25,21,0.994,1.537
2008/12/18,945,4616,-64,64,63,1,1.001,0.587
2008/12/18,1045,4615,-3,47,29,18,1.003,0.944
2008/12/18,1145,4647,33,64,17,47,0.997,0.854
2008/12/18,1245,4635,-12,48,25,23,1.002,0.92
2008/12/18,1345,4699,63,83,6,77,0.99,0.923
2008/12/19,945,4676,14,57,28,29,0.996,0.813
2008/12/19,1045,4609,-68,103,76,27,1.011,0.642
2008/12/19,1145,4637,27,48,3,45,1.003,1.136
2008/12/19,1245,4695,58,84,25,59,0.989,0.757
2008/12/19,1345,4680,-16,74,44,30,0.993,0.891
2008/12/22,945,4685,-35,83,70,13,0.992,0.867
2008/12/22,1045,4635,-50,82,80,2,1.005,1.045
2008/12/22,1145,4638,1,46,10,36,1.004,1.165
2008/12/22,1245,4577,-61,72,73,-1,1.018,1.151
2008/12/22,1345,4529,-48,77,46,31,1.027,0.949
2008/12/23,945,4407,-100,131,117,14,1.052,0.795
2008/12/23,1045,4317,-90,116,97,19,1.068,0.855
2008/12/23,1145,4328,11,53,15,38,1.058,1.136
2008/12/23,1245,4325,-3,50,30,20,1.052,1.36
2008/12/23,1345,4349,22,55,29,26,1.038,1.081
2008/12/24,945,4340,30,122,23,99,1.03,0.708
2008/12/24,1045,4334,-6,85,51,34,1.024,0.835
2008/12/24,1145,4352,15,50,20,30,1.013,1.209
2008/12/24,1245,4366,14,45,11,34,1.003,1.556
2008/12/24,1345,4379,13,31,20,11,0.995,1.328
2008/12/25,945,4355,-25,60,35,25,0.998,1.476
2008/12/25,1045,4356,1,32,18,14,0.996,1.835
2008/12/25,1145,4352,-3,29,16,13,0.998,2.511
2008/12/25,1245,4362,10,17,3,14,0.996,4.137
2008/12/25,1345,4405,43,36,-9,45,0.987,1.601
2008/12/26,945,4377,5,48,10,38,0.995,0.974
2008/12/26,1045,4395,19,77,50,27,0.992,0.669
2008/12/26,1145,4406,11,47,28,19,0.991,0.948
2008/12/26,1245,4365,-41,34,39,-5,1.001,0.932
2008/12/26,1345,4378,13,38,17,21,0.998,1.089
2008/12/29,945,4343,-23,37,22,15,1.006,0.893
2008/12/29,1045,4339,-4,29,6,23,1.006,1.016
2008/12/29,1145,4345,7,23,5,18,1.005,1.719
2008/12/29,1245,4362,16,22,-2,24,1.001,1.886
2008/12/29,1345,4386,23,41,13,28,0.995,1
2008/12/30,945,4520,91,114,19,95,0.967,0.529
2008/12/30,1045,4535,15,33,14,19,0.967,0.971
2008/12/30,1145,4548,14,29,9,20,0.967,1.433
2008/12/30,1245,4578,30,58,27,31,0.964,0.773
2008/12/30,1345,4565,-13,30,21,9,0.971,0.806
2008/12/31,945,4571,-34,54,43,11,0.975,0.744
2008/12/31,1045,4580,9,25,10,15,0.978,1.356
2008/12/31,1145,4572,-8,29,24,5,0.985,1.512
2008/12/31,1245,4499,-72,94,80,14,1.006,0.725
2008/12/31,1345,4540,40,69,23,46,1,0.861
2009/1/5,945,4759,37,105,38,67,0.96,0.542
2009/1/5,1045,4731,-27,57,36,21,0.971,0.95
2009/1/5,1145,4671,-62,93,56,37,0.988,0.647
2009/1/5,1245,4679,7,47,4,43,0.989,1.264
2009/1/5,1345,4670,-9,42,28,14,0.993,1.033
2009/1/6,945,4688,-11,66,28,38,0.991,0.816
2009/1/6,1045,4722,34,67,13,54,0.986,1.002
2009/1/6,1145,4710,-12,41,25,16,0.992,1.112
2009/1/6,1245,4664,-45,69,43,26,1.005,0.867
2009/1/6,1345,4706,40,48,2,46,0.999,1.355
2009/1/7,945,4745,-13,65,57,8,0.992,0.71
2009/1/7,1045,4732,-13,44,23,21,0.994,0.878
2009/1/7,1145,4748,17,29,10,19,0.991,1.322
2009/1/7,1245,4749,3,39,16,23,0.992,1.238
2009/1/7,1345,4752,2,28,14,14,0.993,1.338
2009/1/8,945,4626,-24,33,12,21,1.019,0.921
2009/1/8,1045,4558,-68,93,70,23,1.033,0.769
2009/1/8,1145,4527,-29,54,42,12,1.036,1.367
2009/1/8,1245,4499,-28,44,25,19,1.039,1.018
2009/1/8,1345,4452,-48,79,61,18,1.046,0.936
2009/1/9,945,4455,8,72,22,50,1.038,0.73
2009/1/9,1045,4456,1,43,32,11,1.032,0.95
2009/1/9,1145,4471,14,33,-2,35,1.022,1.311
2009/1/9,1245,4483,12,41,12,29,1.013,1.052
2009/1/9,1345,4421,-62,59,59,0,1.021,1.239
2009/1/10,945,4403,41,78,19,59,1.019,1.08
2009/1/10,1045,4404,1,34,21,13,1.014,1.391
2009/1/10,1145,4410,6,14,3,11,1.009,3.763
2009/1/10,1245,4370,-37,63,48,15,1.015,1.255
2009/1/10,1345,4374,3,34,30,4,1.011,1.418
2009/1/12,945,4450,64,95,22,73,0.993,0.646
2009/1/12,1045,4400,-52,47,49,-2,1.004,0.818
2009/1/12,1145,4384,-16,43,9,34,1.006,0.794
2009/1/12,1245,4373,-11,49,27,22,1.007,0.973
2009/1/12,1345,4429,56,66,5,61,0.992,0.772
2009/1/13,945,4420,59,66,11,55,0.994,0.749
2009/1/13,1045,4415,-5,53,29,24,0.995,0.835
2009/1/13,1145,4444,29,50,8,42,0.989,1.118
2009/1/13,1245,4440,-5,37,25,12,0.991,1.104
2009/1/13,1345,4518,78,85,0,85,0.975,0.824
2009/1/14,945,4508,18,41,28,13,0.98,0.982
2009/1/14,1045,4525,18,35,20,15,0.977,1.145
2009/1/14,1145,4514,-11,49,38,11,0.982,1.092
2009/1/14,1245,4512,-2,40,6,34,0.986,1.064
2009/1/14,1345,4510,-2,33,12,21,0.989,1.241
2009/1/15,945,4273,51,60,12,48,1.041,0.669
2009/1/15,1045,4272,-2,30,13,17,1.038,1.317
2009/1/15,1145,4264,-9,29,18,11,1.036,1.725
2009/1/15,1245,4271,7,14,5,9,1.03,2.138
2009/1/15,1345,4239,-33,52,43,9,1.034,1.012
2009/1/16,945,4302,25,47,17,30,1.014,0.797
2009/1/16,1045,4296,-7,26,11,15,1.011,1.225
2009/1/16,1145,4281,-15,47,16,31,1.009,0.848
2009/1/16,1245,4300,18,32,0,32,0.999,1.446
2009/1/16,1345,4323,23,37,6,31,0.989,0.888
2009/1/17,945,4316,-14,34,29,5,0.993,1.279
2009/1/17,1045,4330,14,34,10,24,0.991,1.58
2009/1/17,1145,4340,10,34,14,20,0.99,1.861
2009/1/17,1245,4342,2,17,8,9,0.991,2.491
2009/1/17,1345,4349,7,30,9,21,0.991,1.457
2009/1/19,945,4355,-23,54,34,20,0.992,0.742
2009/1/19,1045,4358,3,21,11,10,0.992,1.171
2009/1/19,1145,4349,-9,19,14,5,0.996,1.646
2009/1/19,1245,4344,-5,25,6,19,0.999,0.973
2009/1/19,1345,4357,14,24,3,21,0.997,0.902
2009/1/20,945,4242,-24,49,12,37,1.022,0.573
2009/1/20,1045,4247,4,17,6,11,1.019,1.63
2009/1/20,1145,4241,-6,14,11,3,1.019,1.752
2009/1/20,1245,4240,-1,18,3,15,1.017,1.263
2009/1/20,1345,4240,-1,16,9,7,1.014,1.016
2009/1/21,945,4199,85,77,18,59,1.018,0.768
2009/1/21,1045,4222,23,44,17,27,1.009,1.075
2009/1/21,1145,4236,14,27,6,21,1.002,1.616
2009/1/21,1245,4231,-5,26,16,10,1,1.907
2009/2/2,945,4182,-17,159,83,76,1.009,0.42
2009/2/2,1045,4176,-6,28,17,11,1.008,0.936
2009/2/2,1145,4185,9,23,10,13,1.004,1.203
2009/2/2,1245,4155,-31,42,39,3,1.01,1.143
2009/2/2,1345,4161,6,20,8,12,1.007,1.09
2009/2/3,945,4256,88,97,13,84,0.983,0.497
2009/2/3,1045,4290,34,40,5,35,0.978,0.725
2009/2/3,1145,4322,33,51,6,45,0.973,0.834
2009/2/3,1245,4307,-15,24,15,9,0.979,1.151
2009/2/3,1345,4275,-32,37,34,3,0.988,0.784
2009/2/4,945,4322,-5,49,28,21,0.98,0.755
2009/2/4,1045,4321,-1,20,16,4,0.983,1.408
2009/2/4,1145,4303,-17,44,26,18,0.991,1.07
2009/2/4,1245,4358,56,75,17,58,0.981,1.01
2009/2/4,1345,4351,-7,28,22,6,0.987,0.973
2009/2/5,945,4324,9,36,9,27,0.997,0.955
2009/2/5,1045,4316,-7,41,11,30,1,1.101
2009/2/5,1145,4345,28,41,6,35,0.994,0.943
2009/2/5,1245,4357,14,49,32,17,0.992,0.882
2009/2/5,1345,4270,-87,82,81,1,1.013,0.627
2009/2/6,945,4443,81,113,26,87,0.974,0.601
2009/2/6,1045,4469,27,29,-5,34,0.972,1.251
2009/2/6,1145,4437,-33,54,42,12,0.982,0.96
2009/2/6,1245,4408,-29,45,42,3,0.991,0.965
2009/2/6,1345,4443,35,47,0,47,0.985,0.994
2009/2/9,945,4488,-12,44,34,10,0.979,1.017
2009/2/9,1045,4477,-11,24,17,7,0.985,1.416
2009/2/9,1145,4458,-21,37,19,18,0.993,1.107
2009/2/9,1245,4451,-9,29,24,5,0.997,1.62
2009/2/9,1345,4456,5,35,4,31,0.998,1.111
2009/2/10,945,4450,-6,39,24,15,1.002,1.102
2009/2/10,1045,4470,21,42,13,29,0.997,1.184
2009/2/10,1145,4472,1,29,22,7,0.997,1.21
2009/2/10,1245,4472,0,19,5,14,0.998,1.595
2009/2/10,1345,4497,26,32,0,32,0.993,1.011
2009/2/11,945,4428,43,50,-3,53,1.006,0.69
2009/2/11,1045,4440,13,28,11,17,1.002,0.859
2009/2/11,1145,4457,17,38,7,31,0.998,0.99
2009/2/11,1245,4483,25,44,15,29,0.992,0.842
2009/2/11,1345,4558,76,95,20,75,0.976,0.601
2009/2/12,945,4515,-5,66,42,24,0.987,0.731
2009/2/12,1045,4470,-45,93,94,-1,0.998,0.635
2009/2/12,1145,4428,-41,71,41,30,1.008,0.656
2009/2/12,1245,4437,10,35,3,32,1.005,1.268
2009/2/12,1345,4445,8,47,2,45,1.002,1.049
2009/2/13,945,4485,26,60,35,25,0.995,0.878
2009/2/13,1045,4533,48,60,12,48,0.985,0.932
2009/2/13,1145,4550,17,38,10,28,0.984,1.113
2009/2/13,1245,4565,17,35,0,35,0.983,1.303
2009/2/13,1345,4571,4,30,19,11,0.983,1.023
2009/2/16,945,4575,6,42,9,33,0.983,1.242
2009/2/16,1045,4567,-8,30,21,9,0.986,1.516
2009/2/16,1145,4553,-14,31,12,19,0.992,1.367
2009/2/16,1245,4576,23,28,0,28,0.989,1.971
2009/2/16,1345,4575,0,19,6,13,0.993,1.547
2009/2/17,945,4472,-49,96,87,9,1.017,0.61
2009/2/17,1045,4471,-1,35,1,34,1.017,0.994
2009/2/17,1145,4479,8,21,-1,22,1.014,1.654
2009/2/17,1245,4473,-7,33,15,18,1.013,1.306
2009/2/17,1345,4494,22,33,0,33,1.007,1.065
2009/2/18,945,4466,11,60,20,40,1.01,0.87
2009/2/18,1045,4463,-3,29,21,8,1.009,1.722
2009/2/18,1145,4460,-5,22,8,14,1.007,2.036
2009/2/18,1245,4480,21,30,2,28,1,2.667
2009/2/19,945,4375,-36,185,144,41,1.021,0.41
2009/2/19,1045,4390,13,36,9,27,1.014,0.998
2009/2/19,1145,4476,86,109,22,87,0.992,0.459
2009/2/19,1245,4498,23,45,26,19,0.988,0.749
2009/2/19,1345,4468,-31,63,51,12,0.995,0.763
2009/2/20,945,4379,-26,69,60,9,1.013,0.717
2009/2/20,1045,4386,7,31,12,19,1.01,1.306
2009/2/20,1145,4404,17,83,49,34,1.004,0.747
2009/2/20,1245,4356,-47,62,51,11,1.014,1.083
2009/2/20,1345,4363,6,25,21,4,1.01,1.538
2009/2/23,945,4376,44,89,9,80,1.005,0.72
2009/2/23,1045,4419,43,48,6,42,0.995,1.004
2009/2/23,1145,4397,-23,51,36,15,1.001,1.248
2009/2/23,1245,4405,8,40,23,17,0.997,1.613
2009/2/23,1345,4426,22,34,3,31,0.99,1.37
2009/2/24,945,4353,26,65,27,38,1.005,0.811
2009/2/24,1045,4345,-8,39,34,5,1.007,1.33
2009/2/24,1145,4352,6,27,6,21,1.004,1.671
2009/2/24,1245,4383,31,37,5,32,0.996,1.469
2009/2/24,1345,4381,-2,36,14,22,0.997,1.051
2009/2/25,945,4471,36,51,17,34,0.979,0.692
2009/2/25,1045,4509,38,52,6,46,0.973,0.941
2009/2/25,1145,4493,-17,39,27,12,0.978,1.21
2009/2/25,1245,4441,-51,85,52,33,0.992,0.657
2009/2/25,1345,4466,25,42,6,36,0.987,0.968
2009/2/26,945,4487,-33,61,51,10,0.987,0.77
2009/2/26,1045,4472,-14,41,37,4,0.993,1.176
2009/2/26,1145,4470,-3,37,22,15,0.996,1.277
2009/2/26,1245,4467,-2,36,20,16,1,1.477
2009/2/26,1345,4477,10,42,5,37,0.999,0.936
2009/2/27,945,4478,6,56,30,26,1,0.867
2009/2/27,1045,4495,18,30,0,30,0.996,1.514
2009/2/27,1145,4495,0,23,9,14,0.996,1.638
2009/2/27,1245,4508,12,23,10,13,0.993,1.336
2009/2/27,1345,4510,1,28,18,10,0.994,0.989
2009/3/2,945,4433,11,54,26,28,1.009,0.636
2009/3/2,1045,4433,0,23,12,11,1.008,1.467
2009/3/2,1145,4340,-92,112,97,15,1.029,0.578
2009/3/2,1245,4323,-18,33,13,20,1.03,1.08
2009/3/2,1345,4331,8,29,13,16,1.025,0.993
2009/3/3,945,4283,13,71,26,45,1.031,0.658
2009/3/3,1045,4313,31,42,19,23,1.02,0.862
2009/3/3,1145,4326,13,48,12,36,1.012,1.123
2009/3/3,1245,4327,1,34,14,20,1.008,1.243
2009/3/3,1345,4367,40,50,10,40,0.995,1.019
2009/3/4,945,4351,15,45,16,29,0.997,0.953
2009/3/4,1045,4438,87,103,16,87,0.975,0.72
2009/3/4,1145,4475,37,63,10,53,0.967,0.977
2009/3/4,1245,4486,13,33,17,16,0.968,1.131
2009/3/4,1345,4511,24,30,2,28,0.966,1.068
2009/3/5,945,4622,81,106,24,82,0.949,0.654
2009/3/5,1045,4572,-50,80,58,22,0.967,0.734
2009/3/5,1145,4587,16,57,13,44,0.969,1.195
2009/3/5,1245,4581,-6,50,27,23,0.976,1.31
2009/3/5,1345,4595,14,33,19,14,0.979,1.203
2009/3/6,945,4574,24,45,11,34,0.988,0.981
2009/3/6,1045,4607,34,53,22,31,0.985,0.946
2009/3/6,1145,4574,-33,64,52,12,0.996,1.026
2009/3/6,1245,4624,50,63,11,52,0.988,1.094
2009/3/6,1345,4628,3,36,10,26,0.99,1.317
2009/3/9,945,4561,-111,132,114,18,1.007,0.762
2009/3/9,1045,4561,-2,28,22,6,1.006,1.3
2009/3/9,1145,4570,10,31,14,17,1.004,1.704
2009/3/9,1245,4578,7,35,2,33,1.002,1.616
2009/3/9,1345,4624,46,59,9,50,0.992,0.876
2009/3/10,945,4618,17,83,32,51,0.994,0.771
2009/3/10,1045,4613,-4,49,31,18,0.996,1.004
2009/3/10,1145,4624,10,44,22,22,0.994,1.278
2009/3/10,1245,4658,35,35,-2,37,0.988,1.301
2009/3/10,1345,4656,-3,20,13,7,0.989,1.322
2009/3/11,945,4736,-39,67,46,21,0.974,0.663
2009/3/11,1045,4746,11,25,9,16,0.976,1.574
2009/3/11,1145,4750,5,32,17,15,0.979,1.347
2009/3/11,1245,4758,9,33,20,13,0.981,1.724
2009/3/11,1345,4758,0,18,12,6,0.985,1.335
2009/3/12,945,4745,-7,31,31,0,0.991,0.937
2009/3/12,1045,4767,22,31,4,27,0.989,1.365
2009/3/12,1145,4755,-13,26,24,2,0.994,1.455
2009/3/12,1245,4733,-21,40,31,9,1.002,1.122
2009/3/12,1345,4748,17,24,10,14,1,1.118
2009/3/13,945,4824,4,35,24,11,0.985,0.608
2009/3/13,1045,4830,5,16,8,8,0.986,1.448
2009/3/13,1145,4897,68,68,1,67,0.974,0.625
2009/3/13,1245,4927,29,45,15,30,0.971,0.619
2009/3/13,1345,4900,-27,52,30,22,0.98,0.787
2009/3/16,945,4923,-15,27,11,16,0.979,0.975
2009/3/16,1045,4951,28,51,18,33,0.977,0.911
2009/3/16,1145,4968,17,36,17,19,0.978,1.061
2009/3/16,1245,4958,-10,33,15,18,0.984,1.245
2009/3/16,1345,4962,3,23,5,18,0.988,1.341
2009/3/17,945,4973,7,66,39,27,0.989,0.76
2009/3/17,1045,4993,20,29,0,29,0.988,1.498
2009/3/17,1145,4987,-6,26,13,13,0.992,1.57
2009/3/17,1245,5033,46,45,0,45,0.985,0.805
2009/3/17,1345,5057,25,32,13,19,0.982,0.845
2009/3/18,945,5048,-34,56,43,13,0.987,0.888
2009/3/18,1045,5065,18,35,10,25,0.986,1.679
2009/3/18,1145,5083,18,37,13,24,0.985,1.647
2009/3/18,1245,5052,-31,65,37,28,0.993,1.127
2009/3/19,945,5065,20,41,10,31,0.992,0.564
2009/3/19,1045,5062,-2,38,18,20,0.995,0.982
2009/3/19,1145,5090,28,36,7,29,0.991,0.855
2009/3/19,1245,5058,-34,49,47,2,0.999,0.883
2009/3/19,1345,4980,-76,86,81,5,1.016,0.602
2009/3/20,945,5019,13,40,21,19,1.008,0.887
2009/3/20,1045,4942,-76,91,82,9,1.022,0.644
2009/3/20,1145,4957,17,39,6,33,1.017,1.232
2009/3/20,1245,4945,-13,42,38,4,1.017,1.187
2009/3/20,1345,4950,5,34,10,24,1.013,1.194
2009/3/23,945,5014,-18,43,20,23,1,0.987
2009/3/23,1045,5053,39,37,-6,43,0.991,1.296
2009/3/23,1145,5091,39,45,12,33,0.984,0.989
2009/3/23,1245,5091,1,38,18,20,0.984,1.367
2009/3/23,1345,5131,41,49,1,48,0.977,1.081
2009/3/24,945,5241,40,70,29,41,0.96,0.745
2009/3/24,1045,5214,-25,43,17,26,0.969,0.856
2009/3/24,1145,5221,8,33,17,16,0.973,1.322
2009/3/24,1245,5242,20,55,21,34,0.974,0.974
2009/3/24,1345,5262,20,29,-1,30,0.976,1.199
2009/3/25,945,5255,1,34,11,23,0.982,1.01
2009/3/25,1045,5286,30,27,-2,29,0.981,1.063
2009/3/25,1145,5337,51,62,9,53,0.976,0.899
2009/3/25,1245,5307,-31,100,82,18,0.986,0.637
2009/3/25,1345,5360,52,71,7,64,0.98,0.933
2009/3/26,945,5382,33,79,36,43,0.979,0.746
2009/3/26,1045,5337,-44,109,97,12,0.99,0.632
2009/3/26,1145,5370,33,58,9,49,0.986,0.967
2009/3/26,1245,5385,15,48,30,18,0.986,1.234
2009/3/26,1345,5385,1,51,21,30,0.989,1.172
2009/3/27,945,5413,-21,38,41,-3,0.987,1.076
2009/3/27,1045,5394,-20,66,23,43,0.993,0.934
2009/3/27,1145,5399,6,51,23,28,0.994,1.305
2009/3/27,1245,5395,-5,47,17,30,0.996,1.371
2009/3/27,1345,5353,-42,70,53,17,1.006,1.089
2009/3/30,945,5282,-64,101,75,26,1.019,0.868
2009/3/30,1045,5267,-15,38,14,24,1.02,1.274
2009/3/30,1145,5275,9,31,8,23,1.017,1.636
2009/3/30,1245,5220,-57,78,58,20,1.026,0.853
2009/3/30,1345,5175,-43,80,48,32,1.032,0.744
2009/3/31,945,5218,-7,45,19,26,1.019,1.006
2009/3/31,1045,5264,47,68,15,53,1.007,0.966
2009/3/31,1145,5282,17,44,13,31,1.001,1.249
2009/3/31,1245,5260,-22,59,29,30,1.003,1.065
2009/3/31,1345,5201,-58,86,60,26,1.012,0.869
2009/4/1,945,5296,68,95,21,74,0.991,0.748
2009/4/1,1045,5298,3,57,46,11,0.991,0.815
2009/4/1,1145,5262,-36,77,66,11,0.998,0.861
2009/4/1,1245,5260,-1,50,31,19,0.999,1.007
2009/4/1,1345,5314,53,71,5,66,0.989,0.972
2009/4/2,945,5435,35,49,24,25,0.97,0.862
2009/4/2,1045,5461,27,58,11,47,0.97,1.109
2009/4/2,1145,5462,0,46,6,40,0.973,1.22
2009/4/2,1245,5501,39,65,2,63,0.97,1.095
2009/4/2,1345,5511,8,27,3,24,0.972,1.262
2009/4/3,945,5516,-46,84,43,41,0.977,0.891
2009/4/3,1045,5519,3,39,11,28,0.981,1.406
2009/4/3,1145,5513,-6,54,39,15,0.986,1.116
2009/4/3,1245,5539,26,57,28,29,0.986,1.096
2009/4/3,1345,5509,-32,47,44,3,0.996,1.247
2009/4/6,945,5562,2,53,35,18,0.99,0.943
2009/4/6,1045,5606,45,60,9,51,0.984,1.099
2009/4/6,1145,5595,-11,33,24,9,0.989,1.167
2009/4/6,1245,5593,-2,36,26,10,0.991,1.324
2009/4/6,1345,5525,-67,101,69,32,1.005,0.67
2009/4/7,945,5505,2,54,13,41,1.008,0.846
2009/4/7,1045,5525,20,35,20,15,1.004,1.044
2009/4/7,1145,5525,0,51,15,36,1.004,1.108
2009/4/7,1245,5529,4,28,10,18,1.004,1.56
2009/4/7,1345,5583,54,68,3,65,0.994,0.884
2009/4/8,945,5567,66,86,16,70,0.995,0.771
2009/4/8,1045,5524,-42,56,51,5,1.003,0.893
2009/4/8,1145,5442,-84,103,87,16,1.017,0.617
2009/4/8,1245,5453,9,43,22,21,1.012,1.189
2009/4/8,1345,5456,3,45,5,40,1.009,0.935
2009/4/9,945,5547,9,43,21,22,0.993,0.923
2009/4/9,1045,5608,61,65,-3,68,0.983,1.076
2009/4/9,1145,5617,9,35,18,17,0.983,1.186
2009/4/9,1245,5682,64,60,-6,66,0.973,1.283
2009/4/9,1345,5712,29,43,6,37,0.971,0.983
2009/4/10,945,5797,35,45,6,39,0.961,0.949
2009/4/10,1045,5758,-39,96,47,49,0.972,0.767
2009/4/10,1145,5742,-14,45,28,17,0.978,1.197
2009/4/10,1245,5750,10,65,11,54,0.982,1.029
2009/4/10,1345,5827,77,97,3,94,0.974,0.962
2009/4/13,945,5847,12,39,0,39,0.976,1.138
2009/4/13,1045,5825,-19,73,34,39,0.985,0.971
2009/4/13,1145,5854,30,53,14,39,0.984,1.091
2009/4/13,1245,5851,-3,64,25,39,0.988,1.079
2009/4/13,1345,5846,-5,40,26,14,0.992,1.262
2009/4/14,945,5821,-4,53,17,36,0.997,0.832
2009/4/14,1045,5859,37,70,29,41,0.991,0.927
2009/4/14,1145,5871,13,40,12,28,0.991,1.27
2009/4/14,1245,5886,15,33,-1,34,0.991,1.619
2009/4/14,1345,5858,-29,44,43,1,0.998,1.103
2009/4/15,945,5883,25,47,2,45,0.994,1.518
2009/4/15,1045,5872,-11,35,23,12,0.996,1.728
2009/4/15,1145,5856,-17,41,30,11,1,2.092
2009/4/15,1245,5838,-19,82,26,56,1.003,0.998
2009/4/16,945,6025,26,192,9,183,0.974,0.593
2009/4/16,1045,5985,-40,79,62,17,0.984,0.698
2009/4/16,1145,5998,17,65,17,48,0.985,0.787
2009/4/16,1245,5982,-16,36,28,8,0.99,1.021
2009/4/16,1345,5994,12,59,15,44,0.99,0.843
2009/4/17,945,6038,-8,50,22,28,0.985,0.876
2009/4/17,1045,6029,-9,32,15,17,0.989,1.233
2009/4/17,1145,5967,-62,80,73,7,1.002,0.924
2009/4/17,1245,5815,-150,205,155,50,1.03,0.493
2009/4/17,1345,5775,-40,121,30,91,1.036,0.661
2009/4/20,945,5695,-77,140,113,27,1.047,0.768
2009/4/20,1045,5711,17,68,29,39,1.038,1.085
2009/4/20,1145,5788,76,100,27,73,1.02,1.09
2009/4/20,1245,5753,-35,71,40,31,1.022,1.246
2009/4/20,1345,5765,14,55,27,28,1.016,1.315
2009/4/21,945,5700,33,53,24,29,1.021,1.05
2009/4/21,1045,5730,30,81,5,76,1.01,1.128
2009/4/21,1145,5767,38,57,8,49,0.998,1.396
2009/4/21,1245,5827,58,88,8,80,0.985,0.968
2009/4/21,1345,5896,69,79,3,76,0.973,0.907
2009/4/22,945,5893,28,66,25,41,0.975,0.979
2009/4/22,1045,5889,-4,69,13,56,0.979,0.911
2009/4/22,1145,5869,-20,42,26,16,0.986,1.326
2009/4/22,1245,5894,26,64,10,54,0.983,1.261
2009/4/22,1345,5847,-46,84,81,3,0.993,0.971
2009/4/23,945,5810,-60,135,80,55,1.003,0.688
2009/4/23,1045,5861,51,89,38,51,0.996,0.844
2009/4/23,1145,5858,-3,58,25,33,0.999,1.071
2009/4/23,1245,5884,26,63,22,41,0.996,1.124
2009/4/23,1345,5901,16,52,1,51,0.994,1.09
2009/4/24,945,5979,64,115,19,96,0.982,0.817
2009/4/24,1045,5973,-6,40,12,28,0.984,1.236
2009/4/24,1145,5930,-43,65,40,25,0.993,1.024
2009/4/24,1245,5849,-83,162,104,58,1.008,0.66
2009/4/24,1345,5904,56,82,1,81,0.998,1.109
2009/4/27,945,5888,-42,90,62,28,1.001,1.095
2009/4/27,1045,5768,-120,114,109,5,1.024,0.741
2009/4/27,1145,5739,-29,71,35,36,1.027,1.003
2009/4/27,1245,5724,-15,68,20,48,1.028,1.04
2009/4/27,1345,5710,-14,54,25,29,1.027,1.111
2009/4/28,945,5653,-113,149,131,18,1.035,0.771
2009/4/28,1045,5719,69,99,-7,106,1.017,1.007
2009/4/28,1145,5688,-29,89,55,34,1.019,1.134
2009/4/28,1245,5613,-75,121,102,19,1.028,0.922
2009/4/28,1345,5580,-33,54,50,4,1.03,1.102
2009/4/29,945,5632,-16,66,26,40,1.015,0.974
2009/4/29,1045,5606,-25,50,28,22,1.015,1.229
2009/4/29,1145,5632,27,68,32,36,1.008,1.422
2009/4/29,1245,5631,-2,39,18,21,1.006,1.702
2009/4/29,1345,5623,-8,32,20,12,1.006,1.609
2009/4/30,945,6015,0,20,0,20,0.944,0.983
2009/4/30,1045,6015,0,0,0,0,0.95,113.982
2009/4/30,1345,6015,6015,0,0,0,0.855,137.164
2009/5/4,945,6413,50,111,19,92,0.813,0.622
2009/5/4,1145,6436,22,30,0,30,0.822,3.68
2009/5/4,1345,6436,6436,0,0,0,0.735,41.378
2009/5/5,945,6516,-121,212,199,13,0.741,0.365
2009/5/5,1045,6552,35,142,26,116,0.751,0.535
2009/5/5,1145,6506,-45,49,39,10,0.77,0.748
2009/5/5,1245,6459,-48,92,59,33,0.789,0.693
2009/5/5,1345,6542,81,112,1,111,0.786,0.755
2009/5/6,945,6478,-32,125,59,66,0.802,0.656
2009/5/6,1045,6517,41,73,11,62,0.896,1.12
2009/5/6,1145,6560,42,74,25,49,0.893,1.016
2009/5/6,1245,6543,-16,80,40,40,0.897,1.146
2009/5/6,1345,6536,-9,53,32,21,0.998,1.415
2009/5/7,945,6566,-40,88,52,36,0.993,0.932
2009/5/7,1045,6564,-3,43,23,20,0.994,1.519
2009/5/7,1145,6564,2,32,16,16,0.994,2.033
2009/5/7,1245,6495,-68,131,82,49,1.006,0.748
2009/5/7,1345,6613,119,112,1,111,0.988,0.925
2009/5/8,945,6519,-51,68,55,13,1.004,0.855
2009/5/8,1045,6565,46,67,24,43,0.997,1.258
2009/5/8,1145,6572,7,63,11,52,0.997,1.343
2009/5/8,1245,6576,4,54,21,33,0.997,1.154
2009/5/8,1345,6572,-5,38,26,12,0.998,1.257
2009/5/11,945,6567,18,100,55,45,0.997,0.791
2009/5/11,1045,6586,19,40,14,26,0.995,1.339
2009/5/11,1145,6603,17,38,7,31,0.992,1.591
2009/5/11,1245,6670,66,107,19,88,0.983,0.843
2009/5/11,1345,6597,-73,103,100,3,0.997,0.783
2009/5/12,945,6440,-122,180,146,34,1.021,0.51
2009/5/12,1045,6473,33,67,15,52,1.014,1.053
2009/5/12,1145,6475,1,50,24,26,1.013,1.195
2009/5/12,1245,6448,-29,92,29,63,1.015,0.847
2009/5/12,1345,6447,2,54,17,37,1.014,1.06
2009/5/13,945,6453,-1,71,38,33,1.011,0.912
2009/5/13,1045,6481,27,53,14,39,1.005,1.246
2009/5/13,1145,6477,-4,34,22,12,1.004,1.605
2009/5/13,1245,6473,-5,37,11,26,1.003,1.851
2009/5/13,1345,6469,-5,33,16,17,1,1.687
2009/5/14,945,6345,-10,59,35,24,1.017,0.747
2009/5/14,1045,6386,43,38,-10,48,1.009,1.298
2009/5/14,1145,6376,-11,49,43,6,1.009,1.082
2009/5/14,1245,6365,-12,45,22,23,1.009,1.231
2009/5/14,1345,6321,-44,62,56,6,1.015,1.123
2009/5/15,945,6451,79,114,19,95,0.993,0.596
2009/5/15,1045,6475,24,48,10,38,0.989,0.999
2009/5/15,1145,6475,1,61,27,34,0.989,1.002
2009/5/15,1245,6478,4,49,31,18,0.989,1.061
2009/5/15,1345,6476,-2,50,29,21,0.989,1.046
2009/5/18,945,6491,67,132,49,83,0.988,0.634
2009/5/18,1045,6486,-5,52,7,45,0.991,0.901
2009/5/18,1145,6519,33,67,8,59,0.987,1.197
2009/5/18,1245,6504,-15,31,22,9,0.992,1.345
2009/5/18,1345,6561,57,72,12,60,0.985,0.973
2009/5/19,945,6731,16,88,73,15,0.965,0.689
2009/5/19,1045,6750,18,36,14,22,0.967,1.439
2009/5/19,1145,6762,11,29,12,17,0.969,1.604
2009/5/19,1245,6669,-92,113,95,18,0.987,0.851
2009/5/19,1345,6693,27,70,0,70,0.986,0.852
2009/5/20,945,6612,-98,87,103,-16,1.003,0.914
2009/5/20,1045,6712,100,129,15,114,0.99,0.977
2009/5/20,1145,6704,-9,39,21,18,0.994,1.726
2009/5/20,1245,6704,1,70,41,29,0.997,1.236
2009/5/21,945,6670,41,92,50,42,1.004,0.674
2009/5/21,1045,6637,-34,53,58,-5,1.008,0.979
2009/5/21,1145,6637,-1,55,23,32,1.007,1.107
2009/5/21,1245,6655,19,57,13,44,1.002,1.211
2009/5/21,1345,6671,16,30,12,18,0.998,1.283
2009/5/22,945,6674,69,71,-2,73,0.997,0.862
2009/5/22,1045,6704,30,56,15,41,0.992,0.919
2009/5/22,1145,6692,-12,46,40,6,0.995,1.113
2009/5/22,1245,6698,5,60,17,43,0.994,1.01
2009/5/22,1345,6692,-6,28,16,12,0.995,1.501
2009/5/25,945,6715,-36,120,122,-2,0.993,0.558
2009/5/25,1045,6689,-26,98,56,42,0.998,0.806
2009/5/25,1145,6720,34,73,5,68,0.994,1.14
2009/5/25,1245,6705,-14,60,29,31,0.997,1.307
2009/5/25,1345,6724,19,42,4,38,0.995,1.249
2009/5/26,945,6754,54,62,-2,64,0.992,0.908
2009/5/26,1045,6722,-30,61,39,22,0.998,0.955
2009/5/26,1145,6704,-19,29,31,-2,1.001,1.985
2009/5/26,1245,6687,-17,36,18,18,1.004,1.022
2009/5/26,1345,6646,-40,63,50,13,1.01,0.931
2009/5/27,945,6747,27,58,10,48,0.994,0.79
2009/5/27,1045,6799,52,63,16,47,0.987,0.824
2009/5/27,1145,6858,59,71,-7,78,0.98,1.092
2009/5/27,1245,6882,24,56,-4,60,0.979,1.164
2009/5/27,1345,6932,50,120,65,55,0.974,0.59
2009/6/1,945,6938,-42,92,72,20,0.977,0.902
2009/6/1,1045,6930,-8,54,24,30,0.981,1.344
2009/6/1,1145,6957,27,39,4,35,0.98,1.902
2009/6/1,1245,6957,0,30,3,27,0.984,2.11
2009/6/1,1345,6954,-3,63,9,54,0.988,1.086
2009/6/2,945,7014,-23,50,36,14,0.984,0.901
2009/6/2,1045,7016,3,38,10,28,0.988,1.292
2009/6/2,1145,7003,-14,44,26,18,0.993,1.45
2009/6/2,1245,6988,-12,46,20,26,0.997,1.139
2009/6/2,1345,6916,-72,120,68,52,1.009,0.538
2009/6/3,945,6869,-59,75,64,11,1.015,0.696
2009/6/3,1045,6907,40,61,6,55,1.009,1.112
2009/6/3,1145,6886,-19,44,33,11,1.011,1.368
2009/6/3,1245,6882,-3,38,22,16,1.011,1.223
2009/6/3,1345,6898,16,32,1,31,1.007,1.462
2009/6/4,945,6889,29,37,3,34,1.006,0.861
2009/6/4,1045,6859,-30,50,36,14,1.009,1.23
2009/6/4,1145,6755,-105,131,107,24,1.022,0.559
2009/6/4,1245,6730,-26,59,25,34,1.022,0.822
2009/6/4,1345,6784,56,70,2,68,1.01,0.903
2009/6/5,945,6750,-61,67,72,-5,1.013,1.032
2009/6/5,1045,6795,45,65,19,46,1.005,1.192
2009/6/5,1145,6757,-39,46,50,-4,1.009,1.491
2009/6/5,1245,6766,9,45,14,31,1.006,1.271
2009/6/5,1345,6790,26,46,2,44,1.001,1.475
2009/6/6,945,6791,14,34,18,16,0.999,1.875
2009/6/6,1045,6799,7,24,3,21,0.997,3.204
2009/6/6,1145,6817,18,28,8,20,0.993,1.715
2009/6/6,1245,6827,10,29,9,20,0.992,2.021
2009/6/6,1345,6833,6,33,20,13,0.993,1.101
2009/6/8,945,6773,-92,123,111,12,1.003,0.474
2009/6/8,1045,6729,-42,49,21,28,1.01,0.585
2009/6/8,1145,6720,-10,46,18,28,1.01,0.958
2009/6/8,1245,6677,-43,60,59,1,1.016,0.882
2009/6/8,1345,6643,-34,64,33,31,1.02,0.586
2009/6/9,945,6613,-55,87,55,32,1.023,0.607
2009/6/9,1045,6453,-161,182,162,20,1.045,0.528
2009/6/9,1145,6478,25,80,26,54,1.036,0.925
2009/6/9,1245,6461,-17,51,37,14,1.033,1.244
2009/6/9,1345,6413,-48,82,59,23,1.035,0.848
2009/6/10,945,6415,-43,95,65,30,1.029,0.904
2009/6/10,1045,6449,36,55,25,30,1.018,1.194
2009/6/10,1145,6493,43,56,11,45,1.007,1.348
2009/6/10,1245,6439,-55,75,57,18,1.012,1.253
2009/6/10,1345,6459,20,43,12,31,1.005,1.494
2009/6/11,945,6379,-111,155,111,44,1.015,0.629
2009/6/11,1045,6464,84,130,21,109,0.998,0.862
2009/6/11,1145,6520,56,90,24,66,0.989,0.883
2009/6/11,1245,6487,-32,71,52,19,0.995,1.137
2009/6/11,1345,6516,29,60,29,31,0.991,1.083
2009/6/12,945,6509,-21,72,49,23,0.993,0.838
2009/6/12,1045,6524,15,44,25,19,0.992,1.405
2009/6/12,1145,6451,-75,101,82,19,1.005,0.954
2009/6/12,1245,6462,11,63,12,51,1.002,1.233
2009/6/12,1345,6437,-27,80,77,3,1.006,1.037
2009/6/15,945,6293,-97,123,89,34,1.028,0.696
2009/6/15,1045,6291,-2,66,21,45,1.027,0.923
2009/6/15,1145,6230,-62,68,57,11,1.034,1.105
2009/6/15,1245,6201,-29,47,23,24,1.034,1.151
2009/6/15,1345,6208,8,56,22,34,1.029,1.081
2009/6/16,945,6220,47,60,25,35,1.021,0.96
2009/6/16,1045,6171,-50,98,80,18,1.024,0.942
2009/6/16,1145,6177,6,68,24,44,1.018,0.983
2009/6/16,1245,6233,57,64,2,62,1.004,1.382
2009/6/16,1345,6208,-25,37,32,5,1.004,1.611
2009/6/17,945,6273,55,86,16,70,0.991,1.029
2009/6/17,1045,6257,-16,42,37,5,0.993,1.616
2009/6/17,1145,6245,-10,62,12,50,0.995,1.29
2009/6/17,1245,6227,-17,40,34,6,0.998,2.117
2009/6/18,945,6126,-4,116,102,14,1.013,0.537
2009/6/18,1045,6152,26,49,3,46,1.008,0.969
2009/6/18,1145,6083,-70,98,78,20,1.018,0.709
2009/6/18,1245,6025,-56,100,69,31,1.027,0.724
2009/6/18,1345,6090,67,94,0,94,1.013,0.8
2009/6/19,945,6128,38,76,1,75,1.005,0.971
2009/6/19,1045,6083,-45,80,42,38,1.011,0.994
2009/6/19,1145,6117,34,61,-7,68,1.002,1.214
2009/6/19,1245,6115,-2,40,-2,42,1,1.556
2009/6/19,1345,6138,25,49,12,37,0.994,1.366
2009/6/22,945,6104,-33,57,56,1,1,1.141
2009/6/22,1045,6114,11,55,16,39,0.998,1.175
2009/6/22,1145,6164,50,66,11,55,0.989,1.057
2009/6/22,1245,6235,71,65,-4,69,0.979,0.855
2009/6/22,1345,6206,-29,56,58,-2,0.987,0.912
2009/6/23,945,6140,52,70,-2,72,0.998,0.794
2009/6/23,1045,6118,-24,45,30,15,1.001,1.12
2009/6/23,1145,6130,12,50,12,38,1,1.199
2009/6/23,1245,6121,-10,32,21,11,1.002,1.899
2009/6/23,1345,6072,-49,67,67,0,1.01,1.047
2009/6/24,945,6090,1,48,31,17,1.006,0.906
2009/6/24,1045,6127,38,33,-7,40,1,1.307
2009/6/24,1145,6287,160,156,-9,165,0.975,0.568
2009/6/24,1245,6397,107,212,97,115,0.96,0.433
2009/6/24,1345,6311,-88,165,135,30,0.975,0.869
2009/6/25,945,6365,59,100,30,70,0.971,0.908
2009/6/25,1045,6339,-26,70,39,31,0.978,1.012
2009/6/25,1145,6357,18,58,31,27,0.979,1.289
2009/6/25,1245,6393,36,85,34,51,0.977,1.157
2009/6/25,1345,6389,-2,43,5,38,0.982,1.573
2009/6/26,945,6401,-4,43,31,12,0.985,1.331
2009/6/26,1045,6388,-13,54,34,20,0.992,1.387
2009/6/26,1145,6400,13,46,7,39,0.994,1.459
2009/6/26,1245,6381,-20,39,37,2,0.999,1.52
2009/6/26,1345,6391,9,27,14,13,0.997,1.628
2009/6/29,945,6331,-84,131,105,26,1.008,0.663
2009/6/29,1045,6373,40,61,9,52,1.001,1.13
2009/6/29,1145,6410,41,49,-5,54,0.995,1.112
2009/6/29,1245,6350,-61,87,77,10,1.006,0.91
2009/6/29,1345,6345,-5,51,30,21,1.006,1.105
2009/6/30,945,6401,-20,51,49,2,0.997,0.792
2009/6/30,1045,6389,-12,49,26,23,0.999,1.01
2009/6/30,1145,6333,-56,88,66,22,1.008,0.847
2009/6/30,1245,6322,-10,48,27,21,1.009,1.048
2009/6/30,1345,6383,60,67,4,63,0.998,0.876
2009/7/1,945,6395,-19,63,29,34,0.996,0.829
2009/7/1,1045,6409,14,43,25,18,0.995,1.074
2009/7/1,1145,6502,91,109,16,93,0.981,0.811
2009/7/1,1245,6530,28,35,8,27,0.979,0.861
2009/7/1,1345,6517,-13,58,29,29,0.983,0.932
2009/7/2,945,6588,63,87,17,70,0.974,0.845
2009/7/2,1045,6603,15,65,23,42,0.975,0.942
2009/7/2,1145,6568,-35,48,42,6,0.983,1.246
2009/7/2,1245,6590,23,47,7,40,0.984,1.316
2009/7/2,1345,6590,-1,33,13,20,0.988,1.335
2009/7/3,945,6557,10,46,24,22,0.995,0.961
2009/7/3,1045,6578,21,42,11,31,0.994,1.665
2009/7/3,1145,6587,9,56,46,10,0.995,0.945
2009/7/3,1245,6564,-21,72,28,44,1,0.875
2009/7/3,1345,6602,40,66,8,58,0.995,1.182
2009/7/6,945,6571,-48,76,60,16,1.001,0.851
2009/7/6,1045,6554,-17,53,26,27,1.003,0.822
2009/7/6,1145,6590,38,65,14,51,0.997,1.06
2009/7/6,1245,6596,6,40,14,26,0.996,1.192
2009/7/6,1345,6588,-8,41,14,27,0.998,1.264
2009/7/7,945,6616,28,56,23,33,0.994,0.843
2009/7/7,1045,6675,58,95,20,75,0.986,0.693
2009/7/7,1145,6686,11,39,19,20,0.986,1.215
2009/7/7,1245,6678,-7,40,32,8,0.989,1.237
2009/7/7,1345,6665,-13,40,31,9,0.992,1.142
2009/7/8,945,6583,-38,71,54,17,1.005,0.762
2009/7/8,1045,6610,27,41,7,34,1.001,1.256
2009/7/8,1145,6583,-27,70,45,25,1.006,0.836
2009/7/8,1245,6589,4,31,4,27,1.005,1.405
2009/7/8,1345,6627,37,45,-3,48,0.999,1.27
2009/7/9,945,6740,113,138,28,110,0.983,0.6
2009/7/9,1045,6734,-6,61,44,17,0.985,0.881
2009/7/9,1145,6750,16,41,12,29,0.984,1.365
2009/7/9,1245,6750,-1,27,13,14,0.985,1.47
2009/7/9,1345,6724,-25,49,33,16,0.99,0.999
2009/7/10,945,6729,-6,59,26,33,0.991,0.954
2009/7/10,1045,6701,-29,59,34,25,0.997,1.201
2009/7/10,1145,6731,31,39,3,36,0.994,1.571
2009/7/10,1245,6739,8,36,8,28,0.995,1.39
2009/7/10,1345,6755,16,33,-4,37,0.995,1.294
2009/7/13,945,6597,-142,186,168,18,1.02,0.516
2009/7/13,1045,6500,-97,157,108,49,1.033,0.55
2009/7/13,1145,6488,-11,39,24,15,1.032,1.268
2009/7/13,1245,6493,7,40,25,15,1.027,1.358
2009/7/13,1345,6469,-24,52,26,26,1.027,0.837
2009/7/14,945,6546,6,48,9,39,1.012,0.991
2009/7/14,1045,6531,-15,24,20,4,1.011,2.01
2009/7/14,1145,6580,49,72,9,63,1.001,1.186
2009/7/14,1245,6601,21,45,6,39,0.996,1.286
2009/7/14,1345,6580,-20,33,29,4,0.997,1.394
2009/7/15,945,6695,65,56,-3,59,0.978,0.99
2009/7/15,1045,6726,31,48,22,26,0.975,1.09
2009/7/15,1145,6763,38,63,19,44,0.973,1.335
2009/7/15,1245,6733,-31,62,39,23,0.981,1.225
2009/7/16,945,6756,8,59,22,37,0.982,0.53
2009/7/16,1045,6739,-18,59,46,13,0.987,0.847
2009/7/16,1145,6734,-5,27,18,9,0.991,1.353
2009/7/16,1245,6695,-38,72,60,12,1,0.996
2009/7/16,1345,6709,14,44,-4,48,0.999,0.896
2009/7/17,945,6718,-18,64,46,18,1,0.88
2009/7/17,1045,6733,16,33,15,18,0.999,1.285
2009/7/17,1145,6765,32,29,-15,44,0.995,1.509
2009/7/17,1245,6759,-4,52,43,9,0.996,0.773
2009/7/17,1345,6756,-3,21,21,0,0.997,1.636
2009/7/20,945,6799,-40,83,42,41,0.992,0.772
2009/7/20,1045,6842,43,61,19,42,0.986,0.788
2009/7/20,1145,6866,25,45,12,33,0.984,1.189
2009/7/20,1245,6875,11,59,9,50,0.985,1.105
2009/7/20,1345,6859,-16,36,18,18,0.99,1.103
2009/7/21,945,6863,-37,64,47,17,0.992,0.765
2009/7/21,1045,6848,-15,83,30,53,0.996,0.687
2009/7/21,1145,6868,20,56,5,51,0.995,1.113
2009/7/21,1245,6870,2,23,14,9,0.996,1.303
2009/7/21,1345,6874,6,38,6,32,0.997,1.264
2009/7/22,945,6939,69,112,20,92,0.988,0.634
2009/7/22,1045,6943,4,38,9,29,0.99,1.069
2009/7/22,1145,6928,-15,28,20,8,0.993,1.532
2009/7/22,1245,6885,-43,78,55,23,1,0.768
2009/7/22,1345,6885,0,24,24,0,1,1.528
2009/7/23,945,6885,12,77,10,67,1,0.77
2009/7/23,1045,6931,46,46,24,22,0.994,0.784
2009/7/23,1145,6929,-2,44,16,28,0.995,1.295
2009/7/23,1245,6892,-38,67,40,27,1.001,1.118
2009/7/23,1345,6881,-11,43,43,0,1.003,1.268
2009/7/24,945,6923,-27,47,36,11,0.998,0.913
2009/7/24,1045,6925,3,36,15,21,0.998,1.272
2009/7/24,1145,6903,-22,25,36,-11,1.001,1.699
2009/7/24,1245,6908,5,34,7,27,1,1.12
2009/7/24,1345,6897,-11,37,15,22,1.002,1.162
2009/7/27,945,6919,-31,56,33,23,1,0.787
2009/7/27,1045,6923,5,26,14,12,0.999,1.466
2009/7/27,1145,6987,65,62,-3,65,0.99,0.995
2009/7/27,1245,6984,-2,30,19,11,0.991,1.029
2009/7/27,1345,6967,-18,37,21,16,0.995,0.916
2009/7/28,945,7028,66,82,17,65,0.987,0.654
2009/7/28,1045,7034,6,35,26,9,0.987,0.936
2009/7/28,1145,7069,35,45,9,36,0.984,0.979
2009/7/28,1245,7070,0,30,18,12,0.986,1.479
2009/7/28,1345,7080,10,31,3,28,0.987,1.07
2009/7/29,945,7072,-27,59,60,-1,0.99,0.714
2009/7/29,1045,7083,16,28,8,20,0.991,1.223
2009/7/29,1145,7057,-26,62,47,15,0.997,0.93
2009/7/29,1245,7052,-5,37,11,26,0.999,0.993
2009/7/29,1345,7037,-15,35,19,16,1.002,1.165
2009/7/30,945,6895,-130,173,148,25,1.023,0.479
2009/7/30,1045,6959,64,79,17,62,1.012,0.803
2009/7/30,1145,6943,-17,54,26,28,1.013,1.17
2009/7/30,1245,6935,-8,35,13,22,1.012,1.694
2009/7/30,1345,6963,28,41,4,37,1.006,1.268
2009/7/31,945,7037,28,54,11,43,0.995,0.881
2009/7/31,1045,7067,30,54,8,46,0.99,1.092
2009/7/31,1145,7034,-33,53,41,12,0.994,1.317
2009/7/31,1245,7025,-8,23,10,13,0.995,1.347
2009/7/31,1345,7028,1,79,6,73,0.995,0.749
2009/8/3,945,6991,-33,100,37,63,1,0.69
2009/8/3,1045,6947,-44,57,60,-3,1.008,0.963
2009/8/3,1145,6963,16,54,2,52,1.005,1.084
2009/8/3,1245,6975,12,27,4,23,1.004,1.642
2009/8/3,1345,6982,7,30,12,18,1.003,1.309
2009/8/4,945,7035,-21,45,33,12,0.996,0.758
2009/8/4,1045,7023,-11,36,24,12,0.998,1.168
2009/8/4,1145,6974,-48,46,53,-7,1.004,0.957
2009/8/4,1245,6837,-137,152,148,4,1.024,0.587
2009/8/4,1345,6881,43,57,15,42,1.014,0.849
2009/8/5,945,6906,24,78,19,59,1.009,0.812
2009/8/5,1045,6923,14,47,25,22,1.005,1.094
2009/8/5,1145,6884,-39,67,53,14,1.01,1.229
2009/8/5,1245,6843,-41,66,44,22,1.015,0.844
2009/8/5,1345,6772,-69,86,63,23,1.024,0.769
2009/8/6,945,6758,-41,72,75,-3,1.022,0.939
2009/8/6,1045,6754,-4,86,53,33,1.019,0.953
2009/8/6,1145,6782,27,89,9,80,1.01,0.843
2009/8/6,1245,6785,0,43,34,9,1.007,1.318
2009/8/6,1345,6803,17,36,14,22,1.004,1.517
2009/8/10,945,6816,-4,115,32,83,1.001,0.852
2009/8/10,1045,6809,-7,47,23,24,1.001,1.537
2009/8/10,1145,6824,15,49,30,19,0.997,1.526
2009/8/10,1245,6791,-32,37,42,-5,1.001,1.692
2009/8/10,1345,6814,22,47,10,37,0.997,1.47
2009/8/11,945,6795,-23,52,35,17,1,0.978
2009/8/11,1045,6785,-7,33,23,10,1.002,1.282
2009/8/11,1145,6788,3,37,4,33,1.002,0.981
2009/8/11,1245,6830,42,46,5,41,0.996,1.051
2009/8/11,1345,6895,65,64,-3,67,0.987,0.842
2009/8/12,945,6856,7,61,42,19,0.993,0.789
2009/8/12,1045,6851,-5,50,33,17,0.994,0.972
2009/8/12,1145,6843,-10,48,20,28,0.996,0.914
2009/8/12,1245,6861,18,44,19,25,0.994,1.164
2009/8/12,1345,6839,-22,37,38,-1,0.998,1.414
2009/8/13,945,6944,79,101,19,82,0.983,0.549
2009/8/13,1045,6986,43,81,26,55,0.98,0.836
2009/8/13,1145,6997,9,37,19,18,0.981,1.47
2009/8/13,1245,7010,13,32,8,24,0.982,1.573
2009/8/13,1345,7013,4,40,18,22,0.984,0.889
2009/8/14,945,7071,22,67,41,26,0.979,0.786
2009/8/14,1045,7076,6,33,22,11,0.981,1.509
2009/8/14,1145,7040,-36,57,37,20,0.99,0.841
2009/8/14,1245,7057,18,33,12,21,0.99,1.989
2009/8/14,1345,7063,6,27,2,25,0.992,1.568
2009/8/17,945,6927,-83,122,107,15,1.013,0.553
2009/8/17,1045,6932,7,46,13,33,1.012,0.906
2009/8/17,1145,6936,2,52,19,33,1.011,1.231
2009/8/17,1245,6921,-14,29,26,3,1.012,1.831
2009/8/17,1345,6914,-7,33,31,2,1.012,1.092
2009/8/18,945,6880,-20,67,28,39,1.015,0.633
2009/8/18,1045,6877,-3,22,15,7,1.013,1.326
2009/8/18,1145,6755,-122,153,121,32,1.028,0.497
2009/8/18,1245,6757,1,34,23,11,1.024,1.414
2009/8/18,1345,6817,61,85,-1,86,1.01,0.945
2009/8/19,945,6821,-3,32,23,9,1.007,1.468
2009/8/19,1045,6799,-22,37,24,13,1.009,1.579
2009/8/19,1145,6804,5,28,17,11,1.006,2.335
2009/8/19,1245,6821,19,35,14,21,1.001,2.328
2009/8/20,945,6642,-80,234,182,52,1.025,0.467
2009/8/20,1045,6639,-5,34,29,5,1.022,1.123
2009/8/20,1145,6638,-1,31,7,24,1.018,1.395
2009/8/20,1245,6719,80,84,14,70,1.003,0.655
2009/8/20,1345,6693,-26,47,29,18,1.006,1.103
2009/8/21,945,6735,35,68,35,33,0.999,0.665
2009/8/21,1045,6732,-1,37,11,26,0.998,1.099
2009/8/21,1145,6671,-61,62,77,-15,1.006,0.88
2009/8/21,1245,6604,-67,85,91,-6,1.014,0.852
2009/8/21,1345,6592,-12,73,34,39,1.013,0.801
2009/8/24,945,6724,-30,40,31,9,0.993,0.905
2009/8/24,1045,6737,12,27,1,26,0.993,1.852
2009/8/24,1145,6806,69,84,5,79,0.984,0.838
2009/8/24,1245,6818,12,32,15,17,0.985,1.557
2009/8/24,1345,6808,-10,50,27,23,0.988,1.169
2009/8/25,945,6773,-25,67,54,13,0.994,0.822
2009/8/25,1045,6762,-11,57,40,17,0.997,0.934
2009/8/25,1145,6790,28,30,-5,35,0.993,1.536
2009/8/25,1245,6792,1,24,14,10,0.994,1.546
2009/8/25,1345,6760,-32,49,31,18,1.002,1.156
2009/8/26,945,6658,-127,157,144,13,1.018,0.486
2009/8/26,1045,6648,-10,72,40,32,1.018,0.794
2009/8/26,1145,6704,55,90,6,84,1.008,0.829
2009/8/26,1245,6708,2,34,8,26,1.006,1.397
2009/8/26,1345,6703,-5,41,4,37,1.005,1.25
2009/8/27,945,6696,23,77,-9,86,1.005,0.779
2009/8/27,1045,6705,8,38,22,16,1.002,0.976
2009/8/27,1145,6651,-53,48,49,-1,1.009,1.106
2009/8/27,1245,6656,5,42,22,20,1.006,1.379
2009/8/27,1345,6645,-11,46,43,3,1.006,1.38
2009/8/28,945,6790,113,154,20,134,0.983,0.556
2009/8/28,1045,6770,-20,39,35,4,0.988,1.248
2009/8/28,1145,6771,1,24,12,12,0.989,1.977
2009/8/28,1245,6733,-39,73,59,14,0.996,1.033
2009/8/28,1345,6754,21,45,6,39,0.993,1.233
2009/8/31,945,6764,-1,72,41,31,0.993,0.773
2009/8/31,1045,6736,-28,42,29,13,0.998,1.15
2009/8/31,1145,6717,-21,41,25,16,1.002,1.065
2009/8/31,1245,6741,23,32,4,28,0.999,1.533
2009/8/31,1345,6756,15,24,10,14,0.998,1.245
2009/9/1,945,6862,105,138,12,126,0.984,0.484
2009/9/1,1045,6883,18,26,-2,28,0.982,1.236
2009/9/1,1145,6937,53,73,12,61,0.976,0.975
2009/9/1,1245,6957,20,53,31,22,0.976,0.975
2009/9/1,1345,7027,69,67,0,67,0.969,0.949
2009/9/2,945,7018,67,73,6,67,0.973,0.756
2009/9/2,1045,7008,-10,61,20,41,0.978,0.995
2009/9/2,1145,7005,-3,66,44,22,0.982,0.927
2009/9/2,1245,7020,12,43,13,30,0.984,1.506
2009/9/2,1345,7026,6,24,9,15,0.987,1.696
2009/9/3,945,7029,9,59,9,50,0.991,0.797
2009/9/3,1045,7089,60,58,-3,61,0.985,1.049
2009/9/3,1145,7084,-5,48,39,9,0.988,0.971
2009/9/3,1245,7053,-32,42,19,23,0.995,1.056
2009/9/3,1345,7094,39,41,-2,43,0.99,1.276
2009/9/4,945,7104,-17,98,65,33,0.991,0.678
2009/9/4,1045,7138,34,55,1,54,0.988,1.312
2009/9/4,1145,7104,-34,37,26,11,0.994,1.214
2009/9/4,1245,7134,30,50,19,31,0.991,1.281
2009/9/4,1345,7155,21,35,1,34,0.99,1.387
2009/9/7,945,7182,-4,45,13,32,0.989,0.97
2009/9/7,1045,7176,-5,43,37,6,0.992,1.119
2009/9/7,1145,7150,-26,34,48,-14,0.996,1.68
2009/9/7,1245,7189,39,43,6,37,0.992,1.355
2009/9/7,1345,7221,31,41,6,35,0.989,1.01
2009/9/8,945,7226,-24,65,20,45,0.991,0.596
2009/9/8,1045,7335,106,138,19,119,0.978,0.54
2009/9/8,1145,7339,4,61,28,33,0.98,0.823
2009/9/8,1245,7340,1,49,15,34,0.983,1.066
2009/9/8,1345,7316,-24,37,32,5,0.989,1.086
2009/9/9,945,7317,1,44,27,17,0.99,1.004
2009/9/9,1045,7310,-6,44,10,34,0.993,0.987
2009/9/9,1145,7316,6,33,13,20,0.994,1.818
2009/9/9,1245,7310,-5,37,3,34,0.997,1.494
2009/9/9,1345,7257,-52,61,52,9,1.006,1.102
2009/9/10,945,7436,102,431,322,109,0.983,0.357
2009/9/10,1045,7303,-135,144,126,18,1.004,0.713
2009/9/10,1145,7306,3,52,52,0,1.003,1.315
2009/9/10,1245,7357,48,77,33,44,0.996,1.243
2009/9/10,1345,7360,3,31,15,16,0.996,1.53
2009/9/11,945,7342,13,61,19,42,0.998,1.024
2009/9/11,1045,7341,-1,31,22,9,0.999,1.879
2009/9/11,1145,7357,16,31,13,18,0.997,2.114
2009/9/11,1245,7338,-19,33,24,9,1,2.73
2009/9/11,1345,7353,14,17,3,14,0.998,2.453
2009/9/14,945,7244,-63,140,100,40,1.013,0.546
2009/9/14,1045,7274,30,85,22,63,1.006,0.846
2009/9/14,1145,7289,12,39,10,29,1.004,1.31
2009/9/14,1245,7261,-27,45,35,10,1.007,1.489
2009/9/14,1345,7252,-10,37,19,18,1.007,1.084
2009/9/15,945,7277,-12,44,20,24,1.003,0.84
2009/9/15,1045,7282,5,32,7,25,1.002,1.593
2009/9/15,1145,7325,43,51,2,49,0.995,1.062
2009/9/15,1245,7355,31,52,30,22,0.991,0.759
2009/9/15,1345,7357,2,32,7,25,0.99,1.224
2009/9/16,945,7426,-2,55,34,21,0.983,0.873
2009/9/16,1045,7391,-36,69,53,16,0.99,1.022
2009/9/16,1145,7428,37,45,10,35,0.987,1.526
2009/9/16,1245,7414,-14,33,20,13,0.99,2.358
2009/9/17,945,7492,-8,112,25,87,0.983,0.477
2009/9/17,1045,7482,-12,51,26,25,0.987,0.791
2009/9/17,1145,7489,7,42,19,23,0.989,1.119
2009/9/17,1245,7476,-13,33,17,16,0.994,1.061
2009/9/17,1345,7466,-10,38,8,30,0.997,0.808
2009/9/18,945,7443,2,42,7,35,1.001,0.812
2009/9/18,1045,7445,2,24,15,9,1.001,1.514
2009/9/18,1145,7454,9,25,13,12,1,1.492
2009/9/18,1245,7474,20,28,2,26,0.998,1.7
2009/9/18,1345,7467,-7,37,35,2,1,0.997
2009/9/21,945,7407,-74,158,149,9,1.008,0.455
2009/9/21,1045,7445,38,44,13,31,1.001,1.159
2009/9/21,1145,7474,31,48,16,32,0.997,1.27
2009/9/21,1245,7474,0,30,8,22,0.997,1.678
2009/9/21,1345,7466,-9,27,22,5,0.998,1.549
2009/9/22,945,7451,-33,52,55,-3,1,0.802
2009/9/22,1045,7477,26,53,11,42,0.997,1.132
2009/9/22,1145,7452,-25,32,33,-1,1.001,1.639
2009/9/22,1245,7472,20,28,11,17,0.998,1.791
2009/9/22,1345,7454,-19,26,24,2,1.001,1.625
2009/9/23,945,7471,11,77,49,28,0.998,0.464
2009/9/23,1045,7434,-37,68,37,31,1.004,0.654
2009/9/23,1145,7363,-70,85,80,5,1.013,0.672
2009/9/23,1245,7323,-40,36,38,-2,1.017,1.098
2009/9/23,1345,7347,23,69,33,36,1.012,0.765
2009/9/24,945,7340,-24,49,35,14,1.011,0.898
2009/9/24,1045,7324,-16,58,39,19,1.012,1.024
2009/9/24,1145,7267,-58,76,59,17,1.018,0.784
2009/9/24,1245,7283,17,70,22,48,1.013,1
2009/9/24,1345,7295,12,35,10,25,1.009,1.54
2009/9/25,945,7288,38,55,8,47,1.007,1.002
2009/9/25,1045,7297,14,63,32,31,1.003,1.075
2009/9/25,1145,7306,11,39,14,25,1,1.519
2009/9/25,1245,7334,30,38,6,32,0.995,1.408
2009/9/25,1345,7338,4,21,0,21,0.995,1.459
2009/9/28,945,7268,-8,42,59,-17,1.003,1.057
2009/9/28,1045,7263,-5,61,13,48,1.003,0.645
2009/9/28,1145,7253,-11,29,11,18,1.004,1.35
2009/9/28,1245,7263,11,27,9,18,1.002,1.714
2009/9/28,1345,7280,16,33,5,28,0.999,1.332
2009/9/29,945,7378,48,79,32,47,0.987,0.53
2009/9/29,1045,7419,40,52,9,43,0.983,0.848
2009/9/29,1145,7399,-20,35,32,3,0.987,1.426
2009/9/29,1245,7417,19,27,10,17,0.986,1.983
2009/9/29,1345,7405,-13,28,13,15,0.989,1.031
2009/9/30,945,7468,41,64,7,57,0.983,0.697
2009/9/30,1045,7496,28,57,19,38,0.982,0.729
2009/9/30,1145,7500,5,22,8,14,0.984,1.75
2009/9/30,1245,7478,-22,32,22,10,0.99,1.19
2009/9/30,1345,7493,14,25,11,14,0.991,1.153
2009/10/1,945,7525,-13,96,89,7,0.99,0.519
2009/10/1,1045,7486,-37,50,55,-5,0.997,0.989
2009/10/1,1145,7513,27,63,5,58,0.994,0.923
2009/10/1,1245,7521,8,38,21,17,0.995,1.378
2009/10/1,1345,7538,17,24,2,22,0.994,1.727
2009/10/2,945,7425,7,57,12,45,1.009,0.812
2009/10/2,1045,7427,2,28,23,5,1.008,1.193
2009/10/2,1145,7411,-15,28,25,3,1.009,1.65
2009/10/2,1245,7397,-14,28,18,10,1.01,1.134
2009/10/2,1345,7352,-45,64,56,8,1.015,0.745
2009/10/5,945,7337,-21,57,51,6,1.015,0.789
2009/10/5,1045,7362,25,45,9,36,1.009,1.201
2009/10/5,1145,7364,2,24,10,14,1.007,1.86
2009/10/5,1245,7353,-12,23,15,8,1.006,1.654
2009/10/5,1345,7392,39,54,6,48,0.999,1.036
2009/10/6,945,7416,-12,37,16,21,0.995,0.747
2009/10/6,1045,7520,102,122,12,110,0.982,0.432
2009/10/6,1145,7509,-11,41,27,14,0.984,1.259
2009/10/6,1245,7528,19,31,10,21,0.983,1.807
2009/10/6,1345,7506,-22,40,26,14,0.988,0.957
2009/10/7,945,7551,-36,62,58,4,0.985,0.662
2009/10/7,1045,7566,15,19,4,15,0.986,1.544
2009/10/7,1145,7572,7,30,12,18,0.988,1.71
2009/10/7,1245,7550,-22,48,28,20,0.993,1.181
2009/10/7,1345,7589,39,53,5,48,0.991,1.229
2009/10/8,945,7596,6,52,31,21,0.992,0.814
2009/10/8,1045,7597,1,31,20,11,0.994,1.191
2009/10/8,1145,7581,-16,37,24,13,0.997,1.053
2009/10/8,1245,7568,-13,30,15,15,1,1.273
2009/10/8,1345,7481,-87,116,83,33,1.012,0.479
2009/10/9,945,7533,25,53,32,21,1.004,0.868
2009/10/9,1045,7507,-26,76,33,43,1.007,0.788
2009/10/9,1145,7528,20,52,7,45,1.004,1.264
2009/10/9,1245,7541,13,31,8,23,1.001,1.644
2009/10/9,1345,7552,10,47,5,42,1,1.208
2009/10/12,945,7553,-12,57,37,20,0.999,0.936
2009/10/12,1045,7559,6,27,11,16,0.998,1.892
2009/10/12,1145,7510,-49,66,48,18,1.004,0.825
2009/10/12,1245,7533,23,34,7,27,1,1.967
2009/10/12,1345,7576,43,42,18,24,0.994,0.772
2009/10/13,945,7489,-20,228,15,213,1.006,0.473
2009/10/13,1045,7532,43,66,-1,67,0.999,1.021
2009/10/13,1145,7565,33,55,19,36,0.995,0.715
2009/10/13,1245,7582,18,39,14,25,0.993,1.388
2009/10/13,1345,7561,-22,24,23,1,0.997,1.493
2009/10/14,945,7603,4,42,30,12,0.992,1.005
2009/10/14,1045,7640,37,55,12,43,0.987,1.038
2009/10/14,1145,7669,29,31,3,28,0.985,1.335
2009/10/14,1245,7663,-6,23,10,13,0.988,2.18
2009/10/14,1345,7699,36,37,1,36,0.985,1.107
2009/10/15,945,7739,-35,56,47,9,0.983,0.797
2009/10/15,1045,7771,32,49,13,36,0.982,1.095
2009/10/15,1145,7720,-50,61,49,12,0.992,0.714
2009/10/15,1245,7720,-2,43,13,30,0.994,0.879
2009/10/15,1345,7710,-11,33,16,17,0.997,1.271
2009/10/16,945,7718,8,41,14,27,0.997,0.901
2009/10/16,1045,7711,-9,26,9,17,1,1.245
2009/10/16,1145,7681,-30,51,42,9,1.005,1.102
2009/10/16,1245,7703,22,45,9,36,1.002,1.107
2009/10/16,1345,7694,-8,20,14,6,1.004,1.575
2009/10/19,945,7699,50,59,-5,64,1.001,0.911
2009/10/19,1045,7733,34,42,-4,46,0.996,1.101
2009/10/19,1145,7742,9,23,-2,25,0.995,1.626
2009/10/19,1245,7746,4,22,9,13,0.994,1.528
2009/10/19,1345,7753,7,26,9,17,0.994,0.979
2009/10/20,945,7767,-25,27,27,0,0.993,0.919
2009/10/20,1045,7753,-16,41,19,22,0.996,0.718
2009/10/20,1145,7758,5,29,8,21,0.995,1.48
2009/10/20,1245,7759,-1,22,4,18,0.996,1.478
2009/10/20,1345,7752,-6,22,7,15,0.998,1.208
2009/10/21,945,7720,-23,26,38,-12,1.003,1.136
2009/10/21,1045,7686,-34,54,28,26,1.008,0.653
2009/10/21,1145,7720,36,33,-5,38,1.003,1.554
2009/10/21,1245,7730,10,17,8,9,1.001,1.413
2009/10/22,945,7653,44,118,80,38,1.01,0.465
2009/10/22,1045,7562,-92,108,96,12,1.02,0.422
2009/10/22,1145,7549,-15,51,26,25,1.019,0.857
2009/10/22,1245,7540,-10,29,23,6,1.018,1.39
2009/10/22,1345,7573,34,46,8,38,1.01,0.972
2009/10/23,945,7594,0,40,21,19,1.005,1.021
2009/10/23,1045,7623,29,52,0,52,0.999,1.164
2009/10/23,1145,7626,4,22,4,18,0.998,2.009
2009/10/23,1245,7611,-16,29,21,8,0.999,2.018
2009/10/23,1345,7596,-15,21,25,-4,1,2.06
2009/10/26,945,7711,92,142,54,88,0.985,0.557
2009/10/26,1045,7704,-6,28,26,2,0.986,1.419
2009/10/26,1145,7691,-13,33,27,6,0.99,1.48
2009/10/26,1245,7668,-23,42,28,14,0.995,1.028
2009/10/26,1345,7643,-25,51,30,21,1,0.882
2009/10/27,945,7591,-18,48,27,21,1.007,0.709
2009/10/27,1045,7563,-28,57,31,26,1.01,0.714
2009/10/27,1145,7613,51,79,14,65,1.003,0.795
2009/10/27,1245,7626,13,32,15,17,1.001,1.169
2009/10/27,1345,7644,18,36,-2,38,0.999,1.386
2009/10/28,945,7606,4,34,11,23,1.004,0.849
2009/10/28,1045,7596,-10,80,54,26,1.004,0.583
2009/10/28,1145,7557,-39,50,46,4,1.007,0.795
2009/10/28,1245,7567,10,38,21,17,1.004,1.58
2009/10/28,1345,7508,-59,74,68,6,1.011,0.704
2009/10/29,945,7342,-18,49,62,-13,1.03,0.839
2009/10/29,1045,7311,-30,29,41,-12,1.031,1.064
2009/10/29,1145,7263,-48,118,60,58,1.035,0.601
2009/10/29,1245,7318,56,60,2,58,1.022,1.197
2009/10/29,1345,7322,5,39,20,19,1.017,1.17
2009/10/30,945,7333,-42,41,42,-1,1.013,1.169
2009/10/30,1045,7365,31,60,17,43,1.005,1.376
2009/10/30,1145,7367,2,21,12,9,1.001,1.819
2009/10/30,1245,7355,-12,49,37,12,1,1.399
2009/10/30,1345,7285,-70,68,68,0,1.007,1.125
2009/11/2,945,7224,74,83,10,73,1.012,0.819
2009/11/2,1045,7244,20,67,25,42,1.008,1.011
2009/11/2,1145,7272,29,41,13,28,1.003,1.217
2009/11/2,1245,7256,-15,43,19,24,1.006,1.357
2009/11/2,1345,7278,23,63,17,46,1.002,0.98
2009/11/3,945,7281,3,52,33,19,1,0.8
2009/11/3,1045,7275,-6,67,45,22,1,0.862
2009/11/3,1145,7284,9,44,24,20,0.998,1.306
2009/11/3,1245,7280,-4,23,16,7,0.997,2.078
2009/11/3,1345,7274,-8,15,12,3,0.997,1.853
2009/11/4,945,7367,52,68,13,55,0.986,0.661
2009/11/4,1045,7373,6,22,1,21,0.988,1.134
2009/11/4,1145,7389,16,21,13,8,0.987,1.153
2009/11/4,1245,7433,44,53,8,45,0.983,1.036
2009/11/4,1345,7439,6,31,4,27,0.985,0.843
2009/11/5,945,7393,-16,51,40,11,0.992,0.767
2009/11/5,1045,7447,54,65,6,59,0.987,0.851
2009/11/5,1145,7398,-49,68,50,18,0.996,0.81
2009/11/5,1245,7383,-15,39,31,8,0.999,1.321
2009/11/5,1345,7409,29,31,6,25,0.997,1.353
2009/11/6,945,7472,-30,49,47,2,0.991,0.839
2009/11/6,1045,7476,3,35,21,14,0.992,1.157
2009/11/6,1145,7478,1,24,14,10,0.993,1.898
2009/11/6,1245,7444,-34,36,35,1,0.999,1.06
2009/11/6,1345,7478,34,33,-2,35,0.994,1.089
2009/11/9,945,7537,-3,38,27,11,0.988,0.782
2009/11/9,1045,7524,-14,27,15,12,0.992,1.101
2009/11/9,1145,7553,30,48,0,48,0.989,1.099
2009/11/9,1245,7530,-23,24,25,-1,0.994,1.556
2009/11/9,1345,7549,19,37,0,37,0.994,1.011
2009/11/10,945,7580,-50,50,50,0,0.991,0.736
2009/11/10,1045,7592,12,22,12,10,0.991,1.22
2009/11/10,1145,7590,0,23,5,18,0.993,1.442
2009/11/10,1245,7584,-6,18,13,5,0.995,1.922
2009/11/10,1345,7589,5,18,12,6,0.996,0.997
2009/11/11,945,7570,-45,41,35,6,1,0.727
2009/11/11,1045,7589,18,37,-1,38,0.998,0.822
2009/11/11,1145,7650,61,76,5,71,0.991,0.551
2009/11/11,1245,7666,16,39,17,22,0.99,0.673
2009/11/11,1345,7681,15,23,1,22,0.99,0.905
2009/11/12,945,7687,-8,44,24,20,0.99,0.757
2009/11/12,1045,7688,1,32,16,16,0.991,1.11
2009/11/12,1145,7691,4,24,14,10,0.992,1.715
2009/11/12,1245,7685,-6,16,13,3,0.994,2.341
2009/11/12,1345,7686,1,24,3,21,0.995,1.302
2009/11/13,945,7668,8,27,11,16,0.998,1.083
2009/11/13,1045,7700,32,61,19,42,0.995,0.916
2009/11/13,1145,7694,-6,16,10,6,0.998,1.995
2009/11/13,1245,7647,-48,74,54,20,1.004,0.691
2009/11/13,1345,7672,24,44,18,26,1.001,0.992
2009/11/16,945,7758,70,70,-2,72,0.99,0.626
2009/11/16,1045,7754,-4,32,15,17,0.991,1.028
2009/11/16,1145,7790,38,44,3,41,0.987,0.947
2009/11/16,1245,7786,-4,25,9,16,0.989,1.518
2009/11/16,1345,7806,20,24,2,22,0.988,0.929
2009/11/17,945,7819,-170,175,147,28,0.99,0.412
2009/11/17,1045,7800,-19,83,33,50,0.995,0.714
2009/11/17,1145,7778,-22,42,31,11,0.999,1.208
2009/11/17,1245,7775,-3,31,27,4,1,1.973
2009/11/17,1345,7735,-40,54,49,5,1.007,1.07
2009/11/18,945,7772,-16,33,13,20,1.004,1.431
2009/11/18,1045,7777,5,20,13,7,1.003,2.371
2009/11/18,1145,7770,-7,30,22,8,1.004,2.441
2009/11/18,1245,7783,14,33,0,33,1.002,2.625
2009/11/19,945,7739,-17,88,64,24,1.008,0.704
2009/11/19,1045,7778,39,47,7,40,0.999,0.737
2009/11/19,1145,7766,-12,31,16,15,1,1.177
2009/11/19,1245,7761,-5,29,27,2,1.001,1.259
2009/11/19,1345,7700,-62,68,68,0,1.008,0.678
2009/11/20,945,7678,6,33,31,2,1.01,0.763
2009/11/20,1045,7616,-63,93,83,10,1.017,0.55
2009/11/20,1145,7667,49,54,-2,56,1.008,1.133
2009/11/20,1245,7660,-7,23,15,8,1.007,1.442
2009/11/20,1345,7672,12,47,13,34,1.004,1.004
2009/11/23,945,7648,-12,53,45,8,1.006,1.086
2009/11/23,1045,7668,18,25,7,18,1.003,1.908
2009/11/23,1145,7664,-4,37,9,28,1.002,1.472
2009/11/23,1245,7667,1,21,16,5,1,2.116
2009/11/23,1345,7691,25,37,2,35,0.996,1.659
2009/11/24,945,7695,2,32,24,8,0.995,0.881
2009/11/24,1045,7696,1,22,8,14,0.995,1.338
2009/11/24,1145,7689,-7,18,6,12,0.997,1.254
2009/11/24,1245,7689,0,15,10,5,0.998,2.316
2009/11/24,1345,7700,10,25,4,21,0.997,0.886
2009/11/25,945,7765,70,99,20,79,0.989,0.371
2009/11/25,1045,7768,3,17,11,6,0.99,1.284
2009/11/25,1145,7735,-33,46,36,10,0.995,0.635
2009/11/25,1245,7755,20,24,6,18,0.994,1.399
2009/11/25,1345,7776,20,31,2,29,0.992,0.918
2009/11/26,945,7785,11,54,40,14,0.992,0.577
2009/11/26,1045,7779,-7,37,21,16,0.994,1.161
2009/11/26,1145,7779,-2,18,6,12,0.995,1.945
2009/11/26,1245,7752,-27,56,40,16,1,0.885
2009/11/26,1345,7743,-9,31,20,11,1.002,1.054
2009/11/27,945,7556,-69,95,69,26,1.025,0.469
2009/11/27,1045,7563,7,30,4,26,1.022,1.304
2009/11/27,1145,7570,7,26,20,6,1.018,1.333
2009/11/27,1245,7512,-58,62,60,2,1.024,0.887
2009/11/27,1345,7440,-72,94,90,4,1.03,0.631
2009/11/30,945,7565,7,42,17,25,1.01,0.896
2009/11/30,1045,7575,10,27,11,16,1.006,1.783
2009/11/30,1145,7585,11,17,7,10,1.002,1.922
2009/11/30,1245,7583,-3,15,7,8,1,2.592
2009/11/30,1345,7557,-27,34,28,6,1.001,1.31
2009/12/1,945,7541,-29,68,39,29,1.003,0.722
2009/12/1,1045,7564,25,45,20,25,0.999,1.023
2009/12/1,1145,7603,39,42,-5,47,0.994,1.285
2009/12/1,1245,7633,30,37,5,32,0.991,0.779
2009/12/1,1345,7639,6,42,31,11,0.991,0.689
2009/12/2,945,7705,30,50,16,34,0.984,0.735
2009/12/2,1045,7681,-25,49,27,22,0.989,0.722
2009/12/2,1145,7680,-2,33,8,25,0.991,1.509
2009/12/2,1245,7670,-10,21,20,1,0.993,2.074
2009/12/2,1345,7689,19,33,2,31,0.992,1.368
2009/12/3,945,7702,-38,65,43,22,0.993,0.788
2009/12/3,1045,7685,-17,37,17,20,0.997,1.2
2009/12/3,1145,7697,13,33,14,19,0.997,1.552
2009/12/3,1245,7677,-19,40,19,21,1.001,1.008
2009/12/3,1345,7697,20,59,2,57,0.999,0.717
2009/12/4,945,7679,4,28,9,19,1.001,1.392
2009/12/4,1045,7693,14,19,7,12,0.999,1.36
2009/12/4,1145,7682,-11,36,28,8,1,0.96
2009/12/4,1245,7668,-14,28,12,16,1.002,1.147
2009/12/4,1345,7592,-76,84,85,-1,1.012,0.645
2009/12/7,945,7696,47,90,23,67,0.997,0.556
2009/12/7,1045,7738,43,54,10,44,0.992,0.839
2009/12/7,1145,7728,-9,18,12,6,0.994,2.035
2009/12/7,1245,7768,41,36,-1,37,0.989,1.175
2009/12/7,1345,7754,-14,31,28,3,0.992,0.849
2009/12/8,945,7757,7,29,17,12,0.993,1.069
2009/12/8,1045,7728,-29,48,30,18,0.998,0.82
2009/12/8,1145,7738,9,22,9,13,0.997,1.83
2009/12/8,1245,7756,18,33,16,17,0.995,1.207
2009/12/8,1345,7757,1,29,2,27,0.996,1.262
2009/12/9,945,7727,8,31,13,18,1.001,0.883
2009/12/9,1045,7752,27,37,7,30,0.998,1.061
2009/12/9,1145,7742,-9,27,21,6,1,1.563
2009/12/9,1245,7747,4,23,6,17,0.999,1.975
2009/12/9,1345,7793,47,50,1,49,0.993,0.768
2009/12/10,945,7780,-19,36,27,9,0.995,0.806
2009/12/10,1045,7759,-21,24,22,2,0.998,0.91
2009/12/10,1145,7617,-142,157,142,15,1.017,0.351
2009/12/10,1245,7611,-7,58,37,21,1.016,0.781
2009/12/10,1345,7639,28,58,16,42,1.011,0.815
2009/12/11,945,7681,24,43,4,39,1.004,1.131
2009/12/11,1045,7736,57,65,6,59,0.997,0.82
2009/12/11,1145,7766,30,57,11,46,0.993,1.14
2009/12/11,1245,7744,-21,31,35,-4,0.996,1.516
2009/12/11,1345,7792,47,44,0,44,0.99,1.249
2009/12/14,945,7758,-31,103,87,16,0.994,0.724
2009/12/14,1045,7758,0,44,21,23,0.994,1.436
2009/12/14,1145,7760,2,36,16,20,0.993,1.777
2009/12/14,1245,7824,64,80,0,80,0.987,0.946
2009/12/14,1345,7831,6,28,3,25,0.989,1.21
2009/12/15,945,7823,-17,54,26,28,0.992,1.091
2009/12/15,1045,7788,-35,51,44,7,0.998,1.16
2009/12/15,1145,7817,29,31,11,20,0.995,1.426
2009/12/15,1245,7799,-18,28,25,3,0.998,1.928
2009/12/15,1345,7799,1,28,15,13,0.999,1.31
2009/12/16,945,7738,-71,102,70,32,1.007,0.582
2009/12/16,1045,7748,10,42,32,10,1.006,1.071
2009/12/16,1145,7764,17,28,14,14,1.003,2.13
2009/12/16,1245,7780,15,16,-3,19,1.001,2.954
2009/12/17,945,7778,65,80,20,60,1,0.431
2009/12/17,1045,7744,-33,63,41,22,1.004,0.699
2009/12/17,1145,7691,-53,79,54,25,1.01,0.628
2009/12/17,1245,7689,-2,42,29,13,1.009,1.152
2009/12/17,1345,7691,2,30,21,9,1.007,1.175
2009/12/18,945,7650,-12,57,18,39,1.01,0.803
2009/12/18,1045,7652,2,28,22,6,1.008,1.576
2009/12/18,1145,7656,4,26,1,25,1.006,1.493
2009/12/18,1245,7692,36,51,7,44,1.001,1.268
2009/12/18,1345,7701,9,28,12,16,0.998,1.259
2009/12/21,945,7755,54,78,35,43,0.991,0.623
2009/12/21,1045,7774,19,29,-1,30,0.989,1.522
2009/12/21,1145,7761,-13,28,24,4,0.991,1.351
2009/12/21,1245,7771,10,16,6,10,0.99,2.223
2009/12/21,1345,7753,-18,41,28,13,0.994,1.074
2009/12/22,945,7784,-4,39,28,11,0.991,0.79
2009/12/22,1045,7810,26,26,-3,29,0.99,1.327
2009/12/22,1145,7825,15,19,7,12,0.99,1.008
2009/12/22,1245,7813,-12,24,21,3,0.993,1.637
2009/12/22,1345,7831,18,16,-2,18,0.993,1.365
2009/12/23,945,7832,-12,36,22,14,0.994,0.778
2009/12/23,1045,7834,1,22,16,6,0.995,1.525
2009/12/23,1145,7857,24,33,6,27,0.993,0.88
2009/12/23,1245,7867,12,25,11,14,0.993,1.185
2009/12/23,1345,7867,-1,34,12,22,0.994,0.819
2009/12/24,945,7926,38,59,4,55,0.988,0.601
2009/12/24,1045,7945,19,49,20,29,0.987,0.701
2009/12/24,1145,7968,23,30,2,28,0.986,1.474
2009/12/24,1245,7946,-22,26,28,-2,0.991,1.246
2009/12/24,1345,7953,7,24,2,22,0.992,0.852
2009/12/25,945,7948,-12,42,39,3,0.994,0.828
2009/12/25,1045,7968,20,17,2,15,0.993,2.147
2009/12/25,1145,7964,-4,8,4,4,0.995,4.426
2009/12/25,1245,7968,4,17,10,7,0.996,2.584
2009/12/25,1345,7983,16,26,-1,27,0.995,1.42
2009/12/28,945,8026,31,57,7,50,0.991,0.569
2009/12/28,1045,8040,15,27,10,17,0.991,0.793
2009/12/28,1145,8061,21,38,17,21,0.989,0.762
2009/12/28,1245,8050,-11,22,25,-3,0.992,1.286
2009/12/28,1345,8045,-5,15,16,-1,0.994,0.87
2009/12/29,945,8040,7,32,19,13,0.995,0.662
2009/12/29,1045,8047,8,28,3,25,0.995,1.144
2009/12/29,1145,8038,-8,31,20,11,0.998,1.178
2009/12/29,1245,8055,17,28,8,20,0.996,1.52
2009/12/29,1345,8059,4,22,1,21,0.997,1.402
2009/12/30,945,8055,5,30,18,12,0.998,0.993
2009/12/30,1045,8060,4,18,3,15,0.998,1.709
2009/12/30,1145,8087,28,29,-1,30,0.995,0.896
2009/12/30,1245,8080,-7,39,35,4,0.996,0.7
2009/12/30,1345,8091,12,27,8,19,0.995,0.975
2009/12/31,945,8129,23,42,19,23,0.991,0.674
2009/12/31,1045,8129,0,23,6,17,0.992,1.376
2009/12/31,1145,8178,48,44,-8,52,0.987,0.739
2009/12/31,1245,8194,16,24,-2,26,0.987,1.011
2009/12/31,1345,8205,11,24,-5,29,0.988,0.852
2010/1/4,945,8188,-15,30,23,7,0.991,0.778
2010/1/4,1045,8166,-19,84,19,65,0.996,0.485
2010/1/4,1145,8172,6,22,8,14,0.996,1.689
2010/1/4,1245,8195,23,40,12,28,0.995,1.15
2010/1/4,1345,8166,-32,33,32,1,1,1.097
2010/1/5,945,8204,-8,79,56,23,0.996,0.494
2010/1/5,1045,8160,-43,83,48,35,1.002,0.655
2010/1/5,1145,8200,40,43,0,43,0.998,1.213
2010/1/5,1245,8164,-36,43,45,-2,1.003,1.448
2010/1/5,1345,8178,14,35,5,30,1.001,1.185
2010/1/6,945,8194,-3,67,52,15,0.998,0.618
2010/1/6,1045,8248,55,51,4,47,0.992,0.969
2010/1/6,1145,8282,34,42,3,39,0.989,0.802
2010/1/6,1245,8297,15,25,-7,32,0.988,1.637
2010/1/6,1345,8320,24,48,16,32,0.987,0.892
2010/1/7,945,8312,-23,54,43,11,0.989,0.786
2010/1/7,1045,8314,4,38,12,26,0.99,1.034
2010/1/7,1145,8322,8,34,26,8,0.991,1.52
2010/1/7,1245,8278,-44,63,43,20,0.998,0.794
2010/1/7,1345,8259,-19,46,17,29,1.002,0.823
2010/1/8,945,8240,-47,101,44,57,1.005,0.697
2010/1/8,1045,8270,30,51,9,42,1.002,1.108
2010/1/8,1145,8261,-9,46,36,10,1.003,1.26
2010/1/8,1245,8274,11,40,8,32,1.002,1.736
2010/1/8,1345,8278,4,33,18,15,1.001,1.357
2010/1/11,945,8321,43,79,9,70,0.995,0.79
2010/1/11,1045,8334,12,35,13,22,0.994,1.32
2010/1/11,1145,8342,7,26,11,15,0.993,1.627
2010/1/11,1245,8333,-10,32,19,13,0.994,1.543
2010/1/11,1345,8325,-7,31,12,19,0.996,1.22
2010/1/12,945,8290,-28,56,47,9,1,0.827
2010/1/12,1045,8285,-5,47,24,23,1.002,0.789
2010/1/12,1145,8302,17,59,3,56,1,0.713
2010/1/12,1245,8318,16,25,1,24,0.998,1.4
2010/1/12,1345,8308,-10,23,17,6,1,1.398
2010/1/13,945,8239,-20,45,31,14,1.008,0.644
2010/1/13,1045,8220,-21,32,13,19,1.01,0.786
2010/1/13,1145,8221,1,26,2,24,1.008,0.914
2010/1/13,1245,8202,-19,37,26,11,1.009,1.465
2010/1/13,1345,8215,12,27,7,20,1.006,1.238
2010/1/14,945,8252,6,21,5,16,1,1.274
2010/1/14,1045,8262,8,25,12,13,0.999,1.199
2010/1/14,1145,8272,10,25,7,18,0.997,1.574
2010/1/14,1245,8326,54,58,2,56,0.99,0.843
2010/1/14,1345,8301,-25,27,22,5,0.993,1.119
2010/1/15,945,8342,32,55,26,29,0.989,0.675
2010/1/15,1045,8328,-15,38,22,16,0.992,0.919
2010/1/15,1145,8377,47,62,6,56,0.988,0.855
2010/1/15,1245,8367,-10,31,6,25,0.991,1.269
2010/1/15,1345,8369,3,19,4,15,0.992,1.407
2010/1/18,945,8331,31,47,12,35,0.997,0.857
2010/1/18,1045,8330,-2,24,11,13,0.999,1.546
2010/1/18,1145,8358,27,32,0,32,0.996,1.346
2010/1/18,1245,8381,23,28,-2,30,0.994,1.459
2010/1/18,1345,8353,-29,32,26,6,0.998,1.044
2010/1/19,945,8330,-40,70,52,18,1.002,0.634
2010/1/19,1045,8276,-55,100,75,25,1.008,0.553
2010/1/19,1145,8261,-15,56,32,24,1.009,0.745
2010/1/19,1245,8261,0,48,17,31,1.008,0.922
2010/1/19,1345,8270,10,27,0,27,1.006,1.282
2010/1/20,945,8256,-50,60,52,8,1.007,1.028
2010/1/20,1045,8205,-53,55,51,4,1.013,0.91
2010/1/20,1145,8242,38,52,8,44,1.007,1.486
2010/1/20,1245,8239,-3,21,6,15,1.006,3.67
2010/1/21,945,8197,12,103,42,61,1.008,0.539
2010/1/21,1045,8124,-73,84,86,-2,1.015,0.718
2010/1/21,1145,8144,20,36,4,32,1.01,1.105
2010/1/21,1245,8133,-11,38,25,13,1.01,1.428
2010/1/21,1345,8134,2,32,14,18,1.008,1.073
2010/1/22,945,7955,-64,73,68,5,1.028,0.577
2010/1/22,1045,7966,11,63,2,61,1.022,0.895
2010/1/22,1145,7913,-53,50,55,-5,1.025,1.266
2010/1/22,1245,7909,-4,41,18,23,1.022,1.106
2010/1/22,1345,7897,-11,38,25,13,1.019,1.198
2010/1/25,945,7875,53,86,13,73,1.018,0.929
2010/1/25,1045,7904,29,57,6,51,1.01,1.133
2010/1/25,1145,7864,-40,42,40,2,1.012,1.657
2010/1/25,1245,7841,-23,48,39,9,1.012,1.367
2010/1/25,1345,7852,11,23,3,20,1.006,1.543
2010/1/26,945,7829,-3,51,57,-6,1.007,0.821
2010/1/26,1045,7747,-82,158,107,51,1.016,0.491
2010/1/26,1145,7677,-68,149,70,79,1.022,0.498
2010/1/26,1245,7609,-68,72,58,14,1.029,0.86
2010/1/26,1345,7556,-53,103,67,36,1.032,0.731
2010/1/27,945,7560,-14,81,54,27,1.028,0.789
2010/1/27,1045,7567,7,58,41,17,1.023,1.343
2010/1/27,1145,7608,39,65,25,40,1.013,1.406
2010/1/27,1245,7552,-57,74,64,10,1.017,1.448
2010/1/27,1345,7534,-17,64,39,25,1.016,1.364
2010/1/28,945,7609,30,72,26,46,1.002,1.056
2010/1/28,1045,7634,26,40,4,36,0.996,1.463
2010/1/28,1145,7691,57,71,6,65,0.987,1.1
2010/1/28,1245,7711,20,36,-3,39,0.985,1.306
2010/1/28,1345,7699,-12,72,46,26,0.988,0.864
2010/1/29,945,7495,-57,137,84,53,1.014,0.549
2010/1/29,1045,7580,88,111,-7,118,1.002,0.922
2010/1/29,1145,7624,44,91,9,82,0.996,0.926
2010/1/29,1245,7576,-49,73,53,20,1.003,1.184
2010/1/29,1345,7580,5,68,15,53,1.003,1.109
2010/2/1,945,7565,-4,83,69,14,1.005,0.886
2010/2/1,1045,7533,-33,73,31,42,1.008,0.866
2010/2/1,1145,7477,-55,87,57,30,1.015,0.96
2010/2/1,1245,7524,48,100,18,82,1.005,1.104
2010/2/1,1345,7513,-11,45,35,10,1.004,1.637
2010/2/2,945,7550,-30,56,53,3,1,1.074
2010/2/2,1045,7566,17,43,13,30,0.998,1.294
2010/2/2,1145,7517,-49,47,48,-1,1.005,1.321
2010/2/2,1245,7369,-148,159,156,3,1.023,0.556
2010/2/2,1345,7371,2,79,54,25,1.02,0.837
2010/2/3,945,7507,51,95,15,80,1,0.811
2010/2/3,1045,7419,-88,117,88,29,1.011,0.789
2010/2/3,1145,7502,83,105,26,79,0.999,0.895
2010/2/3,1245,7495,-7,63,23,40,1,1.339
2010/2/3,1345,7501,7,38,13,25,0.999,1.821
2010/2/4,945,7505,2,78,33,45,0.997,0.952
2010/2/4,1045,7508,3,40,0,40,0.996,1.499
2010/2/4,1145,7501,-7,35,24,11,0.996,1.654
2010/2/4,1245,7500,-1,28,-2,30,0.996,1.969
2010/2/4,1345,7507,7,27,2,25,0.997,2.417
2010/2/5,945,7231,-69,90,75,15,1.033,0.618
2010/2/5,1045,7232,3,53,18,35,1.029,0.963
2010/2/5,1145,7212,-20,40,28,12,1.029,1.372
2010/2/5,1245,7174,-39,52,47,5,1.031,1.044
2010/2/5,1345,7201,26,75,4,71,1.022,0.68
2010/2/6,945,7217,-12,60,19,41,1.016,1.057
2010/2/6,1045,7099,-118,159,116,43,1.029,0.725
2010/2/6,1145,7126,23,77,54,23,1.02,0.953
2010/2/6,1245,7179,53,80,18,62,1.007,1.371
2010/2/6,1345,7155,-24,44,39,5,1.006,1.821
2010/2/8,945,7200,45,110,35,75,0.998,0.615
2010/2/8,1045,7191,-9,49,8,41,0.998,1.019
2010/2/8,1145,7183,-7,29,24,5,0.999,1.634
2010/2/8,1245,7163,-21,37,40,-3,1.001,1.878
2010/2/8,1345,7160,-3,20,15,5,1.002,1.534
2010/2/9,945,7236,65,77,-8,85,0.99,0.866
2010/2/9,1045,7308,73,95,19,76,0.981,0.62
2010/2/9,1145,7304,-6,39,16,23,0.984,1.191
2010/2/9,1245,7343,41,49,-1,50,0.981,1.174
2010/2/9,1345,7316,-25,39,25,14,0.987,1.115
2010/2/10,945,7444,94,72,-14,86,0.973,0.671
2010/2/10,1045,7436,-6,51,43,8,0.977,0.777
2010/2/10,1145,7406,-32,65,52,13,0.984,1.047
2010/2/10,1245,7397,-9,59,19,40,0.989,0.968
2010/2/10,1345,7419,21,35,15,20,0.989,1.408
2010/2/22,945,7593,-110,82,45,37,0.973,0.976
2010/2/22,1045,7592,-4,49,30,19,0.978,1.997
2010/2/22,1145,7581,-12,22,19,3,0.983,3.9
2010/2/22,1245,7575,-4,17,13,4,0.988,4.136
2010/2/23,945,7478,-56,104,103,1,1.003,0.596
2010/2/23,1045,7478,0,41,14,27,1.005,0.864
2010/2/23,1145,7518,39,44,7,37,1,1.005
2010/2/23,1245,7526,8,32,16,16,1,1.174
2010/2/23,1345,7535,9,28,17,11,1,1.055
2010/2/24,945,7485,17,45,18,27,1.008,0.718
2010/2/24,1045,7527,43,47,7,40,0.999,0.864
2010/2/24,1145,7523,-4,32,22,10,0.999,1.232
2010/2/24,1245,7512,-11,40,30,10,0.999,1.304
2010/2/24,1345,7480,-33,39,37,2,1.003,1.078
2010/2/25,945,7476,-29,96,46,50,1.003,0.563
2010/2/25,1045,7485,7,33,19,14,1.002,1.032
2010/2/25,1145,7443,-42,38,42,-4,1.008,1.22
2010/2/25,1245,7348,-96,99,97,2,1.02,0.538
2010/2/25,1345,7368,21,63,32,31,1.014,0.911
2010/2/26,945,7408,30,53,26,27,1.008,0.87
2010/2/26,1045,7405,-3,34,24,10,1.007,1.413
2010/2/26,1145,7361,-44,74,54,20,1.011,0.863
2010/2/26,1245,7391,31,48,8,40,1.005,1.584
2010/2/26,1345,7383,-8,40,35,5,1.005,1.427
2010/3/1,945,7412,-1,36,19,17,0.999,1.067
2010/3/1,1045,7555,142,153,13,140,0.98,0.477
2010/3/1,1145,7593,38,47,1,46,0.976,1.443
2010/3/1,1245,7587,-5,26,12,14,0.978,1.714
2010/3/1,1345,7575,-12,50,30,20,0.983,0.907
2010/3/2,945,7637,42,54,12,42,0.978,0.826
2010/3/2,1045,7602,-35,55,29,26,0.985,0.898
2010/3/2,1145,7591,-8,29,24,5,0.989,1.904
2010/3/2,1245,7588,-1,40,21,19,0.993,1.406
2010/3/2,1345,7601,13,16,-3,19,0.994,2.211
2010/3/3,945,7655,59,68,9,59,0.989,0.747
2010/3/3,1045,7602,-53,74,50,24,0.999,0.725
2010/3/3,1145,7599,-3,32,19,13,1,1.433
2010/3/3,1245,7599,1,26,9,17,1,1.761
2010/3/3,1345,7611,12,25,8,17,0.999,1.52
2010/3/4,945,7615,-7,27,24,3,0.999,1.005
2010/3/4,1045,7624,8,31,4,27,0.997,1.038
2010/3/4,1145,7522,-102,116,106,10,1.011,0.61
2010/3/4,1245,7509,-13,69,23,46,1.012,0.604
2010/3/4,1345,7526,19,37,12,25,1.009,0.931
2010/3/5,945,7685,82,79,7,72,0.988,0.577
2010/3/5,1045,7655,-30,31,22,9,0.992,1.192
2010/3/5,1145,7612,-43,100,46,54,0.998,0.695
2010/3/5,1245,7610,-1,34,9,25,0.999,1.942
2010/3/5,1345,7659,49,52,-3,55,0.993,1.265
2010/3/8,945,7719,-10,42,9,33,0.986,1.065
2010/3/8,1045,7709,-10,34,35,-1,0.989,1.332
2010/3/8,1145,7728,19,28,9,19,0.987,2.202
2010/3/8,1245,7732,5,25,10,15,0.99,1.941
2010/3/8,1345,7755,23,27,1,26,0.99,1.258
2010/3/9,945,7733,-38,32,30,2,0.995,1.004
2010/3/9,1045,7745,13,38,17,21,0.994,1.196
2010/3/9,1145,7751,6,21,11,10,0.994,1.754
2010/3/9,1245,7747,-4,15,11,4,0.996,2.214
2010/3/9,1345,7764,17,17,0,17,0.996,1.322
2010/3/10,945,7760,-11,36,32,4,0.997,0.665
2010/3/10,1045,7713,-47,32,60,-28,1.004,0.883
2010/3/10,1145,7766,52,64,10,54,0.997,0.606
2010/3/10,1245,7764,-2,15,16,-1,0.998,1.485
2010/3/10,1345,7769,5,15,8,7,0.997,1.404
2010/3/11,945,7788,-12,26,20,6,0.995,0.838
2010/3/11,1045,7758,-31,54,40,14,1,0.575
2010/3/11,1145,7732,-26,34,36,-2,1.003,0.883
2010/3/11,1245,7767,34,42,13,29,0.999,1.123
2010/3/11,1345,7757,-10,26,12,14,1,1.175
2010/3/12,945,7752,-33,70,29,41,1.001,0.646
2010/3/12,1045,7753,0,19,5,14,1.001,1.375
2010/3/12,1145,7747,-7,27,14,13,1.002,1.417
2010/3/12,1245,7751,2,19,4,15,1.001,2.217
2010/3/12,1345,7754,3,18,11,7,1.001,1.218
2010/3/15,945,7723,-33,44,30,14,1.004,0.634
2010/3/15,1045,7634,-89,88,89,-1,1.015,0.433
2010/3/15,1145,7666,32,34,1,33,1.009,1.216
2010/3/15,1245,7649,-16,33,29,4,1.011,1.717
2010/3/15,1345,7655,6,17,7,10,1.008,1.001
2010/3/16,945,7653,2,33,22,11,1.007,0.921
2010/3/16,1045,7666,13,33,14,19,1.004,1.376
2010/3/16,1145,7667,0,13,6,7,1.002,2.862
2010/3/16,1245,7675,9,19,10,9,1,1.903
2010/3/16,1345,7703,27,30,2,28,0.996,1.579
2010/3/17,945,7811,61,70,5,65,0.982,0.608
2010/3/17,1045,7807,-4,13,1,12,0.984,1.781
2010/3/17,1145,7806,-2,28,1,27,0.986,1.619
2010/3/17,1245,7801,-3,30,19,11,0.988,1.486
2010/3/18,945,7849,12,66,16,50,0.985,0.418
2010/3/18,1045,7853,5,46,16,30,0.987,0.864
2010/3/18,1145,7870,17,30,5,25,0.987,1.188
2010/3/18,1245,7909,39,53,13,40,0.985,0.665
2010/3/18,1345,7850,-60,65,64,1,0.995,0.723
2010/3/19,945,7866,16,43,11,32,0.995,0.89
2010/3/19,1045,7838,-28,31,28,3,1,1.293
2010/3/19,1145,7855,18,29,10,19,0.999,1.578
2010/3/19,1245,7860,5,18,2,16,0.999,2.553
2010/3/19,1345,7867,7,23,17,6,0.998,1.074
2010/3/22,945,7788,-42,77,52,25,1.008,0.545
2010/3/22,1045,7770,-18,50,25,25,1.01,0.764
2010/3/22,1145,7805,35,46,1,45,1.004,1.219
2010/3/22,1245,7803,-2,34,22,12,1.004,1.275
2010/3/22,1345,7802,-1,19,17,2,1.003,1.546
2010/3/23,945,7828,-22,33,31,2,0.999,0.861
2010/3/23,1045,7834,6,26,5,21,0.998,1.253
2010/3/23,1145,7830,-4,21,18,3,0.999,1.568
2010/3/23,1245,7789,-40,68,45,23,1.003,0.646
2010/3/23,1345,7804,13,49,1,48,1.001,0.805
2010/3/24,945,7847,-18,35,23,12,0.996,0.844
2010/3/24,1045,7846,-1,31,6,25,0.996,0.996
2010/3/24,1145,7830,-17,32,32,0,0.999,1.125
2010/3/24,1245,7820,-10,33,19,14,1.001,1.148
2010/3/24,1345,7815,-5,25,14,11,1.002,1.068
2010/3/25,945,7753,-39,71,51,20,1.009,0.591
2010/3/25,1045,7745,-10,37,8,29,1.009,0.773
2010/3/25,1145,7780,35,60,9,51,1.004,0.897
2010/3/25,1245,7841,61,84,17,67,0.995,0.764
2010/3/25,1345,7803,-41,43,52,-9,1.001,0.969
2010/3/26,945,7763,-46,51,12,39,1.005,0.678
2010/3/26,1045,7788,25,48,12,36,1.001,1.081
2010/3/26,1145,7902,115,129,15,114,0.986,0.6
2010/3/26,1245,7897,-5,40,15,25,0.987,1.421
2010/3/26,1345,7886,-11,46,21,25,0.99,1.197
2010/3/29,945,7937,25,43,15,28,0.985,1.134
2010/3/29,1045,7941,3,32,21,11,0.986,1.292
2010/3/29,1145,7957,16,31,9,22,0.987,1.986
2010/3/29,1245,7946,-12,24,20,4,0.991,2.147
2010/3/29,1345,7957,11,27,2,25,0.99,1.671
2010/3/30,945,7966,-11,39,25,14,0.991,1.051
2010/3/30,1045,7962,-4,30,10,20,0.995,1.539
2010/3/30,1145,7965,2,26,1,25,0.996,1.564
2010/3/30,1245,7957,-7,18,13,5,0.998,2.208
2010/3/30,1345,7961,4,20,5,15,0.998,1.118
2010/3/31,945,7933,-13,39,22,17,1.002,0.722
2010/3/31,1045,7959,26,33,11,22,0.999,0.723
2010/3/31,1145,7955,-4,15,12,3,1,1.709
2010/3/31,1245,7948,-8,28,16,12,1.001,1.415
2010/3/31,1345,7906,-43,55,44,11,1.006,0.668
2010/4/1,945,8019,79,87,-4,91,0.991,0.479
2010/4/1,1045,8007,-12,30,23,7,0.993,0.836
2010/4/1,1145,8032,26,34,5,29,0.991,1.121
2010/4/1,1245,8018,-14,26,20,6,0.993,1.532
2010/4/1,1345,8025,7,29,16,13,0.993,0.862
2010/4/2,945,8028,4,31,19,12,0.994,1.052
2010/4/2,1045,8022,-7,19,12,7,0.996,1.903
2010/4/2,1145,8027,5,10,5,5,0.996,3.272
2010/4/2,1245,8028,0,10,2,8,0.997,3.541
2010/4/2,1345,8039,11,14,-1,15,0.996,2.033
2010/4/6,945,8134,63,66,-6,72,0.986,0.416
2010/4/6,1045,8125,-9,25,17,8,0.989,0.901
2010/4/6,1145,8117,-7,33,22,11,0.991,1.066
2010/4/6,1245,8122,5,22,8,14,0.992,2.051
2010/4/6,1345,8096,-25,43,27,16,0.996,0.57
2010/4/7,945,8115,-10,30,25,5,0.995,0.704
2010/4/7,1045,8120,5,25,0,25,0.996,0.844
2010/4/7,1145,8116,-4,19,12,7,0.997,1.739
2010/4/7,1245,8119,2,19,13,6,0.998,1.851
2010/4/7,1345,8126,7,18,4,14,0.998,1.424
2010/4/8,945,8075,-35,35,40,-5,1.005,0.657
2010/4/8,1045,8147,73,99,23,76,0.995,0.496
2010/4/8,1145,8135,-12,33,23,10,0.997,1.26
2010/4/8,1245,8057,-79,89,77,12,1.007,0.455
2010/4/8,1345,8081,24,34,-1,35,1.003,0.842
2010/4/9,945,8074,-3,39,11,28,1.004,1.044
2010/4/9,1045,8068,-6,51,37,14,1.004,0.973
2010/4/9,1145,8091,23,28,1,27,1,1.735
2010/4/9,1245,8089,-2,17,1,16,1,2.231
2010/4/9,1345,8101,12,22,4,18,0.998,1.611
2010/4/12,945,8126,-32,42,38,4,0.996,0.941
2010/4/12,1045,8116,-10,27,21,6,0.998,1.097
2010/4/12,1145,8093,-23,32,35,-3,1,1.22
2010/4/12,1245,8114,21,39,11,28,0.997,1.436
2010/4/12,1345,8126,12,22,3,19,0.996,1.036
2010/4/13,945,8074,-12,59,13,46,1.003,0.484
2010/4/13,1045,8098,25,47,21,26,1,0.712
2010/4/13,1145,8040,-58,65,68,-3,1.008,0.785
2010/4/13,1245,8047,7,20,10,10,1.006,1.472
2010/4/13,1345,8019,-28,55,49,6,1.009,0.743
2010/4/14,945,8056,-9,37,32,5,1.003,0.922
2010/4/14,1045,8048,-9,24,14,10,1.003,1.131
2010/4/14,1145,8058,10,22,6,16,1.001,2.175
2010/4/14,1245,8065,7,20,5,15,1,2.326
2010/4/14,1345,8112,47,48,1,47,0.994,0.84
2010/4/15,945,8159,6,53,37,16,0.989,0.649
2010/4/15,1045,8148,-12,35,17,18,0.991,1.039
2010/4/15,1145,8152,4,23,6,17,0.991,1.614
2010/4/15,1245,8153,-1,23,17,6,0.992,1.592
2010/4/15,1345,8158,5,22,12,10,0.993,1.198
2010/4/16,945,8126,-21,28,29,-1,0.998,0.811
2010/4/16,1045,8083,-44,69,56,13,1.004,0.537
2010/4/16,1145,8119,36,53,13,40,1,0.885
2010/4/16,1245,8104,-14,21,17,4,1.003,1.832
2010/4/16,1345,8102,-2,20,10,10,1.004,1.316
2010/4/19,945,8001,-1,34,32,2,1.014,0.803
2010/4/19,1045,7968,-32,50,40,10,1.017,0.624
2010/4/19,1145,7929,-40,54,47,7,1.019,0.858
2010/4/19,1245,7910,-18,27,35,-8,1.019,1.692
2010/4/19,1345,7822,-88,96,95,1,1.027,0.554
2010/4/20,945,7846,-34,47,49,-2,1.021,0.861
2010/4/20,1045,7873,28,52,4,48,1.014,1.145
2010/4/20,1145,7875,2,28,10,18,1.011,1.881
2010/4/20,1245,7888,12,37,23,14,1.006,1.223
2010/4/20,1345,7876,-11,24,22,2,1.005,1.732
2010/4/21,945,7986,36,40,-9,49,0.99,1.091
2010/4/21,1045,7961,-25,45,37,8,0.993,0.988
2010/4/21,1145,7974,13,54,3,51,0.991,1.195
2010/4/21,1245,7970,-4,18,12,6,0.992,2.59
2010/4/22,945,7848,-57,140,146,-6,1.008,0.434
2010/4/22,1045,7880,32,36,4,32,1.003,0.878
2010/4/22,1145,7893,13,51,22,29,1.002,0.843
2010/4/22,1245,7925,31,37,-3,40,0.998,1.566
2010/4/22,1345,7925,0,29,28,1,0.999,0.886
2010/4/23,945,7952,1,41,31,10,0.996,0.811
2010/4/23,1045,7954,2,37,20,17,0.996,1.027
2010/4/23,1145,7951,-5,18,15,3,0.996,2.074
2010/4/23,1245,7959,8,23,4,19,0.995,2.065
2010/4/23,1345,7958,-1,18,15,3,0.995,1.529
2010/4/26,945,8120,43,69,24,45,0.977,0.585
2010/4/26,1045,8131,11,23,5,18,0.979,1.542
2010/4/26,1145,8144,13,26,11,15,0.981,1.147
2010/4/26,1245,8153,9,20,9,11,0.983,1.801
2010/4/26,1345,8148,-6,24,9,15,0.986,0.97
2010/4/27,945,8128,-20,20,20,0,0.991,1.245
2010/4/27,1045,8115,-12,22,17,5,0.995,0.934
2010/4/27,1145,8141,27,35,3,32,0.994,1.163
2010/4/27,1245,8136,-5,20,16,4,0.996,1.763
2010/4/27,1345,8130,-5,13,8,5,0.999,1.436
2010/4/28,945,7992,31,68,-4,72,1.015,0.465
2010/4/28,1045,8006,12,53,37,16,1.012,0.524
2010/4/28,1145,8046,40,45,6,39,1.005,0.902
2010/4/28,1245,8025,-22,34,27,7,1.007,1.168
2010/4/28,1345,8035,10,37,24,13,1.004,0.959
2010/4/29,945,8051,15,39,14,25,1,0.851
2010/4/29,1045,8016,-35,31,33,-2,1.004,1.121
2010/4/29,1145,8044,28,32,1,31,0.999,1.648
2010/4/29,1245,8047,3,14,5,9,0.998,2.06
2010/4/29,1345,8043,-4,15,4,11,0.997,1.601
2010/4/30,945,8078,-50,64,74,-10,0.995,0.556
2010/4/30,1045,8077,-1,42,22,20,0.996,0.64
2010/4/30,1145,8068,-9,39,22,17,0.998,1.106
2010/4/30,1245,8055,-11,31,33,-2,1,1.532
2010/4/30,1345,7989,-66,90,67,23,1.008,0.514
2010/5/3,945,7962,37,80,39,41,1.01,0.646
2010/5/3,1045,7945,-17,30,18,12,1.011,1.179
2010/5/3,1145,7912,-33,61,29,32,1.015,0.729
2010/5/3,1245,7903,-9,45,18,27,1.014,1.336
2010/5/3,1345,7931,27,38,7,31,1.009,1.274
2010/5/4,945,7957,-11,50,25,25,1.004,0.946
2010/5/4,1045,7915,-42,33,43,-10,1.007,1.479
2010/5/4,1145,7887,-27,67,28,39,1.009,0.637
2010/5/4,1245,7944,56,89,3,86,0.999,0.958
2010/5/4,1345,7880,-64,65,68,-3,1.006,1.176
2010/5/5,945,7694,4,70,56,14,1.027,0.587
2010/5/5,1045,7685,-8,53,22,31,1.025,0.788
2010/5/5,1145,7668,-17,58,41,17,1.024,1.133
2010/5/5,1245,7670,2,34,19,15,1.021,1.784
2010/5/5,1345,7657,-12,47,39,8,1.019,1.216
2010/5/6,945,7632,-11,42,37,5,1.018,1.068
2010/5/6,1045,7631,0,35,16,19,1.014,1.352
2010/5/6,1145,7628,-2,31,25,6,1.011,1.622
2010/5/6,1245,7535,-93,109,94,15,1.02,0.669
2010/5/6,1345,7579,44,62,-5,67,1.008,0.868
2010/5/7,945,7397,45,78,54,24,1.029,0.563
2010/5/7,1045,7509,112,92,-11,103,1.009,0.756
2010/5/7,1145,7500,-9,60,15,45,1.008,1.168
2010/5/7,1245,7518,18,50,29,21,1.004,1.117
2010/5/7,1345,7502,-17,32,26,6,1.004,1.253
2010/5/10,945,7557,-7,45,26,19,0.995,1.083
2010/5/10,1045,7562,4,44,37,7,0.994,1.297
2010/5/10,1145,7573,11,49,7,42,0.991,1.42
2010/5/10,1245,7586,13,44,14,30,0.989,1.956
2010/5/10,1345,7637,50,51,-1,52,0.983,1.224
2010/5/11,945,7664,94,69,33,36,0.983,0.724
2010/5/11,1045,7652,-13,27,18,9,0.988,1.066
2010/5/11,1145,7635,-16,47,23,24,0.992,0.952
2010/5/11,1245,7588,-47,62,46,16,1,0.866
2010/5/11,1345,7568,-20,59,46,13,1.003,0.815
2010/5/12,945,7603,-27,55,45,10,0.999,0.941
2010/5/12,1045,7609,6,54,49,5,0.999,0.81
2010/5/12,1145,7587,-22,45,31,14,1.003,1.083
2010/5/12,1245,7565,-22,44,50,-6,1.006,1.569
2010/5/12,1345,7587,21,45,-1,46,1.003,0.928
2010/5/13,945,7684,-14,31,13,18,0.992,1.029
2010/5/13,1045,7665,-19,27,22,5,0.994,1.568
2010/5/13,1145,7728,63,72,8,64,0.986,0.837
2010/5/13,1245,7767,39,59,10,49,0.983,0.971
2010/5/13,1345,7761,-6,27,14,13,0.986,1.081
2010/5/14,945,7747,35,38,2,36,0.989,1.066
2010/5/14,1045,7743,-3,40,21,19,0.991,1.071
2010/5/14,1145,7744,1,25,14,11,0.992,1.873
2010/5/14,1245,7756,12,32,9,23,0.993,1.84
2010/5/14,1345,7760,4,15,6,9,0.995,1.555
2010/5/17,945,7601,-79,84,81,3,1.015,0.556
2010/5/17,1045,7595,-6,51,17,34,1.015,0.733
2010/5/17,1145,7559,-37,40,40,0,1.019,1.181
2010/5/17,1245,7567,7,31,19,12,1.016,1.363
2010/5/17,1345,7602,35,38,1,37,1.009,0.914
2010/5/18,945,7633,23,42,5,37,1.003,0.877
2010/5/18,1045,7608,-24,33,25,8,1.005,1.192
2010/5/18,1145,7612,4,39,3,36,1.003,1.021
2010/5/18,1245,7604,-7,18,13,5,1.002,2.134
2010/5/18,1345,7619,16,39,-4,43,0.998,1.21
2010/5/19,945,7539,21,68,14,54,1.006,0.783
2010/5/19,1045,7512,-26,46,30,16,1.009,1.198
2010/5/19,1145,7528,15,67,7,60,1.006,1.06
2010/5/19,1245,7551,23,60,24,36,1.002,1.409
2010/5/20,945,7480,-29,122,107,15,1.011,0.546
2010/5/20,1045,7508,30,37,6,31,1.006,0.916
2010/5/20,1145,7479,-29,40,31,9,1.008,1.146
2010/5/20,1245,7390,-86,89,87,2,1.018,0.577
2010/5/20,1345,7357,-33,74,79,-5,1.02,0.779
2010/5/21,945,7145,-19,73,40,33,1.044,0.708
2010/5/21,1045,7192,49,79,30,49,1.032,0.851
2010/5/21,1145,7221,29,62,26,36,1.023,1.226
2010/5/21,1245,7209,-13,51,30,21,1.021,1.399
2010/5/21,1345,7209,1,38,22,16,1.016,1.372
2010/5/24,945,7247,23,43,16,27,1.007,0.995
2010/5/24,1045,7308,62,72,2,70,0.995,0.945
2010/5/24,1145,7288,-20,45,29,16,0.995,1.331
2010/5/24,1245,7302,15,41,17,24,0.991,1.739
2010/5/24,1345,7274,-28,37,36,1,0.993,1.256
2010/5/25,945,7125,-63,62,62,0,1.015,0.654
2010/5/25,1045,7107,-18,52,27,25,1.017,0.742
2010/5/25,1145,7062,-44,65,55,10,1.022,0.903
2010/5/25,1245,7062,0,66,10,56,1.02,0.834
2010/5/25,1345,7052,-10,58,45,13,1.019,0.841
2010/5/26,945,7110,-12,61,40,21,1.009,0.904
2010/5/26,1045,7087,-24,68,26,42,1.011,0.75
2010/5/26,1145,7127,41,56,1,55,1.002,1.089
2010/5/26,1245,7124,-3,36,12,24,1,1.434
2010/5/26,1345,7122,-2,38,32,6,0.998,1.271
2010/5/27,945,7087,-16,57,46,11,1.002,0.984
2010/5/27,1045,7130,44,61,-13,74,0.995,0.969
2010/5/27,1145,7164,34,55,15,40,0.991,0.965
2010/5/27,1245,7225,59,72,-3,75,0.984,1.073
2010/5/27,1345,7202,-24,36,32,4,0.989,1.072
2010/5/28,945,7314,25,58,14,44,0.976,0.903
2010/5/28,1045,7270,-44,67,51,16,0.985,0.894
2010/5/28,1145,7244,-27,41,33,8,0.991,1.174
2010/5/28,1245,7235,-8,54,53,1,0.994,1.251
2010/5/28,1345,7280,45,56,-3,59,0.989,0.915
2010/5/31,945,7260,-42,39,43,-4,0.995,1.292
2010/5/31,1045,7285,25,35,5,30,0.994,1.492
2010/5/31,1145,7309,22,39,11,28,0.993,1.269
2010/5/31,1245,7289,-20,27,26,1,0.997,2.07
2010/5/31,1345,7325,36,44,8,36,0.993,1.257
2010/6/1,945,7237,-46,62,51,11,1.005,0.706
2010/6/1,1045,7305,69,81,-2,83,0.995,0.647
2010/6/1,1145,7286,-18,39,35,4,0.998,1.011
2010/6/1,1245,7251,-35,75,49,26,1.003,0.798
2010/6/1,1345,7244,-7,33,20,13,1.005,1.131
2010/6/2,945,7238,45,54,-6,60,1.004,0.844
2010/6/2,1045,7257,19,49,18,31,1.001,0.853
2010/6/2,1145,7220,-38,74,62,12,1.006,0.851
2010/6/2,1245,7153,-67,96,84,12,1.014,0.771
2010/6/2,1345,7140,-13,58,19,39,1.014,0.896
2010/6/3,945,7292,39,64,28,36,0.992,0.775
2010/6/3,1045,7305,13,44,22,22,0.991,1.104
2010/6/3,1145,7320,15,43,9,34,0.989,1.313
2010/6/3,1245,7329,9,23,6,17,0.988,1.915
2010/6/3,1345,7338,9,18,2,16,0.988,1.673
2010/6/4,945,7322,-16,27,26,1,0.992,1.718
2010/6/4,1045,7327,6,28,6,22,0.993,1.343
2010/6/4,1145,7337,11,18,3,15,0.993,1.992
2010/6/4,1245,7323,-14,23,13,10,0.996,2.017
2010/6/4,1345,7321,-3,16,12,4,0.999,1.802
2010/6/7,945,7038,-62,61,67,-6,1.037,0.448
2010/6/7,1045,7119,81,93,9,84,1.021,0.569
2010/6/7,1145,7086,-32,50,30,20,1.023,1.024
2010/6/7,1245,7110,26,36,-12,48,1.017,1.243
2010/6/7,1345,7097,-13,32,30,2,1.015,0.88
2010/6/8,945,7128,31,51,11,40,1.008,0.849
2010/6/8,1045,7115,-13,58,18,40,1.007,0.724
2010/6/8,1145,7119,4,32,15,17,1.003,1.329
2010/6/8,1245,7117,-2,26,15,11,1,2.168
2010/6/8,1345,7129,11,14,-2,16,0.996,1.927
2010/6/9,945,7126,46,61,13,48,0.996,0.83
2010/6/9,1045,7077,-48,56,50,6,1.004,0.815
2010/6/9,1145,7051,-26,62,42,20,1.007,0.707
2010/6/9,1245,6995,-58,63,69,-6,1.015,0.862
2010/6/9,1345,7038,43,51,9,42,1.007,0.827
2010/6/10,945,7051,-17,37,29,8,1.005,0.999
2010/6/10,1045,7068,16,47,17,30,1.001,0.908
2010/6/10,1145,7095,27,38,0,38,0.997,1.243
2010/6/10,1245,7131,36,45,13,32,0.991,0.971
2010/6/10,1345,7163,34,42,0,42,0.987,0.964
2010/6/11,945,7288,-28,32,10,22,0.973,1.055
2010/6/11,1045,7269,-18,21,13,8,0.978,1.227
2010/6/11,1145,7266,-3,32,10,22,0.981,1.277
2010/6/11,1245,7279,13,26,4,22,0.982,2.032
2010/6/11,1345,7293,14,27,2,25,0.984,1.179
2010/6/14,945,7363,7,29,15,14,0.979,0.966
2010/6/14,1045,7347,-15,27,16,11,0.985,1.323
2010/6/14,1145,7382,36,42,6,36,0.984,1.081
2010/6/14,1245,7377,-5,21,14,7,0.989,1.607
2010/6/14,1345,7382,3,21,13,8,0.992,1.169
2010/6/15,945,7377,-1,15,2,13,0.993,1.239
2010/6/15,1045,7409,32,36,1,35,0.99,1.047
2010/6/15,1145,7403,-6,16,10,6,0.993,1.368
2010/6/15,1245,7485,81,96,13,83,0.984,0.488
2010/6/15,1345,7459,-26,47,36,11,0.99,0.696
2010/6/17,945,7502,-16,23,22,1,0.986,1.181
2010/6/17,1045,7520,18,23,3,20,0.986,1.528
2010/6/17,1145,7484,-36,58,53,5,0.993,1.079
2010/6/17,1245,7503,19,27,4,23,0.992,1.708
2010/6/18,945,7332,-32,196,191,5,1.015,0.521
2010/6/18,1045,7360,28,31,6,25,1.01,1.013
2010/6/18,1145,7352,-8,43,25,18,1.011,1.257
2010/6/18,1245,7333,-20,28,35,-7,1.013,2.044
2010/6/18,1345,7352,19,67,12,55,1.009,0.591
2010/6/21,945,7425,-15,101,84,17,0.999,0.478
2010/6/21,1045,7465,40,48,11,37,0.992,0.95
2010/6/21,1145,7509,43,68,16,52,0.986,0.817
2010/6/21,1245,7507,-2,30,15,15,0.986,1.482
2010/6/21,1345,7523,17,28,1,27,0.984,1.195
2010/6/22,945,7476,-4,23,19,4,0.992,1.235
2010/6/22,1045,7499,22,30,-1,31,0.991,1.207
2010/6/22,1145,7496,-2,16,10,6,0.993,1.869
2010/6/22,1245,7486,-11,13,8,5,0.996,2.32
2010/6/22,1345,7480,-5,15,12,3,0.999,2.173
2010/6/23,945,7400,-30,45,33,12,1.01,0.632
2010/6/23,1045,7452,50,64,13,51,1.003,0.637
2010/6/23,1145,7435,-15,47,43,4,1.005,0.864
2010/6/23,1245,7423,-12,22,22,0,1.005,1.433
2010/6/23,1345,7437,14,24,-1,25,1.002,1.019
2010/6/24,945,7434,3,33,14,19,1.002,1.049
2010/6/24,1045,7437,2,51,12,39,1.001,0.734
2010/6/24,1145,7444,8,25,12,13,0.999,1.157
2010/6/24,1245,7437,-8,22,15,7,1,1.897
2010/6/24,1345,7427,-10,18,19,-1,1,1.777
2010/6/25,945,7364,23,36,11,25,1.008,0.717
2010/6/25,1045,7376,12,29,9,20,1.005,1.022
2010/6/25,1145,7350,-26,37,32,5,1.008,0.99
2010/6/25,1245,7313,-37,45,34,11,1.012,0.563
2010/6/25,1345,7324,11,30,17,13,1.009,0.896
2010/6/28,945,7346,12,27,7,20,1.005,1.206
2010/6/28,1045,7367,21,27,5,22,1,1.082
2010/6/28,1145,7359,-8,25,11,14,1.001,1.752
2010/6/28,1245,7367,7,18,8,10,0.998,2.224
2010/6/28,1345,7362,-5,23,6,17,0.998,1.435
2010/6/29,945,7436,43,56,17,39,0.989,0.711
2010/6/29,1045,7333,-104,105,102,3,1.004,0.5
2010/6/29,1145,7322,-11,56,31,25,1.005,0.693
2010/6/29,1245,7277,-47,59,50,9,1.011,0.81
2010/6/29,1345,7252,-25,66,66,0,1.014,0.632
2010/6/30,945,7134,8,48,6,42,1.027,0.718
2010/6/30,1045,7125,-8,41,30,11,1.026,1.099
2010/6/30,1145,7147,22,32,5,27,1.019,1.853
2010/6/30,1245,7150,2,30,18,12,1.016,1.672
2010/6/30,1345,7153,5,19,1,18,1.012,1.663
2010/7/1,945,7134,11,50,13,37,1.011,0.861
2010/7/1,1045,7123,-11,61,6,55,1.008,0.692
2010/7/1,1145,7102,-22,38,33,5,1.009,1.362
2010/7/1,1245,7095,-6,51,17,34,1.006,1.064
2010/7/1,1345,7101,8,33,14,19,1.003,1.115
2010/7/2,945,7129,-6,23,10,13,0.999,1.166
2010/7/2,1045,7186,56,86,28,58,0.991,0.599
2010/7/2,1145,7195,9,39,21,18,0.991,1.139
2010/7/2,1245,7148,-46,57,47,10,0.998,0.899
2010/7/2,1345,7165,17,22,4,18,0.996,1.429
2010/7/5,945,7180,-5,32,25,7,0.994,1.365
2010/7/5,1045,7221,41,57,4,53,0.989,0.877
2010/7/5,1145,7211,-8,29,19,10,0.992,1.276
2010/7/5,1245,7289,79,83,6,77,0.983,0.734
2010/7/5,1345,7324,36,58,0,58,0.981,0.81
2010/7/6,945,7283,21,54,17,37,0.988,1.036
2010/7/6,1045,7338,55,75,20,55,0.983,0.748
2010/7/6,1145,7396,58,69,6,63,0.977,0.901
2010/7/6,1245,7428,32,43,7,36,0.976,0.869
2010/7/6,1345,7456,30,42,2,40,0.976,0.97
2010/7/7,945,7440,4,48,15,33,0.981,1.086
2010/7/7,1045,7426,-12,33,27,6,0.987,1.279
2010/7/7,1145,7426,-1,28,8,20,0.989,1.624
2010/7/7,1245,7424,-2,23,5,18,0.992,1.886
2010/7/7,1345,7447,22,36,8,28,0.991,1.607
2010/7/8,945,7541,-27,43,28,15,0.983,0.836
2010/7/8,1045,7515,-25,41,37,4,0.99,1.206
2010/7/8,1145,7533,18,35,2,33,0.99,1.254
2010/7/8,1245,7532,-1,34,28,6,0.992,0.914
2010/7/8,1345,7532,0,40,18,22,0.993,0.891
2010/7/9,945,7534,-6,29,23,6,0.994,1.193
2010/7/9,1045,7547,12,30,5,25,0.994,1.022
2010/7/9,1145,7569,23,38,9,29,0.992,0.936
2010/7/9,1245,7567,-2,20,13,7,0.995,1.763
2010/7/9,1345,7566,-1,20,16,4,0.997,1.242
2010/7/12,945,7566,-24,27,19,8,0.997,1.166
2010/7/12,1045,7599,33,48,5,43,0.993,0.867
2010/7/12,1145,7643,44,59,11,48,0.988,0.665
2010/7/12,1245,7638,-5,17,7,10,0.99,1.72
2010/7/12,1345,7533,-104,114,110,4,1.006,0.496
2010/7/13,945,7567,-22,49,36,13,1.002,0.821
2010/7/13,1045,7568,1,33,23,10,1.002,1.032
2010/7/13,1145,7547,-21,43,28,15,1.005,0.848
2010/7/13,1245,7560,13,46,3,43,1.003,1.086
2010/7/13,1345,7560,0,32,0,32,1.003,1.274
2010/7/14,945,7693,30,36,-3,39,0.987,0.946
2010/7/14,1045,7689,-5,19,7,12,0.989,1.381
2010/7/14,1145,7663,-26,47,29,18,0.993,1.077
2010/7/14,1245,7667,3,14,9,5,0.993,2.583
2010/7/14,1345,7703,35,34,-1,35,0.989,0.895
2010/7/15,945,7676,-1,28,20,8,0.993,1.102
2010/7/15,1045,7700,25,50,28,22,0.992,0.65
2010/7/15,1145,7717,17,28,3,25,0.991,1.368
2010/7/15,1245,7698,-18,23,20,3,0.996,1.609
2010/7/15,1345,7707,9,22,13,9,0.997,1.271
2010/7/16,945,7652,-49,62,58,4,1.004,0.693
2010/7/16,1045,7693,41,80,22,58,0.998,0.54
2010/7/16,1145,7670,-23,50,45,5,1.001,0.855
2010/7/16,1245,7685,16,33,20,13,0.999,1.689
2010/7/16,1345,7669,-18,30,16,14,1.002,0.921
2010/7/19,945,7634,33,43,7,36,1.005,0.88
2010/7/19,1045,7657,22,42,10,32,1.002,0.995
2010/7/19,1145,7648,-9,33,25,8,1.002,1.44
2010/7/19,1245,7648,2,32,19,13,1.002,1.677
2010/7/19,1345,7659,9,16,1,15,1,1.461
2010/7/20,945,7652,5,19,17,2,1,1.241
2010/7/20,1045,7676,22,50,9,41,0.997,0.726
2010/7/20,1145,7718,42,54,7,47,0.991,0.919
2010/7/20,1245,7731,13,28,15,13,0.99,0.961
2010/7/20,1345,7709,-23,32,35,-3,0.993,0.768
2010/7/21,945,7736,-22,16,14,2,0.992,1.529
2010/7/21,1045,7744,6,19,1,18,0.992,1.842
2010/7/21,1145,7726,-18,26,24,2,0.996,1.834
2010/7/21,1245,7705,-21,36,19,17,0.999,1.028
2010/7/22,945,7544,-41,184,176,8,1.02,0.429
2010/7/22,1045,7565,21,39,20,19,1.016,0.761
2010/7/22,1145,7560,-3,24,22,2,1.015,1.273
2010/7/22,1245,7575,15,24,12,12,1.012,1.618
2010/7/22,1345,7563,-12,27,22,5,1.011,1.143
2010/7/23,945,7669,22,41,7,34,0.996,0.679
2010/7/23,1045,7662,-7,28,23,5,0.996,1.213
2010/7/23,1145,7670,5,16,9,7,0.994,1.696
2010/7/23,1245,7694,24,36,8,28,0.99,1.121
2010/7/23,1345,7680,-14,27,23,4,0.991,1.026
2010/7/26,945,7702,-13,26,20,6,0.99,1.056
2010/7/26,1045,7704,3,38,24,14,0.992,0.906
2010/7/26,1145,7701,-4,24,5,19,0.994,1.177
2010/7/26,1245,7709,8,21,5,16,0.995,2.042
2010/7/26,1345,7709,-1,14,2,12,0.997,1.61
2010/7/27,945,7676,-54,64,54,10,1.002,0.641
2010/7/27,1045,7677,0,31,18,13,1.002,0.907
2010/7/27,1145,7672,-6,19,9,10,1.003,1.199
2010/7/27,1245,7652,-20,33,23,10,1.006,0.872
2010/7/27,1345,7657,5,16,11,5,1.004,0.905
2010/7/28,945,7668,-11,45,12,33,1.002,0.786
2010/7/28,1045,7679,11,25,-1,26,1.001,1.166
2010/7/28,1145,7692,14,22,8,14,0.999,0.831
2010/7/28,1245,7714,22,39,8,31,0.996,1.01
2010/7/28,1345,7723,9,29,9,20,0.994,1.067
2010/7/29,945,7718,-2,21,6,15,0.995,1.225
2010/7/29,1045,7692,-26,37,29,8,0.999,0.793
2010/7/29,1145,7691,-1,34,11,23,0.999,1.029
2010/7/29,1245,7723,29,40,7,33,0.995,0.946
2010/7/29,1345,7707,-16,25,24,1,0.998,1.031
2010/7/30,945,7647,-38,35,33,2,1.006,0.691
2010/7/30,1045,7695,48,61,4,57,1,0.713
2010/7/30,1145,7676,-19,25,20,5,1.002,1.417
2010/7/30,1245,7671,-5,20,15,5,1.003,1.886
2010/7/30,1345,7682,11,14,-2,16,1.001,1.351
2010/8/2,945,7830,82,78,5,73,0.982,0.575
2010/8/2,1045,7833,3,19,6,13,0.983,1.376
2010/8/2,1145,7870,36,41,6,35,0.98,1.121
2010/8/2,1245,7857,-12,15,12,3,0.984,1.862
2010/8/2,1345,7870,13,23,8,15,0.984,0.939
2010/8/3,945,7892,-19,20,19,1,0.985,0.978
2010/8/3,1045,7875,-17,19,22,-3,0.99,1.232
2010/8/3,1145,7891,16,24,1,23,0.99,1.515
2010/8/3,1245,7887,-4,14,8,6,0.993,2.213
2010/8/3,1345,7914,27,31,1,30,0.993,1.183
2010/8/4,945,7908,22,33,3,30,0.995,0.911
2010/8/4,1045,7916,9,41,12,29,0.995,0.681
2010/8/4,1145,7886,-30,46,35,11,1,0.694
2010/8/4,1245,7903,17,32,1,31,0.998,1.178
2010/8/4,1345,7911,9,18,9,9,0.998,0.959
2010/8/5,945,7944,-16,27,16,11,0.994,0.848
2010/8/5,1045,7939,-4,32,9,23,0.995,0.753
2010/8/5,1145,7926,-13,22,16,6,0.998,1.343
2010/8/5,1245,7879,-48,50,47,3,1.004,0.637
2010/8/5,1345,7913,35,32,0,32,1,0.879
2010/8/6,945,7905,15,28,6,22,1.001,1.208
2010/8/6,1045,7887,-18,28,26,2,1.003,1.096
2010/8/6,1145,7927,40,48,3,45,0.998,0.984
2010/8/6,1245,7927,0,17,4,13,0.998,1.743
2010/8/6,1345,7929,4,14,3,11,0.998,1.484
2010/8/9,945,7986,75,69,-2,71,0.99,0.766
2010/8/9,1045,7987,1,22,7,15,0.991,1.067
2010/8/9,1145,7982,-5,24,13,11,0.992,1.381
2010/8/9,1245,7987,4,17,10,7,0.992,1.595
2010/8/9,1345,7987,0,17,14,3,0.993,0.853
2010/8/10,945,7976,-22,32,22,10,0.996,0.869
2010/8/10,1045,7985,9,17,0,17,0.996,1.26
2010/8/10,1145,7943,-41,47,42,5,1.002,0.644
2010/8/10,1245,7949,5,18,4,14,1.002,1.465
2010/8/10,1345,7936,-13,19,16,3,1.004,1.086
2010/8/11,945,7917,31,49,13,36,1.006,0.746
2010/8/11,1045,7903,-14,78,27,51,1.007,0.426
2010/8/11,1145,7902,-1,33,9,24,1.006,1.094
2010/8/11,1245,7849,-53,70,59,11,1.012,0.83
2010/8/11,1345,7856,8,31,8,23,1.009,0.861
2010/8/12,945,7770,-8,44,42,2,1.017,0.862
2010/8/12,1045,7813,44,50,11,39,1.009,0.916
2010/8/12,1145,7793,-21,34,22,12,1.01,1.369
2010/8/12,1245,7805,12,25,3,22,1.006,1.9
2010/8/12,1345,7800,-5,22,16,6,1.005,1.403
2010/8/13,945,7827,11,27,3,24,1,1.298
2010/8/13,1045,7832,5,31,6,25,0.999,1.231
2010/8/13,1145,7844,12,24,-6,30,0.996,1.557
2010/8/13,1245,7905,61,56,7,49,0.988,0.607
2010/8/13,1345,7911,7,32,14,18,0.988,0.737
2010/8/16,945,7855,12,29,13,16,0.996,1.051
2010/8/16,1045,7887,32,39,5,34,0.993,1.015
2010/8/16,1145,7903,16,40,10,30,0.992,1.104
2010/8/16,1245,7944,39,62,13,49,0.988,0.912
2010/8/16,1345,7946,2,22,9,13,0.989,1.132
2010/8/17,945,7939,4,29,25,4,0.992,1.017
2010/8/17,1045,7948,9,33,10,23,0.992,1.23
2010/8/17,1145,7956,9,20,9,11,0.992,1.782
2010/8/17,1245,7943,-14,24,17,7,0.996,1.905
2010/8/17,1345,7941,-3,27,19,8,0.996,1.321
2010/8/18,945,7958,-11,17,7,10,0.996,1.193
2010/8/18,1045,7954,-4,22,13,9,0.998,1.415
2010/8/18,1145,7909,-45,47,48,-1,1.004,0.911
2010/8/18,1245,7933,23,38,5,33,1.001,1.266
2010/8/19,945,7896,-3,105,66,39,1.005,0.426
2010/8/19,1045,7871,-25,49,25,24,1.008,0.623
2010/8/19,1145,7894,23,41,14,27,1.004,0.842
2010/8/19,1245,7908,14,26,14,12,1.002,0.951
2010/8/19,1345,7918,10,18,1,17,1,1.273
2010/8/20,945,7883,0,26,17,9,1.003,1.009
2010/8/20,1045,7870,-13,28,23,5,1.004,1.042
2010/8/20,1145,7883,13,24,1,23,1.001,1.454
2010/8/20,1245,7874,-9,24,13,11,1.001,1.806
2010/8/20,1345,7886,11,22,7,15,1,1.345
2010/8/23,945,7942,62,64,-4,68,0.992,0.794
2010/8/23,1045,7999,57,51,4,47,0.986,0.585
2010/8/23,1145,7976,-23,26,21,5,0.99,1.117
2010/8/23,1245,7986,11,22,4,18,0.99,1.645
2010/8/23,1345,7952,-35,41,34,7,0.995,0.812
2010/8/24,945,7910,-10,31,29,2,1.001,0.883
2010/8/24,1045,7942,32,54,5,49,0.997,0.701
2010/8/24,1145,7943,1,20,13,7,0.998,1.147
2010/8/24,1245,7912,-31,47,40,7,1.003,1.102
2010/8/24,1345,7887,-25,33,32,1,1.006,0.947
2010/8/25,945,7786,-57,59,53,6,1.019,0.57
2010/8/25,1045,7718,-68,89,86,3,1.026,0.563
2010/8/25,1145,7734,16,45,14,31,1.02,1.002
2010/8/25,1245,7711,-21,42,22,20,1.02,0.96
2010/8/25,1345,7679,-32,60,54,6,1.021,0.84
2010/8/26,945,7682,10,34,13,21,1.017,1.214
2010/8/26,1045,7654,-28,43,28,15,1.018,0.999
2010/8/26,1145,7688,36,52,0,52,1.01,1.135
2010/8/26,1245,7663,-23,35,32,3,1.009,1.975
2010/8/26,1345,7621,-42,46,46,0,1.012,1.377
2010/8/27,945,7616,5,55,55,0,1.009,0.898
2010/8/27,1045,7631,13,41,16,25,1.005,1.053
2010/8/27,1145,7640,9,31,13,18,1.003,1.424
2010/8/27,1245,7674,34,37,-5,42,0.997,1.415
2010/8/27,1345,7659,-15,20,16,4,0.999,1.092
2010/8/30,945,7737,-5,27,11,16,0.99,0.882
2010/8/30,1045,7790,53,60,-2,62,0.984,0.742
2010/8/30,1145,7756,-34,36,31,5,0.99,1.256
2010/8/30,1245,7705,-51,67,50,17,0.997,0.611
2010/8/30,1345,7718,12,20,0,20,0.996,1.175
2010/8/31,945,7601,-52,68,52,16,1.012,0.599
2010/8/31,1045,7583,-18,53,29,24,1.014,0.797
2010/8/31,1145,7574,-9,31,29,2,1.015,1.257
2010/8/31,1245,7559,-15,48,25,23,1.016,1.121
2010/8/31,1345,7557,-2,32,13,19,1.014,0.995
2010/9/1,945,7597,28,33,13,20,1.007,1.041
2010/9/1,1045,7615,17,41,12,29,1.003,1.033
2010/9/1,1145,7618,2,23,10,13,1,1.84
2010/9/1,1245,7612,-5,12,6,6,0.999,2.92
2010/9/1,1345,7630,18,24,8,16,0.995,1.26
2010/9/2,945,7714,19,49,30,19,0.985,0.604
2010/9/2,1045,7701,-13,44,24,20,0.988,0.846
2010/9/2,1145,7677,-23,44,33,11,0.993,0.965
2010/9/2,1245,7677,1,21,9,12,0.994,1.766
2010/9/2,1345,7692,14,26,6,20,0.994,1.084
2010/9/3,945,7754,40,49,14,35,0.988,0.696
2010/9/3,1045,7782,28,42,-5,47,0.986,0.868
2010/9/3,1145,7758,-24,21,21,0,0.991,1.255
2010/9/3,1245,7784,26,31,1,30,0.99,1.464
2010/9/3,1345,7777,-5,18,7,11,0.993,1.182
2010/9/6,945,7830,-8,32,21,11,0.988,0.874
2010/9/6,1045,7864,33,39,9,30,0.985,0.768
2010/9/6,1145,7870,6,21,8,13,0.987,1.493
2010/9/6,1245,7867,-3,22,7,15,0.989,2.236
2010/9/6,1345,7865,-1,15,8,7,0.992,1.3
2010/9/7,945,7855,-5,21,9,12,0.995,1.063
2010/9/7,1045,7867,14,22,5,17,0.995,1.12
2010/9/7,1145,7861,-6,22,9,13,0.997,1.282
2010/9/7,1245,7858,-3,19,16,3,0.998,1.48
2010/9/7,1345,7853,-6,18,10,8,1,1.226
2010/9/8,945,7853,30,40,15,25,1,0.624
2010/9/8,1045,7816,-37,52,39,13,1.005,0.501
2010/9/8,1145,7822,6,46,34,12,1.003,0.777
2010/9/8,1245,7816,-6,35,9,26,1.004,0.635
2010/9/8,1345,7848,33,48,2,46,0.999,0.928
2010/9/9,945,7865,-20,28,24,4,0.997,1.012
2010/9/9,1045,7850,-17,42,25,17,0.999,0.794
2010/9/9,1145,7827,-23,36,33,3,1.002,1.138
2010/9/9,1245,7811,-17,27,22,5,1.003,0.999
2010/9/9,1345,7834,24,30,8,22,1,1.029
2010/9/10,945,7882,-7,32,24,8,0.995,1.023
2010/9/10,1045,7861,-21,39,31,8,0.998,1.054
2010/9/10,1145,7866,5,22,5,17,0.998,1.368
2010/9/10,1245,7857,-9,23,19,4,0.999,1.656
2010/9/10,1345,7900,42,41,-3,44,0.994,0.97
2010/9/13,945,7967,24,33,0,33,0.987,0.838
2010/9/13,1045,7988,23,23,8,15,0.985,0.902
2010/9/13,1145,8039,52,53,3,50,0.981,0.792
2010/9/13,1245,8093,54,58,3,55,0.977,0.819
2010/9/13,1345,8109,15,29,1,28,0.978,0.791
2010/9/14,945,8096,-21,29,21,8,0.983,1.181
2010/9/14,1045,8106,10,25,17,8,0.984,1.286
2010/9/14,1145,8112,6,17,5,12,0.987,2.257
2010/9/14,1245,8119,6,9,2,7,0.989,2.71
2010/9/14,1345,8122,3,24,13,11,0.992,1.471
2010/9/15,945,8131,-11,24,8,16,0.993,1.256
2010/9/15,1045,8125,-7,19,12,7,0.996,1.873
2010/9/15,1145,8135,9,22,0,22,0.996,1.742
2010/9/15,1245,8128,-7,16,13,3,0.998,2.143
2010/9/16,945,8134,-11,35,29,6,0.998,0.441
2010/9/16,1045,8124,-11,21,16,5,1,0.735
2010/9/16,1145,8111,-12,19,25,-6,1.002,0.93
2010/9/16,1245,8096,-17,30,14,16,1.003,0.535
2010/9/16,1345,8070,-27,42,34,8,1.007,0.752
2010/9/17,945,8132,32,39,6,33,0.999,0.745
2010/9/17,1045,8139,7,30,13,17,0.998,0.875
2010/9/17,1145,8196,56,68,10,58,0.991,0.614
2010/9/17,1245,8187,-10,28,22,6,0.993,1.236
2010/9/17,1345,8171,-16,50,36,14,0.995,0.831
2010/9/20,945,8146,-9,45,35,10,0.999,1.3
2010/9/20,1045,8166,19,36,18,18,0.996,1.413
2010/9/20,1145,8185,19,48,10,38,0.994,1.049
2010/9/20,1245,8184,-2,19,10,9,0.995,2.064
2010/9/20,1345,8178,-6,21,14,7,0.997,1.529
2010/9/21,945,8205,-32,39,42,-3,0.996,0.845
2010/9/21,1045,8166,-40,46,53,-7,1.001,0.893
2010/9/21,1145,8187,22,43,21,22,0.999,0.924
2010/9/21,1245,8192,5,19,11,8,0.998,1.848
2010/9/21,1345,8192,0,22,9,13,0.998,1.029
2010/9/23,945,8158,-20,47,47,0,1.003,0.906
2010/9/23,1045,8185,27,34,-3,37,1,1.134
2010/9/23,1145,8219,36,42,-1,43,0.996,1.062
2010/9/23,1245,8211,-7,30,22,8,0.997,0.936
2010/9/23,1345,8202,-9,39,21,18,0.998,0.951
2010/9/24,945,8147,-38,65,43,22,1.005,0.587
2010/9/24,1045,8177,31,68,20,48,1,0.646
2010/9/24,1145,8139,-36,66,48,18,1.005,0.72
2010/9/24,1245,8156,17,54,25,29,1.002,0.823
2010/9/24,1345,8147,-10,37,28,9,1.003,1.148
2010/9/27,945,8200,0,35,30,5,0.997,0.909
2010/9/27,1045,8182,-19,38,32,6,0.999,1.2
2010/9/27,1145,8194,11,21,4,17,0.998,1.735
2010/9/27,1245,8192,-1,19,13,6,0.998,2.124
2010/9/27,1345,8185,-8,17,14,3,0.999,1.653
2010/9/28,945,8155,-7,24,19,5,1.002,1.253
2010/9/28,1045,8195,41,41,2,39,0.997,0.885
2010/9/28,1145,8189,-6,20,7,13,0.998,1.504
2010/9/28,1245,8190,1,18,8,10,0.999,1.873
2010/9/28,1345,8180,-10,22,12,10,1,1.028
2010/9/29,945,8215,-5,42,30,12,0.996,0.526
2010/9/29,1045,8213,-1,18,13,5,0.997,1.17
2010/9/29,1145,8234,21,20,-2,22,0.994,1.333
2010/9/29,1245,8275,41,55,20,35,0.99,0.49
2010/9/29,1345,8210,-66,64,66,-2,0.999,0.58
2010/9/30,945,8226,8,24,4,20,0.998,1.087
2010/9/30,1045,8209,-17,41,23,18,1.001,0.895
2010/9/30,1145,8222,13,21,5,16,0.999,1.478
2010/9/30,1245,8198,-24,28,26,2,1.002,1.555
2010/9/30,1345,8219,21,33,0,33,1,1.134
2010/10/1,945,8220,-26,51,32,19,1,0.78
2010/10/1,1045,8223,2,29,17,12,1,1.392
2010/10/1,1145,8216,-7,20,16,4,1.001,2.237
2010/10/1,1245,8215,-1,17,10,7,1.001,1.551
2010/10/1,1345,8238,23,22,-3,25,0.997,0.997
2010/10/4,945,8268,30,55,17,38,0.994,0.593
2010/10/4,1045,8252,-16,52,22,30,0.996,0.718
2010/10/4,1145,8254,3,20,8,12,0.997,1.616
2010/10/4,1245,8248,-3,11,9,2,0.998,2.289
2010/10/4,1345,8217,-31,30,31,-1,1.002,0.74
2010/10/5,945,8149,-58,77,63,14,1.01,0.482
2010/10/5,1045,8148,-1,25,17,8,1.009,1.126
2010/10/5,1145,8164,16,34,21,13,1.006,0.947
2010/10/5,1245,8169,6,37,-5,42,1.005,0.952
2010/10/5,1345,8192,24,35,0,35,1.002,0.984
2010/10/6,945,8257,-11,27,30,-3,0.994,0.797
2010/10/6,1045,8265,8,17,9,8,0.993,1.711
2010/10/6,1145,8276,11,31,17,14,0.992,1.186
2010/10/6,1245,8270,-6,24,12,12,0.993,1.691
2010/10/6,1345,8273,1,13,3,10,0.993,1.753
2010/10/7,945,8267,-4,25,14,11,0.994,1.041
2010/10/7,1045,8276,9,18,6,12,0.995,1.592
2010/10/7,1145,8267,-9,12,9,3,0.997,2.106
2010/10/7,1245,8272,5,10,0,10,0.998,2.713
2010/10/7,1345,8272,0,18,1,17,0.999,1.187
2010/10/8,945,8233,-33,75,67,8,1.004,0.434
2010/10/8,1045,8239,6,23,6,17,1.003,0.87
2010/10/8,1145,8271,33,39,7,32,0.999,0.586
2010/10/8,1245,8265,-5,20,8,12,0.999,1.534
2010/10/8,1345,8214,-52,53,52,1,1.005,0.657
2010/10/11,945,8224,-17,55,22,33,1.004,0.71
2010/10/11,1045,8222,-2,22,11,11,1.004,1.32
2010/10/11,1145,8223,1,26,21,5,1.003,1.269
2010/10/11,1245,8202,-21,37,23,14,1.005,0.93
2010/10/11,1345,8135,-67,79,74,5,1.012,0.604
2010/10/12,945,8143,-7,35,7,28,1.01,0.799
2010/10/12,1045,8118,-25,31,21,10,1.012,1.13
2010/10/12,1145,8104,-15,24,23,1,1.012,1.245
2010/10/12,1245,8046,-58,86,61,25,1.017,0.532
2010/10/12,1345,8056,10,32,6,26,1.013,0.963
2010/10/13,945,8093,3,26,17,9,1.007,1.047
2010/10/13,1045,8077,-16,35,20,15,1.007,1.198
2010/10/13,1145,8045,-32,45,44,1,1.009,1.17
2010/10/13,1245,8070,25,39,13,26,1.004,1.413
2010/10/13,1345,8108,38,35,0,35,0.998,1.123
2010/10/14,945,8196,22,42,11,31,0.987,0.7
2010/10/14,1045,8237,40,55,14,41,0.983,0.8
2010/10/14,1145,8217,-20,33,22,11,0.987,1.263
2010/10/14,1245,8220,4,34,5,29,0.988,1.131
2010/10/14,1345,8229,9,32,6,26,0.989,1.103
2010/10/15,945,8213,1,21,11,10,0.992,1.411
2010/10/15,1045,8229,16,28,4,24,0.992,1.37
2010/10/15,1145,8224,-5,28,22,6,0.994,1.33
2010/10/15,1245,8198,-26,34,26,8,1,0.976
2010/10/15,1345,8190,-8,21,25,-4,1.002,1.3
2010/10/18,945,8113,-76,86,79,7,1.012,0.543
2010/10/18,1045,8090,-23,51,33,18,1.014,0.731
2010/10/18,1145,8073,-17,48,25,23,1.014,0.811
2010/10/18,1245,8068,-4,35,8,27,1.013,1.088
2010/10/18,1345,8033,-33,56,47,9,1.015,0.831
2010/10/19,945,8025,-10,46,16,30,1.014,0.819
2010/10/19,1045,8041,16,33,12,21,1.01,1.325
2010/10/19,1145,8028,-14,26,20,6,1.009,1.872
2010/10/19,1245,8029,1,22,9,13,1.007,2.247
2010/10/19,1345,8020,-9,22,19,3,1.006,1.673
2010/10/20,945,8029,79,80,8,72,1.001,0.863
2010/10/20,1045,8042,12,33,6,27,0.999,1.35
2010/10/20,1145,8102,59,59,0,59,0.991,0.96
2010/10/20,1245,8084,-19,32,24,8,0.993,1.72
2010/10/21,945,8115,35,67,29,38,0.99,0.45
2010/10/21,1045,8106,-7,44,19,25,0.992,0.761
2010/10/21,1145,8086,-21,45,22,23,0.995,0.849
2010/10/21,1245,8102,18,36,10,26,0.994,1.196
2010/10/21,1345,8088,-14,36,36,0,0.997,1.169
2010/10/22,945,8106,-16,28,26,2,0.995,1.147
2010/10/22,1045,8116,9,27,8,19,0.996,1.256
2010/10/22,1145,8116,0,22,12,10,0.997,1.822
2010/10/22,1245,8116,-1,11,3,8,0.998,2.831
2010/10/22,1345,8142,26,27,-2,29,0.995,1.235
2010/10/25,945,8242,69,84,0,84,0.984,0.555
2010/10/25,1045,8249,7,34,13,21,0.985,0.87
2010/10/25,1145,8280,29,42,12,30,0.983,0.953
2010/10/25,1245,8285,5,27,12,15,0.985,1.236
2010/10/25,1345,8303,18,21,3,18,0.985,0.754
2010/10/26,945,8312,13,30,15,15,0.986,0.823
2010/10/26,1045,8304,-9,20,17,3,0.989,1.706
2010/10/26,1145,8305,2,11,8,3,0.991,2.432
2010/10/26,1245,8335,31,35,3,32,0.99,1.076
2010/10/26,1345,8313,-22,28,27,1,0.995,1.172
2010/10/27,945,8311,-18,104,57,47,0.997,0.447
2010/10/27,1045,8315,5,41,30,11,0.998,0.87
2010/10/27,1145,8287,-28,47,40,7,1.002,0.933
2010/10/27,1245,8280,-7,30,18,12,1.003,1.123
2010/10/27,1345,8281,1,26,13,13,1.003,1.177
2010/10/28,945,8299,-11,36,24,12,1.001,0.994
2010/10/28,1045,8295,-4,23,10,13,1.001,1.549
2010/10/28,1145,8327,32,48,18,30,0.997,0.872
2010/10/28,1245,8322,-6,20,10,10,0.998,2.021
2010/10/28,1345,8341,20,39,14,25,0.995,0.728
2010/10/29,945,8292,-28,37,35,2,1.001,0.814
2010/10/29,1045,8290,-2,25,26,-1,1.001,1.147
2010/10/29,1145,8303,12,51,5,46,0.999,0.671
2010/10/29,1245,8295,-8,22,12,10,1.001,1.804
2010/10/29,1345,8302,7,33,5,28,1,1.073
2010/11/1,945,8382,57,69,14,55,0.991,0.645
2010/11/1,1045,8414,34,49,15,34,0.988,0.694
2010/11/1,1145,8413,-1,21,14,7,0.989,1.838
2010/11/1,1245,8403,-11,25,23,2,0.991,1.945
2010/11/1,1345,8393,-10,24,14,10,0.994,0.946
2010/11/2,945,8378,-27,26,23,3,0.996,1.353
2010/11/2,1045,8378,0,18,8,10,0.997,1.908
2010/11/2,1145,8387,9,24,9,15,0.997,1.471
2010/11/2,1245,8384,-3,16,7,9,0.999,2.334
2010/11/2,1345,8367,-17,26,20,6,1.002,1.091
2010/11/3,945,8351,-60,72,69,3,1.005,0.538
2010/11/3,1045,8362,11,71,16,55,1.003,0.41
2010/11/3,1145,8372,10,24,6,18,1.001,1.227
2010/11/3,1245,8342,-28,36,30,6,1.004,1.225
2010/11/3,1345,8324,-19,57,16,41,1.006,0.599
2010/11/4,945,8375,33,45,-5,50,0.999,0.887
2010/11/4,1045,8358,-17,34,30,4,1.001,1.034
2010/11/4,1145,8368,10,18,12,6,1,2.384
2010/11/4,1245,8377,9,15,3,12,0.998,2.799
2010/11/4,1345,8368,-9,19,11,8,0.999,1.53
2010/11/5,945,8452,-26,45,36,9,0.99,0.739
2010/11/5,1045,8454,1,19,8,11,0.991,1.415
2010/11/5,1145,8454,-1,18,11,7,0.992,1.789
2010/11/5,1245,8459,4,10,4,6,0.993,3.326
2010/11/5,1345,8463,3,25,21,4,0.993,0.702
2010/11/8,945,8450,-32,35,30,5,0.997,0.838
2010/11/8,1045,8436,-15,27,26,1,0.999,0.859
2010/11/8,1145,8459,23,39,11,28,0.997,0.979
2010/11/8,1245,8455,-4,12,9,3,0.999,2.494
2010/11/8,1345,8453,-1,28,8,20,1,0.905
2010/11/9,945,8447,7,38,24,14,1,0.675
2010/11/9,1045,8446,-2,16,9,7,1,1.186
2010/11/9,1145,8459,12,22,8,14,0.999,1.462
2010/11/9,1245,8460,3,12,8,4,0.999,2.25
2010/11/9,1345,8467,6,15,0,15,0.998,1.282
2010/11/10,945,8466,-22,29,19,10,0.998,0.697
2010/11/10,1045,8466,0,23,19,4,0.998,0.899
2010/11/10,1145,8469,2,14,5,9,0.998,1.463
2010/11/10,1245,8448,-22,36,23,13,1.001,0.767
2010/11/10,1345,8485,37,38,-2,40,0.996,0.72
2010/11/11,945,8466,1,28,12,16,0.999,0.707
2010/11/11,1045,8471,5,18,9,9,0.999,1.253
2010/11/11,1145,8471,0,9,4,5,0.999,2.448
2010/11/11,1245,8467,-4,15,6,9,1,1.368
2010/11/11,1345,8451,-15,24,19,5,1.001,1.026
2010/11/12,945,8371,-64,72,59,13,1.01,0.385
2010/11/12,1045,8370,-1,36,4,32,1.009,0.588
2010/11/12,1145,8344,-26,47,28,19,1.011,0.822
2010/11/12,1245,8328,-15,26,20,6,1.012,1.386
2010/11/12,1345,8314,-13,42,29,13,1.012,0.738
2010/11/15,945,8294,-2,47,14,33,1.012,0.719
2010/11/15,1045,8265,-29,57,32,25,1.014,0.854
2010/11/15,1145,8254,-9,32,30,2,1.013,1.613
2010/11/15,1245,8245,-9,32,16,16,1.011,1.41
2010/11/15,1345,8270,25,40,0,40,1.006,1.244
2010/11/16,945,8265,35,57,12,45,1.004,0.837
2010/11/16,1045,8272,7,24,6,18,1.002,1.482
2010/11/16,1145,8270,-2,17,12,5,1.001,2.192
2010/11/16,1245,8335,66,73,7,66,0.992,0.72
2010/11/16,1345,8290,-45,45,47,-2,0.997,0.895
2010/11/17,945,8268,22,28,5,23,0.999,1.265
2010/11/17,1045,8248,-21,43,22,21,1.002,1.291
2010/11/17,1145,8257,9,19,9,10,1,2.642
2010/11/17,1245,8279,23,43,20,23,0.998,1.394
2010/11/18,945,8263,8,43,19,24,1,0.517
2010/11/18,1045,8247,-15,28,20,8,1.002,1.02
2010/11/18,1145,8267,20,27,3,24,0.999,1.177
2010/11/18,1245,8284,17,26,4,22,0.997,1.262
2010/11/18,1345,8292,8,20,1,19,0.996,1.14
2010/11/19,945,8348,10,46,13,33,0.99,0.57
2010/11/19,1045,8354,6,20,4,16,0.99,1.122
2010/11/19,1145,8312,-42,50,44,6,0.996,0.738
2010/11/19,1245,8275,-37,66,48,18,1.002,0.783
2010/11/19,1345,8286,13,39,16,23,1,0.892
2010/11/22,945,8328,5,33,17,16,0.996,1.056
2010/11/22,1045,8339,10,21,10,11,0.996,1.491
2010/11/22,1145,8383,44,53,5,48,0.992,0.881
2010/11/22,1245,8375,-8,30,21,9,0.994,1.189
2010/11/22,1345,8373,-2,24,12,12,0.995,1.101
2010/11/23,945,8353,-21,27,22,5,0.998,1.152
2010/11/23,1045,8350,-3,15,10,5,0.998,1.795
2010/11/23,1145,8339,-11,25,16,9,1,1.215
2010/11/23,1245,8328,-11,19,11,8,1.001,1.307
2010/11/23,1345,8330,2,29,5,24,1.002,0.884
2010/11/24,945,8332,51,62,8,54,1.001,0.613
2010/11/24,1045,8330,-2,31,23,8,1.001,0.74
2010/11/24,1145,8324,-6,22,12,10,1.002,1.355
2010/11/24,1245,8329,5,21,6,15,1.001,2.045
2010/11/24,1345,8305,-24,33,30,3,1.003,0.884
2010/11/25,945,8323,14,23,15,8,1,0.979
2010/11/25,1045,8326,3,16,8,8,0.999,1.987
2010/11/25,1145,8346,20,32,4,28,0.997,1.369
2010/11/25,1245,8350,2,14,10,4,0.996,1.327
2010/11/25,1345,8341,-9,28,21,7,0.998,0.906
2010/11/26,945,8331,-23,32,27,5,1,0.948
2010/11/26,1045,8329,-2,22,3,19,1,0.959
2010/11/26,1145,8348,18,21,3,18,0.998,0.975
2010/11/26,1245,8322,-25,31,30,1,1.001,1.251
2010/11/26,1345,8300,-23,35,29,6,1.004,0.601
2010/11/29,945,8321,-29,83,74,9,1.002,0.375
2010/11/29,1045,8366,44,47,6,41,0.996,0.874
2010/11/29,1145,8384,19,20,1,19,0.994,1.082
2010/11/29,1245,8367,-17,28,25,3,0.997,1.583
2010/11/29,1345,8382,15,31,2,29,0.995,0.898
2010/11/30,945,8402,2,35,6,29,0.994,0.911
2010/11/30,1045,8440,38,53,10,43,0.99,0.793
2010/11/30,1145,8408,-31,33,27,6,0.995,0.989
2010/11/30,1245,8396,-12,34,16,18,0.997,1.198
2010/11/30,1345,8401,5,41,11,30,0.997,0.999
2010/12/1,945,8470,47,62,5,57,0.99,0.644
2010/12/1,1045,8469,-1,28,11,17,0.992,1.33
2010/12/1,1145,8469,0,18,9,9,0.993,1.945
2010/12/1,1245,8497,28,33,7,26,0.991,1.194
2010/12/1,1345,8550,53,58,-1,59,0.986,0.842
2010/12/2,945,8621,21,42,21,21,0.981,0.75
2010/12/2,1045,8608,-13,36,19,17,0.985,1.118
2010/12/2,1145,8613,4,23,5,18,0.986,2.128
2010/12/2,1245,8610,-3,18,5,13,0.989,2.27
2010/12/2,1345,8619,10,26,2,24,0.99,1.204
2010/12/3,945,8618,-21,22,13,9,0.993,0.848
2010/12/3,1045,8633,15,28,12,16,0.993,1.067
2010/12/3,1145,8632,-1,20,5,15,0.995,1.468
2010/12/3,1245,8626,-6,12,7,5,0.997,2.691
2010/12/3,1345,8630,4,12,5,7,0.998,1.273
2010/12/6,945,8685,45,63,10,53,0.992,0.57
2010/12/6,1045,8701,16,29,3,26,0.991,0.898
2010/12/6,1145,8696,-5,19,6,13,0.993,1.416
2010/12/6,1245,8696,2,13,3,10,0.994,2.187
2010/12/6,1345,8697,0,29,17,12,0.995,0.767
2010/12/7,945,8661,-37,26,32,-6,1,0.885
2010/12/7,1045,8670,8,23,5,18,0.999,0.879
2010/12/7,1145,8686,17,28,8,20,0.998,1.201
2010/12/7,1245,8690,4,13,3,10,0.998,2.242
2010/12/7,1345,8716,26,30,-1,31,0.996,0.928
2010/12/8,945,8686,-32,40,29,11,1,0.647
2010/12/8,1045,8693,7,19,4,15,0.999,1.211
2010/12/8,1145,8694,0,17,10,7,0.999,1.349
2010/12/8,1245,8694,0,19,8,11,0.999,2.026
2010/12/8,1345,8701,7,17,3,14,0.998,1.29
2010/12/9,945,8769,47,46,14,32,0.991,0.513
2010/12/9,1045,8771,1,35,26,9,0.992,0.597
2010/12/9,1145,8771,0,32,7,25,0.993,0.849
2010/12/9,1245,8785,13,21,1,20,0.992,1.851
2010/12/9,1345,8789,4,17,1,16,0.993,0.924
2010/12/10,945,8715,-46,48,38,10,1.002,0.561
2010/12/10,1045,8720,5,25,20,5,1.002,0.86
2010/12/10,1145,8725,5,30,13,17,1.001,1.457
2010/12/10,1245,8722,-5,29,5,24,1.002,1.166
2010/12/10,1345,8742,20,33,3,30,1,1.121
2010/12/13,945,8746,18,35,14,21,1,1.063
2010/12/13,1045,8754,8,13,2,11,0.998,1.639
2010/12/13,1145,8755,1,13,4,9,0.998,2.062
2010/12/13,1245,8754,-2,13,10,3,0.998,2.05
2010/12/13,1345,8737,-17,19,20,-1,1,1.162
2010/12/14,945,8775,23,44,13,31,0.995,0.722
2010/12/14,1045,8718,-58,77,74,3,1.002,0.443
2010/12/14,1145,8742,23,22,0,22,1,1.415
2010/12/14,1245,8725,-17,34,24,10,1.002,1.142
2010/12/14,1345,8738,12,22,8,14,1,0.907
2010/12/15,945,8736,-4,26,6,20,1.001,1.173
2010/12/15,1045,8721,-16,32,17,15,1.002,1.294
2010/12/15,1145,8728,8,12,0,12,1.001,2.785
2010/12/15,1245,8731,3,18,7,11,1,2.763
2010/12/16,945,8779,15,78,3,75,0.995,0.494
2010/12/16,1045,8768,-12,28,26,2,0.997,0.881
2010/12/16,1145,8773,5,22,9,13,0.996,1.135
2010/12/16,1245,8773,0,12,7,5,0.997,2.136
2010/12/16,1345,8773,1,19,11,8,0.997,1.003
2010/12/17,945,8819,42,48,11,37,0.992,0.493
2010/12/17,1045,8822,3,22,13,9,0.993,0.91
2010/12/17,1145,8826,3,17,14,3,0.993,1.187
2010/12/17,1245,8829,3,14,6,8,0.994,2.14
2010/12/17,1345,8809,-19,29,26,3,0.998,0.836
2010/12/20,945,8790,-27,46,42,4,1,0.717
2010/12/20,1045,8806,15,20,5,15,0.999,1.381
2010/12/20,1145,8736,-70,79,71,8,1.007,0.515
2010/12/20,1245,8761,25,32,3,29,1.004,1.1
2010/12/20,1345,8762,1,24,14,10,1.004,0.927
2010/12/21,945,8769,-14,28,23,5,1.003,1.021
2010/12/21,1045,8788,19,34,9,25,1,0.988
2010/12/21,1145,8801,14,20,1,19,0.998,1.913
2010/12/21,1245,8818,17,33,7,26,0.996,1.258
2010/12/21,1345,8846,29,33,0,33,0.993,0.988
2010/12/22,945,8839,-19,18,17,1,0.994,0.951
2010/12/22,1045,8846,7,11,7,4,0.994,2.308
2010/12/22,1145,8863,17,31,2,29,0.992,1.14
2010/12/22,1245,8869,6,16,2,14,0.993,1.434
2010/12/22,1345,8850,-19,24,22,2,0.996,0.91
2010/12/23,945,8875,19,30,4,26,0.994,0.829
2010/12/23,1045,8896,21,38,11,27,0.993,0.679
2010/12/23,1145,8899,3,14,3,11,0.994,1.773
2010/12/23,1245,8889,-11,17,19,-2,0.996,1.337
2010/12/23,1345,8898,9,19,4,15,0.996,0.898
2010/12/24,945,8883,-15,23,13,10,0.998,0.88
2010/12/24,1045,8877,-5,20,11,9,1,1.18
2010/12/24,1145,8884,8,16,4,12,0.999,1.709
2010/12/24,1245,8879,-5,10,7,3,1,2.663
2010/12/24,1345,8880,1,13,0,13,1,1.115
2010/12/27,945,8843,-23,40,29,11,1.004,0.568
2010/12/27,1045,8869,26,41,5,36,1.001,0.727
2010/12/27,1145,8877,8,20,6,14,1,1.195
2010/12/27,1245,8910,32,42,8,34,0.996,0.732
2010/12/27,1345,8884,-26,31,31,0,0.999,0.792
2010/12/28,945,8884,-16,38,22,16,0.999,0.745
2010/12/28,1045,8876,-8,23,9,14,1,1.021
2010/12/28,1145,8874,-2,16,7,9,1,1.697
2010/12/28,1245,8849,-25,47,28,19,1.003,0.695
2010/12/28,1345,8878,30,40,4,36,0.999,0.79
2010/12/29,945,8889,29,48,6,42,0.998,0.797
2010/12/29,1045,8861,-28,46,27,19,1.002,0.743
2010/12/29,1145,8878,18,27,4,23,0.999,1.309
2010/12/29,1245,8869,-9,25,15,10,1.001,1.389
2010/12/29,1345,8872,3,21,7,14,1,1.385
2010/12/30,945,8903,24,53,15,38,0.996,0.654
2010/12/30,1045,8886,-16,23,3,20,0.998,0.934
2010/12/30,1145,8881,-6,21,16,5,0.999,1.721
2010/12/30,1245,8889,7,14,3,11,0.998,3.124
2010/12/30,1345,8906,17,34,4,30,0.997,0.778
2010/12/31,945,8927,35,33,5,28,0.995,0.847
2010/12/31,1045,8968,40,51,3,48,0.99,0.711
2010/12/31,1145,8990,22,22,2,20,0.989,1.051
2010/12/31,1245,8989,-2,23,6,17,0.991,1.391
2010/12/31,1345,8988,0,17,9,8,0.992,0.969
2011/1/3,945,9005,5,27,24,3,0.991,0.819
2011/1/3,1045,9011,7,17,3,14,0.992,1.748
2011/1/3,1145,9026,16,17,2,15,0.992,1.294
2011/1/3,1245,9016,-10,10,8,2,0.994,2.088
2011/1/3,1345,9020,3,15,4,11,0.995,1.306
2011/1/4,945,9012,-18,23,17,6,0.998,0.834
2011/1/4,1045,9017,5,15,4,11,0.998,1.411
2011/1/4,1145,9025,7,13,3,10,0.998,1.834
2011/1/4,1245,9019,-6,8,7,1,0.999,3.11
2011/1/4,1345,8978,-41,43,41,2,1.004,0.486
2011/1/5,945,8972,5,52,33,19,1.004,0.45
2011/1/5,1045,8880,-90,76,98,-22,1.014,0.432
2011/1/5,1145,8850,-30,63,25,38,1.016,0.455
2011/1/5,1245,8825,-24,42,38,4,1.017,0.982
2011/1/5,1345,8838,13,63,16,47,1.013,0.621
2011/1/6,945,8847,-12,41,9,32,1.01,0.916
2011/1/6,1045,8826,-20,31,26,5,1.011,1.789
2011/1/6,1145,8849,23,36,14,22,1.006,1.69
2011/1/6,1245,8832,-17,31,24,7,1.006,2.081
2011/1/6,1345,8869,37,45,7,38,1,1.414
2011/1/7,945,8860,-6,32,23,9,1,1.222
2011/1/7,1045,8836,-22,39,30,9,1.001,1.151
2011/1/7,1145,8762,-74,110,81,29,1.009,0.484
2011/1/7,1245,8743,-18,44,31,13,1.01,1.114
2011/1/7,1345,8753,8,42,16,26,1.008,0.787
2011/1/10,945,8756,3,34,21,13,1.006,1.14
2011/1/10,1045,8756,1,39,18,21,1.005,1.359
2011/1/10,1145,8751,-5,13,11,2,1.005,2.815
2011/1/10,1245,8772,21,21,0,21,1.002,2.037
2011/1/10,1345,8786,13,32,13,19,0.999,1.213
2011/1/11,945,8846,67,100,14,86,0.992,0.597
2011/1/11,1045,8907,61,65,5,60,0.985,0.731
2011/1/11,1145,8917,10,24,9,15,0.984,1.104
2011/1/11,1245,8925,7,34,25,9,0.985,0.849
2011/1/11,1345,8942,18,34,3,31,0.985,0.87
2011/1/12,945,8972,12,49,31,18,0.984,0.7
2011/1/12,1045,8977,4,27,10,17,0.986,1.627
2011/1/12,1145,8979,2,16,10,6,0.989,2.638
2011/1/12,1245,8955,-25,37,27,10,0.994,1.236
2011/1/12,1345,8967,12,28,12,16,0.994,1.473
2011/1/13,945,8992,-6,37,25,12,0.994,0.901
2011/1/13,1045,8974,-18,32,26,6,0.998,1.04
2011/1/13,1145,8981,7,77,12,65,0.998,0.532
2011/1/13,1245,8963,-18,39,19,20,1,1.361
2011/1/13,1345,8969,6,25,10,15,1,1.344
2011/1/14,945,8957,-8,38,24,14,1.002,0.972
2011/1/14,1045,8963,6,29,4,25,1.001,1.288
2011/1/14,1145,8957,-7,37,11,26,1.001,1.161
2011/1/14,1245,8964,10,25,8,17,1,2.425
2011/1/14,1345,8970,5,15,2,13,1,1.601
2011/1/17,945,8955,-38,55,46,9,1.001,0.802
2011/1/17,1045,8926,-28,49,44,5,1.004,0.662
2011/1/17,1145,8927,1,31,18,13,1.003,0.967
2011/1/17,1245,8935,9,22,11,11,1.002,1.788
2011/1/17,1345,8922,-13,31,24,7,1.003,0.907
2011/1/18,945,8932,12,55,-4,59,1.001,0.663
2011/1/18,1045,8964,32,49,18,31,0.998,0.681
2011/1/18,1145,8970,5,12,9,3,0.997,1.565
2011/1/18,1245,9005,34,34,-4,38,0.993,1.364
2011/1/18,1345,8972,-33,34,37,-3,0.997,0.813
2011/1/19,945,9010,22,28,7,21,0.993,1.238
2011/1/19,1045,9048,38,38,-2,40,0.99,1.152
2011/1/19,1145,9026,-21,45,27,18,0.993,1.418
2011/1/19,1245,9043,17,20,6,14,0.993,3.012
2011/1/20,945,9004,-14,85,81,4,0.998,0.501
2011/1/20,1045,9004,1,21,13,8,0.999,1.399
2011/1/20,1145,9009,5,22,10,12,0.999,1.507
2011/1/20,1245,9005,-5,12,9,3,1,3.344
2011/1/20,1345,9009,4,22,13,9,1,1.073
2011/1/21,945,8919,-51,111,50,61,1.009,0.349
2011/1/21,1045,8936,19,35,-11,46,1.007,0.907
2011/1/21,1145,8966,31,47,9,38,1.003,0.679
2011/1/21,1245,8944,-22,45,23,22,1.004,1.069
2011/1/21,1345,8907,-37,47,45,2,1.007,1.018
2011/1/24,945,8936,13,43,20,23,1.003,0.88
2011/1/24,1045,8938,3,30,9,21,1.002,1.431
2011/1/24,1145,8920,-17,33,23,10,1.003,1.534
2011/1/24,1245,8914,-6,11,13,-2,1.003,3.346
2011/1/24,1345,8947,31,35,0,35,0.998,1.42
2011/1/25,945,8998,4,52,31,21,0.993,0.549
2011/1/25,1045,9002,3,19,8,11,0.993,1.746
2011/1/25,1145,9005,3,24,7,17,0.994,1.974
2011/1/25,1245,9004,-1,10,4,6,0.994,2.812
2011/1/25,1345,8966,-37,42,42,0,0.999,0.744
2011/1/26,945,8999,29,30,11,19,0.996,0.795
2011/1/26,1045,9015,15,31,13,18,0.995,0.822
2011/1/26,1145,9023,7,20,2,18,0.995,1.596
2011/1/26,1245,9072,49,51,-1,52,0.991,0.637
2011/1/26,1345,9052,-21,29,18,11,0.995,0.795
2011/1/27,945,9097,11,33,4,29,0.991,0.667
2011/1/27,1045,9096,-1,31,9,22,0.992,1.124
2011/1/27,1145,9102,5,20,10,10,0.992,1.463
2011/1/27,1245,9122,19,35,4,31,0.991,1.555
2011/1/27,1345,9105,-17,35,19,16,0.994,0.892
2011/1/28,945,9107,-5,27,22,5,0.996,0.951
2011/1/28,1045,9112,5,23,5,18,0.996,1.573
2011/1/28,1145,9113,1,14,6,8,0.997,2.697
2011/1/28,1245,9134,21,27,4,23,0.996,1.107
2011/1/28,1345,9138,4,14,2,12,0.996,1.004
2011/1/28,845,9181,9181,-99999,-9181,-90818,0.893,#DIV/0!
2011/2/8,945,9103,-83,78,93,-15,0.901,0.441
2011/2/8,1045,9118,15,76,20,56,0.9,0.576
2011/2/8,1145,9137,19,47,8,39,0.898,1.359
2011/2/8,1245,9114,-23,26,22,4,0.901,1.68
2011/2/8,1345,9099,-15,33,14,19,0.902,0.836
2011/2/9,945,9067,-4,56,35,21,0.905,0.647
2011/2/9,1045,9080,12,46,29,17,0.903,0.752
2011/2/9,1145,9060,-20,56,27,29,0.905,0.632
2011/2/9,1245,9012,-50,93,56,37,0.909,0.623
2011/2/9,1345,9016,6,39,7,32,1.008,0.947
2011/2/10,945,8939,-32,41,44,-3,1.015,0.831
2011/2/10,1045,8892,-46,85,52,33,1.018,0.543
2011/2/10,1145,8903,13,44,13,31,1.014,1.305
2011/2/10,1245,8902,-2,36,24,12,1.012,1.73
2011/2/10,1345,8824,-78,83,76,7,1.018,0.759
2011/2/11,945,8728,-90,110,95,15,1.027,0.611
2011/2/11,1045,8784,56,65,15,50,1.016,1.044
2011/2/11,1145,8759,-25,50,45,5,1.016,1.71
2011/2/11,1245,8672,-87,106,80,26,1.022,0.713
2011/2/11,1345,8563,-109,149,109,40,1.031,0.551
2011/2/14,945,8636,11,53,18,35,1.019,1.078
2011/2/14,1045,8668,32,42,3,39,1.011,1.655
2011/2/14,1145,8663,-7,27,4,23,1.01,2.528
2011/2/14,1245,8668,2,23,20,3,1.006,2.063
2011/2/14,1345,8641,-27,48,52,-4,1.007,1.542
2011/2/15,945,8607,-18,116,40,76,1.008,0.795
2011/2/15,1045,8713,105,110,7,103,0.995,0.785
2011/2/15,1145,8703,-11,49,30,19,0.995,1.445
2011/2/15,1245,8691,-12,48,29,19,0.996,1.485
2011/2/15,1345,8696,5,36,27,9,0.995,1.236
2011/2/15,845,8714,8714,-99999,-8714,-91285,0.894,#DIV/0!
2011/2/16,945,8734,16,48,10,38,0.893,1.135
2011/2/16,1045,8724,-9,40,11,29,0.895,1.723
2011/2/16,1145,8750,26,37,7,30,0.893,1.806
2011/2/16,1245,8749,-2,19,1,18,0.894,2.296
2011/2/17,945,8636,-15,123,110,13,0.906,0.403
2011/2/17,1045,8642,6,73,20,53,0.906,0.563
2011/2/17,1145,8652,9,31,2,29,0.904,1.109
2011/2/17,1245,8634,-16,42,41,1,0.905,0.948
2011/2/17,1345,8629,-6,36,17,19,0.905,0.883
2011/2/18,945,8802,124,116,17,99,0.986,0.482
2011/2/18,1045,8803,1,28,14,14,0.987,1.256
2011/2/18,1145,8809,6,24,8,16,0.987,1.667
2011/2/18,1245,8830,21,40,15,25,0.985,1.203
2011/2/18,1345,8808,-22,32,24,8,0.989,1.153
2011/2/21,945,8771,-43,68,29,39,0.995,0.746
2011/2/21,1045,8779,8,27,14,13,0.995,1.525
2011/2/21,1145,8781,2,34,23,11,0.997,1.512
2011/2/21,1245,8783,2,19,9,10,0.998,2.664
2011/2/21,1345,8809,26,46,3,43,0.997,1.289
2011/2/22,945,8615,-98,108,91,17,1.02,0.402
2011/2/22,1045,8580,-34,52,42,10,1.022,0.816
2011/2/22,1145,8596,16,33,17,16,1.017,1.402
2011/2/22,1245,8586,-8,31,7,24,1.016,1.368
2011/2/22,1345,8616,30,75,43,32,1.009,0.67
2011/2/23,945,8606,18,61,31,30,1.008,0.826
2011/2/23,1045,8588,-17,47,41,6,1.008,1.318
2011/2/23,1145,8578,-10,71,21,50,1.007,0.761
2011/2/23,1245,8524,-54,79,60,19,1.011,1.031
2011/2/23,1345,8522,-2,54,12,42,1.008,0.751
2011/2/24,945,8548,46,62,26,36,1.003,0.878
2011/2/24,1045,8588,40,67,22,45,0.997,0.986
2011/2/24,1145,8585,-3,29,16,13,0.998,1.988
2011/2/24,1245,8525,-61,74,70,4,1.005,1.014
2011/2/24,1345,8531,5,32,13,19,1.003,1.092
2011/2/25,945,8519,-41,142,111,31,1.004,0.542
2011/2/25,1045,8468,-49,115,80,35,1.009,0.741
2011/2/25,1145,8578,107,119,13,106,0.995,0.812
2011/2/25,1245,8578,0,42,20,22,0.995,1.411
2011/2/25,1345,8615,37,49,15,34,0.991,1.036
2011/3/1,945,8663,-32,63,34,29,0.988,1.074
2011/3/1,1045,8661,-1,28,15,13,0.99,2.238
2011/3/1,1145,8679,18,31,9,22,0.988,2.039
2011/3/1,1245,8685,6,19,5,14,0.989,2.903
2011/3/1,1345,8691,5,26,16,10,0.99,1.486
2011/3/2,945,8652,42,69,8,61,0.995,0.792
2011/3/2,1045,8634,-17,48,40,8,0.999,0.77
2011/3/2,1145,8637,3,42,11,31,1,1.024
2011/3/2,1245,8613,-24,36,33,3,1.004,1.494
2011/3/2,1345,8602,-13,38,18,20,1.005,0.711
2011/3/3,945,8667,7,25,8,17,0.997,0.942
2011/3/3,1045,8656,-12,42,16,26,0.999,0.998
2011/3/3,1145,8733,77,88,2,86,0.99,0.783
2011/3/3,1245,8745,13,29,10,19,0.989,1.034
2011/3/3,1345,8748,4,31,4,27,0.99,1.034
2011/3/4,945,8767,-29,39,28,11,0.989,1.051
2011/3/4,1045,8774,7,20,15,5,0.99,1.688
2011/3/4,1145,8786,12,39,10,29,0.99,1.331
2011/3/4,1245,8768,-18,33,23,10,0.994,1.566
2011/3/4,1345,8758,-11,22,17,5,0.997,1.205
2011/3/7,945,8695,-48,69,51,18,1.005,0.644
2011/3/7,1045,8732,37,64,30,34,1.001,0.75
2011/3/7,1145,8711,-21,39,24,15,1.004,1.116
2011/3/7,1245,8701,-8,28,17,11,1.005,1.696
2011/3/7,1345,8723,22,31,6,25,1.002,1.118
2011/3/8,945,8740,36,57,18,39,0.999,0.699
2011/3/8,1045,8745,5,31,9,22,0.998,1.135
2011/3/8,1145,8738,-7,26,18,8,0.999,1.702
2011/3/8,1245,8739,2,14,10,4,0.998,2.625
2011/3/8,1345,8740,1,20,8,12,0.998,1.408
2011/3/9,945,8788,-5,17,9,8,0.993,0.965
2011/3/9,1045,8785,-3,17,7,10,0.994,1.396
2011/3/9,1145,8753,-31,42,34,8,0.998,0.716
2011/3/9,1245,8712,-41,64,50,14,1.004,0.662
2011/3/9,1345,8757,45,43,-1,44,0.999,0.74
2011/3/10,945,8666,-97,89,86,3,1.01,0.475
2011/3/10,1045,8655,-11,38,28,10,1.01,0.741
2011/3/10,1145,8649,-8,35,17,18,1.01,0.957
2011/3/10,1245,8628,-20,38,20,18,1.011,0.988
2011/3/10,1345,8622,-6,37,23,14,1.011,0.849
2011/3/11,945,8496,-54,82,69,13,1.023,0.66
2011/3/11,1045,8502,5,55,48,7,1.019,1.034
2011/3/11,1145,8512,9,49,17,32,1.014,1.362
2011/3/11,1245,8554,42,50,5,45,1.006,1.524
2011/3/11,1345,8562,8,36,12,24,1.004,1.108
2011/3/14,945,8533,2,63,35,28,1.004,0.784
2011/3/14,1045,8410,-124,161,117,44,1.018,0.51
2011/3/14,1145,8445,33,46,21,25,1.01,1.124
2011/3/14,1245,8472,26,62,6,56,1.005,1.319
2011/3/14,1345,8500,27,54,26,28,1,0.996
2011/3/15,945,8452,-79,82,66,16,1.005,0.807
2011/3/15,1045,8306,-146,151,163,-12,1.022,0.585
2011/3/15,1145,8158,-147,275,149,126,1.038,0.462
2011/3/15,1245,8176,18,165,15,150,1.032,0.706
2011/3/15,1345,8257,82,151,20,131,1.017,1.019
2011/3/16,945,8294,-116,126,117,9,1.011,1.326
2011/3/16,1045,8292,-1,59,31,28,1.008,1.802
2011/3/16,1145,8310,19,42,12,30,1.005,2.713
2011/3/16,1245,8332,22,39,12,27,1,2.962
2011/3/17,945,8177,26,199,151,48,1.015,0.811
2011/3/17,1045,8230,53,77,20,57,1.005,1.248
2011/3/17,1145,8230,0,56,12,44,1.002,1.575
2011/3/17,1245,8209,-21,66,51,15,1.004,1.295
2011/3/17,1345,8255,47,65,19,46,0.999,1.207
2011/3/17,845,8292,8292,-99999,-8292,-91707,0.896,#DIV/0!
2011/3/18,945,8314,22,65,21,44,0.892,0.624
2011/3/18,1045,8319,5,38,19,19,0.891,1.225
2011/3/18,1145,8324,5,35,21,14,0.891,1.482
2011/3/18,1245,8329,5,24,11,13,0.891,2.158
2011/3/18,1345,8319,-10,17,21,-4,0.894,1.33
2011/3/21,945,8435,76,117,10,107,0.884,0.516
2011/3/21,1045,8410,-25,25,20,5,0.889,1.233
2011/3/21,1145,8386,-24,47,26,21,0.894,0.944
2011/3/21,1245,8394,7,36,21,15,0.895,1.498
2011/3/21,1345,8390,-4,25,23,2,0.995,1.488
2011/3/22,945,8464,33,52,15,37,0.988,0.668
2011/3/22,1045,8461,-3,29,5,24,0.991,1.161
2011/3/22,1145,8456,-5,26,18,8,0.993,1.492
2011/3/22,1245,8457,2,19,11,8,0.994,2.491
2011/3/22,1345,8415,-43,46,45,1,1.001,0.94
2011/3/23,945,8430,30,50,15,35,0.999,0.695
2011/3/23,1045,8411,-21,31,28,3,1.002,1.351
2011/3/23,1145,8477,66,72,5,67,0.994,0.705
2011/3/23,1245,8465,-11,54,45,9,0.996,0.718
2011/3/23,1345,8448,-17,31,29,2,0.999,0.956
2011/3/24,945,8498,-4,61,50,11,0.994,0.593
2011/3/24,1045,8506,8,38,12,26,0.994,1.182
2011/3/24,1145,8511,5,29,6,23,0.994,1.617
2011/3/24,1245,8515,4,34,20,14,0.994,1.276
2011/3/24,1345,8527,12,19,5,14,0.993,1.661
2011/3/25,945,8558,-30,34,29,5,0.992,0.867
2011/3/25,1045,8574,16,31,5,26,0.991,1.307
2011/3/25,1145,8618,44,60,8,52,0.988,1.028
2011/3/25,1245,8596,-22,29,18,11,0.992,1.251
2011/3/25,1345,8579,-17,38,22,16,0.996,0.935
2011/3/28,945,8543,-42,72,38,34,1.001,0.602
2011/3/28,1045,8557,14,34,12,22,1,1.215
2011/3/28,1145,8531,-25,29,26,3,1.003,1.65
2011/3/28,1245,8522,-9,46,19,27,1.005,0.912
2011/3/28,1345,8520,0,21,18,3,1.005,1.094
2011/3/29,945,8558,51,91,7,84,1,0.588
2011/3/29,1045,8547,-11,17,10,7,1.001,1.703
2011/3/29,1145,8532,-16,41,36,5,1.002,1.028
2011/3/29,1245,8562,30,31,0,31,0.998,1.532
2011/3/29,1345,8575,13,29,0,29,0.996,0.964
2011/3/30,945,8608,1,36,10,26,0.992,0.853
2011/3/30,1045,8626,18,25,6,19,0.991,1.058
2011/3/30,1145,8640,15,26,-2,28,0.99,1.436
2011/3/30,1245,8644,5,14,6,8,0.991,1.338
2011/3/30,1345,8590,-54,64,60,4,0.999,0.657
2011/3/31,945,8613,9,34,29,5,0.997,0.734
2011/3/31,1045,8612,-1,26,11,15,0.998,1.176
2011/3/31,1145,8564,-50,60,57,3,1.004,0.856
2011/3/31,1245,8587,23,25,6,19,1.002,1.215
2011/3/31,1345,8642,56,60,3,57,0.996,0.665
2011/4/1,945,8643,3,36,23,13,0.996,0.986
2011/4/1,1045,8650,6,24,10,14,0.996,1.694
2011/4/1,1145,8661,12,37,9,28,0.995,1.36
2011/4/1,1245,8651,-9,23,16,7,0.996,1.664
2011/4/1,1345,8686,35,36,-1,37,0.992,0.998
2011/4/6,945,8801,58,56,-3,59,0.981,0.606
2011/4/6,1045,8805,2,21,8,13,0.983,1.282
2011/4/6,1145,8834,29,41,8,33,0.981,1.004
2011/4/6,1245,8856,22,28,7,21,0.982,0.98
2011/4/6,1345,8838,-17,40,21,19,0.987,0.657
2011/4/7,945,8850,-14,44,24,20,0.988,0.828
2011/4/7,1045,8838,-13,33,18,15,0.992,1.325
2011/4/7,1145,8870,32,34,1,33,0.991,1.275
2011/4/7,1245,8864,-6,21,9,12,0.994,1.854
2011/4/7,1345,8897,33,44,4,40,0.992,0.991
2011/4/8,945,8882,-57,46,26,20,0.996,0.802
2011/4/8,1045,8910,28,53,22,31,0.994,0.821
2011/4/8,1145,8924,14,18,-3,21,0.994,1.653
2011/4/8,1245,8875,-49,62,57,5,1,0.881
2011/4/8,1345,8866,-7,41,25,16,1.001,0.715
2011/4/11,945,8844,-24,56,32,24,1.004,0.716
2011/4/11,1045,8844,-1,36,16,20,1.004,1.16
2011/4/11,1145,8832,-12,27,23,4,1.005,1.725
2011/4/11,1245,8847,16,24,5,19,1.003,1.853
2011/4/11,1345,8859,13,41,23,18,1.001,1.044
2011/4/12,945,8765,-55,72,57,15,1.011,0.489
2011/4/12,1045,8714,-51,62,57,5,1.015,0.73
2011/4/12,1145,8739,24,28,-5,33,1.01,1.258
2011/4/12,1245,8714,-23,43,36,7,1.011,1.072
2011/4/12,1345,8705,-10,38,38,0,1.01,0.799
2011/4/13,945,8726,-2,39,9,30,1.006,0.855
2011/4/13,1045,8717,-10,25,9,16,1.006,1.617
2011/4/13,1145,8737,19,31,3,28,1.002,1.374
2011/4/13,1245,8761,24,30,2,28,0.998,1.527
2011/4/13,1345,8806,44,51,0,51,0.992,0.887
2011/4/14,945,8787,7,33,7,26,0.994,0.923
2011/4/14,1045,8783,-3,18,6,12,0.995,1.794
2011/4/14,1145,8838,54,72,8,64,0.989,0.754
2011/4/14,1245,8788,-50,102,64,38,0.996,0.623
2011/4/14,1345,8799,12,46,28,18,0.996,0.856
2011/4/15,945,8779,-7,58,41,17,0.999,0.962
2011/4/15,1045,8782,5,32,29,3,0.999,1.254
2011/4/15,1145,8775,-6,39,20,19,1,1.387
2011/4/15,1245,8721,-53,54,58,-4,1.007,1.168
2011/4/15,1345,8704,-17,57,33,24,1.008,0.721
2011/4/18,945,8744,52,57,2,55,1.003,0.928
2011/4/18,1045,8752,8,26,8,18,1.001,1.337
2011/4/18,1145,8718,-34,37,38,-1,1.005,1.916
2011/4/18,1245,8709,-8,53,18,35,1.005,0.898
2011/4/18,1345,8710,1,27,6,21,1.004,1.207
2011/4/19,945,8614,-43,66,57,9,1.013,0.59
2011/4/19,1045,8607,-6,37,20,17,1.012,1.012
2011/4/19,1145,8598,-8,43,30,13,1.011,1.094
2011/4/19,1245,8617,18,32,10,22,1.007,1.565
2011/4/19,1345,8627,10,28,17,11,1.005,0.935
2011/4/20,945,8743,42,58,10,48,0.991,0.85
2011/4/20,1045,8760,17,25,3,22,0.989,1.865
2011/4/20,1145,8769,9,20,13,7,0.988,2.167
2011/4/20,1245,8772,3,19,12,7,0.989,3.72
2011/4/21,945,8895,13,157,17,140,0.977,0.511
2011/4/21,1045,8985,90,103,9,94,0.97,0.594
2011/4/21,1145,8991,6,34,13,21,0.973,0.988
2011/4/21,1245,8992,2,26,2,24,0.977,1.486
2011/4/21,1345,8993,1,25,4,21,0.982,0.943
2011/4/22,945,8993,4,31,15,16,0.986,1.085
2011/4/22,1045,8978,-14,31,26,5,0.991,1.613
2011/4/22,1145,8984,6,16,11,5,0.993,2.476
2011/4/22,1245,8983,-1,14,12,2,0.995,3.099
2011/4/22,1345,8992,9,13,1,12,0.997,1.755
2011/4/25,945,8963,-40,79,87,-8,1.001,0.538
2011/4/25,1045,8991,28,50,1,49,0.999,0.757
2011/4/25,1145,9003,11,38,22,16,0.998,0.855
2011/4/25,1245,8983,-20,36,24,12,1,1.074
2011/4/25,1345,8975,-8,23,12,11,1.001,1.124
2011/4/26,945,8962,48,108,16,92,1.001,0.411
2011/4/26,1045,8959,-2,42,23,19,1.001,0.804
2011/4/26,1145,8910,-51,56,63,-7,1.007,0.927
2011/4/26,1245,8911,1,35,14,21,1.006,1.19
2011/4/26,1345,8970,60,61,6,55,0.998,0.95
2011/4/27,945,9059,8,46,19,27,0.989,0.719
2011/4/27,1045,9054,-5,26,12,14,0.991,1.327
2011/4/27,1145,9052,-2,15,8,7,0.992,2.614
2011/4/27,1245,9058,5,16,6,10,0.992,2.493
2011/4/27,1345,9060,2,38,14,24,0.992,0.954
2011/4/28,945,9079,-19,33,19,14,0.992,0.861
2011/4/28,1045,9072,-6,16,10,6,0.994,1.88
2011/4/28,1145,9012,-60,56,64,-8,1.002,0.858
2011/4/28,1245,9021,9,31,15,16,1.002,1.02
2011/4/28,1345,9010,-11,36,38,-2,1.005,0.712
2011/4/29,945,9003,-12,72,29,43,1.005,0.536
2011/4/29,1045,9044,41,44,5,39,1,0.936
2011/4/29,1145,8999,-45,60,49,11,1.005,1.082
2011/4/29,1245,8963,-37,59,46,13,1.008,0.827
2011/4/29,1345,9027,64,97,0,97,1,0.666
2011/5/3,945,8977,-59,112,75,37,1.005,0.736
2011/5/3,1045,8929,-48,78,45,33,1.009,0.81
2011/5/3,1145,8925,-5,32,23,9,1.008,2.002
2011/5/3,1245,8925,0,28,13,15,1.007,2.242
2011/5/3,1345,8926,1,60,52,8,1.006,0.872
2011/5/4,945,8889,-19,59,30,29,1.009,0.724
2011/5/4,1045,8909,21,38,9,29,1.005,1.206
2011/5/4,1145,8890,-19,37,21,16,1.006,1.726
2011/5/4,1245,8935,45,47,-7,54,1,1.591
2011/5/4,1345,8937,1,43,22,21,0.999,0.975
2011/5/5,945,8924,21,55,16,39,0.999,0.862
2011/5/5,1045,9028,104,116,14,102,0.987,0.509
2011/5/5,1145,9015,-13,42,30,12,0.989,1.471
2011/5/5,1245,9033,18,29,8,21,0.988,2.119
2011/5/5,1345,9050,18,32,8,24,0.988,0.89
2011/5/6,945,8989,18,47,26,21,0.995,0.76
2011/5/6,1045,9013,24,42,7,35,0.994,1.337
2011/5/6,1145,8993,-19,32,22,10,0.997,1.689
2011/5/6,1245,8997,3,46,15,31,0.998,1.419
2011/5/6,1345,9018,19,30,4,26,0.996,1.251
2011/5/9,945,9096,95,96,1,95,0.989,0.629
2011/5/9,1045,9092,-4,28,10,18,0.991,1.35
2011/5/9,1145,9098,6,28,13,15,0.991,1.54
2011/5/9,1245,9089,-10,21,8,13,0.993,1.751
2011/5/9,1345,9063,-26,51,28,23,0.996,0.787
2011/5/10,945,9051,-12,34,20,14,0.999,1.029
2011/5/10,1045,9060,10,37,7,30,0.998,1.163
2011/5/10,1145,9036,-24,26,23,3,1.002,1.875
2011/5/10,1245,9042,5,24,8,16,1.001,1.781
2011/5/10,1345,9046,4,25,18,7,1.001,1.073
2011/5/11,945,9060,-49,61,50,11,1.001,0.566
2011/5/11,1045,9048,-12,53,18,35,1.002,0.558
2011/5/11,1145,9053,6,27,15,12,1.001,1.313
2011/5/11,1245,9049,-5,18,6,12,1.001,1.572
2011/5/11,1345,9020,-29,31,29,2,1.004,0.837
2011/5/12,945,8979,19,53,19,34,1.007,0.629
2011/5/12,1045,9011,32,54,4,50,1.003,0.969
2011/5/12,1145,9023,11,35,16,19,1.001,1.063
2011/5/12,1245,9062,38,50,6,44,0.996,1.059
2011/5/12,1345,9030,-31,42,34,8,1,0.907
2011/5/13,945,9033,16,46,30,16,0.999,0.871
2011/5/13,1045,9040,7,27,18,9,0.998,1.322
2011/5/13,1145,9029,-11,31,22,9,0.999,1.502
2011/5/13,1245,9013,-16,34,21,13,1,1.108
2011/5/13,1345,9034,21,25,5,20,0.998,1.177
2011/5/16,945,8965,-30,86,61,25,1.006,0.535
2011/5/16,1045,8964,-3,30,9,21,1.006,1.553
2011/5/16,1145,8946,-19,36,40,-4,1.007,1.617
2011/5/16,1245,8959,13,32,-4,36,1.005,1.197
2011/5/16,1345,8922,-37,46,38,8,1.008,0.867
2011/5/17,945,8914,14,42,14,28,1.007,0.789
2011/5/17,1045,8850,-64,66,78,-12,1.013,0.728
2011/5/17,1145,8900,49,52,-1,53,1.006,1.084
2011/5/17,1245,8922,20,38,14,24,1.002,1.161
2011/5/17,1345,8914,-8,36,20,16,1.002,1.254
2011/5/18,945,8927,12,44,21,23,0.999,1.179
2011/5/18,1045,8907,-21,39,32,7,1.001,1.971
2011/5/18,1145,8912,4,28,12,16,1,2.251
2011/5/18,1245,8908,-4,15,15,0,1,3.208
2011/5/19,945,9012,52,128,19,109,0.988,0.391
2011/5/19,1045,9021,9,34,22,12,0.989,0.886
2011/5/19,1145,8991,-29,47,37,10,0.993,0.984
2011/5/19,1245,8922,-71,73,76,-3,1.002,0.576
2011/5/19,1345,8840,-83,120,118,2,1.012,0.498
2011/5/20,945,8872,-28,53,43,10,1.008,0.837
2011/5/20,1045,8884,10,42,25,17,1.006,1.26
2011/5/20,1145,8854,-30,50,41,9,1.009,1.464
2011/5/20,1245,8827,-27,72,51,21,1.012,0.963
2011/5/20,1345,8817,-10,57,51,6,1.012,1.148
2011/5/23,945,8725,-22,40,28,12,1.02,0.976
2011/5/23,1045,8735,10,31,4,27,1.015,1.472
2011/5/23,1145,8681,-54,66,53,13,1.019,1.223
2011/5/23,1245,8737,56,85,34,51,1.008,0.998
2011/5/23,1345,8738,3,49,21,28,1.006,1.186
2011/5/24,945,8721,-2,44,34,10,1.006,0.822
2011/5/24,1045,8691,-30,67,36,31,1.008,0.764
2011/5/24,1145,8733,41,59,12,47,1.001,1.156
2011/5/24,1245,8728,-4,33,22,11,1,1.445
2011/5/24,1345,8762,34,38,5,33,0.995,1.157
2011/5/25,945,8664,-81,85,76,9,1.006,0.575
2011/5/25,1045,8681,19,48,17,31,1.003,1.12
2011/5/25,1145,8685,5,32,15,17,1.002,1.712
2011/5/25,1245,8734,49,57,4,53,0.997,0.935
2011/5/25,1345,8678,-56,58,55,3,1.003,1.167
2011/5/26,945,8727,-37,38,34,4,0.998,1.018
2011/5/26,1045,8731,4,22,10,12,0.998,1.644
2011/5/26,1145,8756,24,30,4,26,0.995,1.565
2011/5/26,1245,8768,12,22,0,22,0.994,1.684
2011/5/26,1345,8787,19,20,9,11,0.992,0.898
2011/5/27,945,8796,23,43,25,18,0.992,0.75
2011/5/27,1045,8801,5,26,14,12,0.993,1.584
2011/5/27,1145,8841,40,49,4,45,0.99,0.988
2011/5/27,1245,8800,-41,52,55,-3,0.996,0.761
2011/5/27,1345,8782,-18,41,27,14,0.999,0.701
2011/5/30,945,8786,26,89,11,78,0.998,0.575
2011/5/30,1045,8813,27,47,10,37,0.996,1.029
2011/5/30,1145,8816,3,21,11,10,0.996,2.104
2011/5/30,1245,8803,-13,33,18,15,0.999,1.551
2011/5/30,1345,8820,16,52,-2,54,0.997,0.775
2011/5/31,945,8902,45,45,0,45,0.989,0.73
2011/5/31,1045,8929,27,34,1,33,0.987,1.167
2011/5/31,1145,8924,-5,23,11,12,0.989,2.002
2011/5/31,1245,8954,31,48,11,37,0.987,1.112
2011/5/31,1345,9021,67,87,13,74,0.981,0.571
2011/6/1,945,9052,29,43,7,36,0.981,0.868
2011/6/1,1045,9071,17,32,2,30,0.981,1.221
2011/6/1,1145,9083,12,33,13,20,0.983,1.031
2011/6/1,1245,9082,-1,37,24,13,0.986,1.27
2011/6/1,1345,9092,10,32,10,22,0.988,1.025
2011/6/2,945,9038,58,72,19,53,0.995,0.685
2011/6/2,1045,9028,-8,38,21,17,0.998,1.364
2011/6/2,1145,9014,-14,32,26,6,1.001,1.817
2011/6/2,1245,9023,8,22,13,9,1.001,2.362
2011/6/2,1345,9027,4,26,7,19,1.001,1.184
2011/6/3,945,9008,-40,64,54,10,1.003,0.716
2011/6/3,1045,9022,14,27,13,14,1.001,1.067
2011/6/3,1145,9052,31,39,0,39,0.997,1.284
2011/6/3,1245,9051,-1,27,23,4,0.997,0.989
2011/6/3,1345,9070,19,30,8,22,0.995,0.988
2011/6/7,945,8989,-43,69,53,16,1.004,0.532
2011/6/7,1045,9007,19,28,11,17,1.002,1.335
2011/6/7,1145,9043,36,59,4,55,0.997,0.934
2011/6/7,1245,9054,12,32,14,18,0.997,0.997
2011/6/7,1345,9095,45,40,-3,43,0.992,1.014
2011/6/8,945,9052,-24,49,35,14,0.997,0.73
2011/6/8,1045,9006,-46,51,47,4,1.003,0.829
2011/6/8,1145,9024,17,50,29,21,1.001,1.149
2011/6/8,1245,9058,36,35,4,31,0.997,1.355
2011/6/8,1345,9031,-28,62,34,28,1,0.931
2011/6/9,945,9018,7,51,32,19,1.001,0.776
2011/6/9,1045,9027,9,36,13,23,1,1.316
2011/6/9,1145,9012,-15,22,18,4,1.002,1.583
2011/6/9,1245,9034,22,37,10,27,0.999,1.333
2011/6/9,1345,9031,-5,24,11,13,1,1.323
2011/6/10,945,9008,-60,62,59,3,1.002,0.642
2011/6/10,1045,8901,-107,89,103,-14,1.014,0.487
2011/6/10,1145,8902,1,65,31,34,1.012,0.849
2011/6/10,1245,8865,-37,74,41,33,1.015,0.814
2011/6/10,1345,8829,-34,56,38,18,1.017,0.812
2011/6/13,945,8765,-15,51,36,15,1.022,0.81
2011/6/13,1045,8778,13,43,27,16,1.018,1.74
2011/6/13,1145,8717,-61,79,66,13,1.022,0.92
2011/6/13,1245,8693,-24,64,54,10,1.021,1.315
2011/6/13,1345,8744,51,61,0,61,1.011,1.172
2011/6/14,945,8756,13,39,17,22,1.006,1.286
2011/6/14,1045,8823,67,69,5,64,0.996,0.893
2011/6/14,1145,8825,1,36,14,22,0.995,1.501
2011/6/14,1245,8838,13,37,7,30,0.992,1.391
2011/6/14,1345,8846,8,23,2,21,0.991,1.262
2011/6/15,945,8780,-66,65,60,5,0.999,0.854
2011/6/15,1045,8772,-8,40,30,10,1,1.667
2011/6/15,1145,8735,-37,53,48,5,1.005,1.558
2011/6/15,1245,8790,53,85,32,53,0.999,1.13
2011/6/16,945,8512,-47,375,365,10,1.03,0.441
2011/6/16,1045,8526,13,49,4,45,1.025,0.869
2011/6/16,1145,8510,-15,55,40,15,1.024,1.085
2011/6/16,1245,8503,-7,34,27,7,1.022,1.522
2011/6/16,1345,8493,-10,33,24,9,1.019,0.889
2011/6/17,945,8479,-13,71,64,7,1.017,0.757
2011/6/17,1045,8487,8,38,8,30,1.011,1.035
2011/6/17,1145,8513,26,57,17,40,1.005,1.073
2011/6/17,1245,8466,-45,48,50,-2,1.007,1.366
2011/6/17,1345,8461,-2,33,8,25,1.005,0.966
2011/6/20,945,8504,3,41,13,28,0.999,1.02
2011/6/20,1045,8475,-29,43,50,-7,1.002,1.129
2011/6/20,1145,8405,-70,90,78,12,1.01,0.717
2011/6/20,1245,8385,-20,48,45,3,1.011,1.129
2011/6/20,1345,8401,15,35,-1,36,1.008,0.939
2011/6/21,945,8429,-41,58,45,13,1.004,0.843
2011/6/21,1045,8405,-24,57,55,2,1.006,0.983
2011/6/21,1145,8425,20,45,20,25,1.003,1.249
2011/6/21,1245,8436,13,39,6,33,1.001,1.432
2011/6/21,1345,8465,29,43,18,25,0.997,0.896
2011/6/22,945,8479,-39,47,35,12,0.996,0.823
2011/6/22,1045,8486,7,26,12,14,0.994,1.856
2011/6/22,1145,8446,-40,70,69,1,0.999,0.924
2011/6/22,1245,8453,7,29,-8,37,0.999,0.979
2011/6/22,1345,8441,-11,34,36,-2,1.001,0.924
2011/6/23,945,8406,-18,86,69,17,1.005,0.631
2011/6/23,1045,8433,27,55,15,40,1.001,1.034
2011/6/23,1145,8420,-13,33,22,11,1.003,1.669
2011/6/23,1245,8409,-11,23,19,4,1.004,2.008
2011/6/23,1345,8395,-15,44,47,-3,1.006,1.106
2011/6/24,945,8388,-32,56,33,23,1.005,0.756
2011/6/24,1045,8402,14,36,8,28,1.003,1.144
2011/6/24,1145,8387,-14,18,14,4,1.003,1.877
2011/6/24,1245,8386,-3,21,12,9,1.003,1.94
2011/6/24,1345,8411,25,36,11,25,0.999,0.907
2011/6/27,945,8280,-30,38,18,20,1.014,0.662
2011/6/27,1045,8322,43,64,15,49,1.007,1.051
2011/6/27,1145,8322,0,34,8,26,1.006,1.353
2011/6/27,1245,8363,41,55,10,45,0.999,0.849
2011/6/27,1345,8337,-26,33,29,4,1.002,0.947
2011/6/28,945,8369,-16,38,27,11,0.998,0.828
2011/6/28,1045,8379,11,20,6,14,0.996,1.925
2011/6/28,1145,8331,-48,60,44,16,1.002,0.763
2011/6/28,1245,8335,4,28,8,20,1.001,1.343
2011/6/28,1345,8308,-27,48,44,4,1.003,0.86
2011/6/29,945,8357,-20,22,18,4,0.998,0.895
2011/6/29,1045,8447,90,104,12,92,0.988,0.565
2011/6/29,1145,8464,17,41,22,19,0.988,1.015
2011/6/29,1245,8429,-35,53,49,4,0.994,1.257
2011/6/29,1345,8471,42,61,2,59,0.99,0.802
2011/6/30,945,8485,10,37,8,29,0.989,0.957
2011/6/30,1045,8512,29,54,8,46,0.987,0.983
2011/6/30,1145,8511,0,20,7,13,0.989,1.92
2011/6/30,1245,8489,-22,43,36,7,0.994,1.345
2011/6/30,1345,8503,14,37,25,12,0.994,1.039
2011/7/1,945,8594,34,49,-2,51,0.985,0.851
2011/7/1,1045,8593,-1,29,14,15,0.988,1.224
2011/7/1,1145,8601,9,24,11,13,0.989,1.451
2011/7/1,1245,8614,12,16,1,15,0.989,1.887
2011/7/1,1345,8566,-48,40,49,-9,0.997,0.837
2011/7/4,945,8620,-11,22,14,8,0.992,0.929
2011/7/4,1045,8649,28,32,3,29,0.991,1.019
2011/7/4,1145,8644,-6,19,13,6,0.993,1.547
2011/7/4,1245,8637,-6,19,3,16,0.995,1.501
2011/7/4,1345,8603,-34,44,39,5,1.001,1.03
2011/7/5,945,8602,-9,29,12,17,1.002,0.987
2011/7/5,1045,8602,1,16,5,11,1.002,1.417
2011/7/5,1145,8624,21,35,7,28,0.999,0.884
2011/7/5,1245,8614,-10,20,16,4,1.001,1.547
2011/7/5,1345,8628,14,28,2,26,0.999,0.966
2011/7/6,945,8692,64,65,-4,69,0.992,0.558
2011/7/6,1045,8692,1,23,17,6,0.992,0.7
2011/7/6,1145,8702,10,15,4,11,0.992,1.588
2011/7/6,1245,8684,-19,36,29,7,0.994,1.091
2011/7/6,1345,8692,8,24,12,12,0.994,0.914
2011/7/7,945,8689,-1,47,23,24,0.995,0.674
2011/7/7,1045,8703,13,29,-1,30,0.995,1.366
2011/7/7,1145,8685,-18,22,22,0,0.998,1.488
2011/7/7,1245,8687,1,23,9,14,0.998,1.67
2011/7/7,1345,8690,3,18,11,7,0.999,1.336
2011/7/8,945,8757,61,69,11,58,0.992,0.499
2011/7/8,1045,8752,-6,15,5,10,0.993,1.426
2011/7/8,1145,8679,-73,85,73,12,1.002,0.577
2011/7/8,1245,8673,-6,50,14,36,1.003,0.747
2011/7/8,1345,8638,-33,51,48,3,1.007,0.906
2011/7/11,945,8616,13,39,14,25,1.008,0.783
2011/7/11,1045,8597,-19,45,21,24,1.01,1.047
2011/7/11,1145,8587,-9,24,23,1,1.01,2.088
2011/7/11,1245,8583,-4,22,22,0,1.009,2.222
2011/7/11,1345,8599,16,25,8,17,1.006,1.426
2011/7/12,945,8476,-35,63,62,1,1.018,0.599
2011/7/12,1045,8461,-15,37,26,11,1.017,0.84
2011/7/12,1145,8446,-18,26,21,5,1.015,1.339
2011/7/12,1245,8453,7,19,11,8,1.012,2.045
2011/7/12,1345,8419,-35,45,38,7,1.013,0.625
2011/7/13,945,8436,5,32,14,18,1.009,0.829
2011/7/13,1045,8474,38,46,-6,52,1.002,0.959
2011/7/13,1145,8466,-8,25,17,8,1.002,1.276
2011/7/13,1245,8431,-35,47,46,1,1.005,1.249
2011/7/13,1345,8463,32,59,6,53,0.999,0.858
2011/7/14,945,8480,32,69,26,43,0.996,0.674
2011/7/14,1045,8457,-23,36,22,14,0.999,1.183
2011/7/14,1145,8408,-49,58,50,8,1.005,0.803
2011/7/14,1245,8383,-25,59,36,23,1.007,0.811
2011/7/14,1345,8482,99,110,0,110,0.995,0.65
2011/7/15,945,8485,13,51,17,34,0.995,0.883
2011/7/15,1045,8557,73,98,7,91,0.987,0.769
2011/7/15,1145,8526,-31,44,33,11,0.992,1.21
2011/7/15,1245,8529,3,32,25,7,0.992,1.973
2011/7/15,1345,8562,31,49,8,41,0.989,1.103
2011/7/18,945,8490,-17,58,37,21,0.998,0.818
2011/7/18,1045,8562,73,100,28,72,0.99,0.811
2011/7/18,1145,8563,1,32,4,28,0.991,1.781
2011/7/18,1245,8519,-44,58,43,15,0.998,1.54
2011/7/18,1345,8487,-32,67,67,0,1.004,1.054
2011/7/19,945,8513,13,48,22,26,1.001,0.882
2011/7/19,1045,8530,17,55,16,39,0.999,1.077
2011/7/19,1145,8516,-13,39,19,20,1,1.362
2011/7/19,1245,8518,3,31,19,12,1,1.778
2011/7/19,1345,8535,18,23,4,19,0.998,1.35
2011/7/20,945,8652,32,52,11,41,0.986,0.813
2011/7/20,1045,8655,3,17,5,12,0.987,2.106
2011/7/20,1145,8639,-16,32,17,15,0.99,2.308
2011/7/20,1245,8665,26,31,3,28,0.988,1.748
2011/7/21,945,8630,-7,90,78,12,0.993,0.521
2011/7/21,1045,8630,0,18,10,8,0.995,1.473
2011/7/21,1145,8630,-1,24,9,15,0.996,1.474
2011/7/21,1245,8629,-1,9,6,3,0.998,3.329
2011/7/21,1345,8652,22,32,2,30,0.996,0.908
2011/7/22,945,8699,-4,34,17,17,0.993,0.635
2011/7/22,1045,8732,34,49,8,41,0.99,0.663
2011/7/22,1145,8721,-11,16,10,6,0.992,1.53
2011/7/22,1245,8706,-17,29,26,3,0.995,1.236
2011/7/22,1345,8691,-15,32,37,-5,0.997,0.945
2011/7/25,945,8663,13,41,26,15,1.001,0.605
2011/7/25,1045,8636,-27,48,32,16,1.004,0.75
2011/7/25,1145,8600,-36,50,36,14,1.008,0.712
2011/7/25,1245,8614,14,30,17,13,1.006,1.264
2011/7/25,1345,8608,-6,38,28,10,1.007,0.948
2011/7/26,945,8631,-5,29,26,3,1.004,0.792
2011/7/26,1045,8675,44,56,14,42,0.998,0.75
2011/7/26,1145,8720,45,54,2,52,0.992,0.843
2011/7/26,1245,8717,-3,17,5,12,0.992,1.995
2011/7/26,1345,8738,22,46,6,40,0.99,0.876
2011/7/27,945,8726,12,33,14,19,0.992,0.992
2011/7/27,1045,8756,31,41,12,29,0.989,1.055
2011/7/27,1145,8744,-13,29,28,1,0.992,1.471
2011/7/27,1245,8766,22,34,0,34,0.991,1.371
2011/7/27,1345,8762,-4,14,6,8,0.993,1.411
2011/7/28,945,8717,22,69,12,57,0.999,0.571
2011/7/28,1045,8697,-20,53,38,15,1.002,0.871
2011/7/28,1145,8712,15,36,9,27,1.001,1.411
2011/7/28,1245,8699,-13,39,25,14,1.002,1.295
2011/7/28,1345,8728,28,36,3,33,0.999,1.03
2011/7/29,945,8709,11,34,17,17,1.001,0.87
2011/7/29,1045,8616,-94,114,94,20,1.012,0.446
2011/7/29,1145,8625,9,45,12,33,1.009,0.989
2011/7/29,1245,8651,25,57,20,37,1.004,1.171
2011/7/29,1345,8613,-38,58,37,21,1.008,0.854
2011/8/1,945,8684,-29,67,38,29,1,0.805
2011/8/1,1045,8676,-6,29,21,8,1,1.775
2011/8/1,1145,8698,23,34,10,24,0.997,1.694
2011/8/1,1245,8683,-15,19,13,6,0.999,3.027
2011/8/1,1345,8681,-3,19,17,2,0.999,1.791
2011/8/2,945,8580,-20,40,20,20,1.009,0.757
2011/8/2,1045,8576,-4,33,7,26,1.008,1.012
2011/8/2,1145,8559,-16,25,28,-3,1.01,1.694
2011/8/2,1245,8550,-9,32,17,15,1.01,1.01
2011/8/2,1345,8574,25,29,1,28,1.006,0.856
2011/8/3,945,8383,-37,57,59,-2,1.026,0.527
2011/8/3,1045,8409,26,49,7,42,1.019,0.835
2011/8/3,1145,8439,30,50,15,35,1.012,0.92
2011/8/3,1245,8433,-8,28,9,19,1.01,1.712
2011/8/3,1345,8439,6,36,16,20,1.006,1.103
2011/8/4,945,8451,21,57,37,20,1.003,0.652
2011/8/4,1045,8433,-19,37,25,12,1.003,0.957
2011/8/4,1145,8415,-18,29,18,11,1.004,1.148
2011/8/4,1245,8326,-89,73,99,-26,1.013,0.901
2011/8/4,1345,8294,-33,110,94,16,1.014,0.608
2011/8/5,945,7860,40,120,94,26,1.062,0.431
2011/8/5,1045,7941,80,129,47,82,1.045,0.798
2011/8/5,1145,7910,-30,76,47,29,1.043,1.34
2011/8/5,1245,7891,-18,58,25,33,1.039,1.331
2011/8/5,1345,7766,-125,146,116,30,1.049,0.65
2011/8/8,945,7765,23,87,0,87,1.04,0.826
2011/8/8,1045,7652,-112,130,115,15,1.046,1.042
2011/8/8,1145,7607,-45,119,78,41,1.042,0.94
2011/8/8,1245,7425,-183,359,194,165,1.057,0.519
2011/8/8,1345,7555,132,210,40,170,1.027,0.733
2011/8/9,945,7125,-105,144,118,26,1.08,0.713
2011/8/9,1045,7230,99,165,26,139,1.055,0.864
2011/8/9,1145,7460,230,289,36,253,1.013,0.879
2011/8/9,1245,7522,58,212,85,127,0.998,0.956
2011/8/9,1345,7533,10,112,36,76,0.992,1.429
2011/8/10,945,7629,32,88,69,19,0.978,1.137
2011/8/10,1045,7667,39,83,-3,86,0.971,1.439
2011/8/10,1145,7683,16,60,13,47,0.969,1.785
2011/8/10,1245,7652,-30,50,34,16,0.974,2.088
2011/8/10,1345,7662,9,53,33,20,0.976,1.51
2011/8/11,945,7580,26,111,-8,119,0.991,0.805
2011/8/11,1045,7724,145,195,24,171,0.978,0.769
2011/8/11,1145,7624,-101,103,113,-10,0.997,1.077
2011/8/11,1245,7679,56,77,22,55,0.992,1.332
2011/8/11,1345,7699,19,72,31,41,0.992,1.142
2011/8/12,945,7732,-8,71,62,9,0.989,0.913
2011/8/12,1045,7717,-19,56,48,8,0.993,1.354
2011/8/12,1145,7639,-78,123,106,17,1.003,1.153
2011/8/12,1245,7601,-38,77,58,19,1.008,1.02
2011/8/12,1345,7589,-12,65,40,25,1.009,1.006
2011/8/15,945,7753,30,51,27,24,0.99,1.292
2011/8/15,1045,7739,-15,51,24,27,0.994,1.723
2011/8/15,1145,7752,13,38,11,27,0.992,2.546
2011/8/15,1245,7804,52,55,-7,62,0.987,1.76
2011/8/15,1345,7817,11,47,14,33,0.987,1.122
2011/8/16,945,7802,-56,114,75,39,0.991,0.653
2011/8/16,1045,7791,-12,62,46,16,0.993,1.068
2011/8/16,1145,7785,-6,45,29,16,0.995,1.212
2011/8/16,1245,7764,-22,67,38,29,0.999,1.054
2011/8/16,1345,7773,11,39,22,17,1,1.012
2011/8/17,945,7773,15,71,51,20,1.001,1.002
2011/8/17,1045,7747,-26,69,40,29,1.004,1.257
2011/8/17,1145,7780,32,54,25,29,1,1.665
2011/8/17,1245,7771,-10,47,21,26,1.002,2.15
2011/8/18,945,7519,-61,282,278,4,1.032,0.523
2011/8/18,1045,7496,-23,66,45,21,1.031,0.724
2011/8/18,1145,7511,13,45,23,22,1.025,1.073
2011/8/18,1245,7460,-51,72,65,7,1.028,0.993
2011/8/18,1345,7500,41,85,32,53,1.018,0.744
2011/8/19,945,7312,14,86,36,50,1.038,0.575
2011/8/19,1045,7324,12,63,31,32,1.03,1.018
2011/8/19,1145,7305,-20,59,40,19,1.027,1.266
2011/8/19,1245,7296,-9,79,24,55,1.022,0.977
2011/8/19,1345,7195,-101,99,99,0,1.029,1.014
2011/8/22,945,7354,157,173,34,139,1.002,0.663
2011/8/22,1045,7351,-3,107,82,25,1,0.875
2011/8/22,1145,7199,-152,189,150,39,1.019,0.701
2011/8/22,1245,7283,85,84,-9,93,1.003,1.19
2011/8/22,1345,7252,-32,126,87,39,1.005,0.966
2011/8/23,945,7315,14,59,51,8,0.996,0.984
2011/8/23,1045,7381,66,86,2,84,0.988,1.051
2011/8/23,1145,7428,46,54,0,54,0.982,1.182
2011/8/23,1245,7455,27,38,-3,41,0.98,1.626
2011/8/23,1345,7509,54,71,34,37,0.975,0.949
2011/8/24,945,7449,-81,94,93,1,0.988,0.834
2011/8/24,1045,7392,-57,102,63,39,0.996,0.839
2011/8/24,1145,7394,4,85,31,54,0.997,1.006
2011/8/24,1245,7489,96,109,16,93,0.987,0.996
2011/8/24,1345,7423,-66,119,97,22,0.998,0.968
2011/8/25,945,7480,-63,93,63,30,0.994,0.956
2011/8/25,1045,7504,23,53,19,34,0.993,1.361
2011/8/25,1145,7459,-45,83,50,33,1,1.246
2011/8/25,1245,7427,-32,75,51,24,1.005,1.38
2011/8/25,1345,7366,-61,95,75,20,1.013,1.027
2011/8/26,945,7430,31,84,61,23,1.003,0.856
2011/8/26,1045,7406,-24,92,58,34,1.006,0.975
2011/8/26,1145,7393,-12,68,29,39,1.008,1.076
2011/8/26,1245,7441,48,84,19,65,1.001,1.136
2011/8/26,1345,7447,6,54,-1,55,1,1.268
2011/8/29,945,7551,81,142,31,111,0.985,0.723
2011/8/29,1045,7584,32,55,11,44,0.982,1.138
2011/8/29,1145,7589,5,36,9,27,0.982,1.733
2011/8/29,1245,7571,-18,47,39,8,0.986,1.45
2011/8/29,1345,7525,-45,47,50,-3,0.994,1.107
2011/8/30,945,7590,-10,57,15,42,0.988,0.901
2011/8/30,1045,7622,31,58,10,48,0.986,1.018
2011/8/30,1145,7584,-39,63,44,19,0.994,1.184
2011/8/30,1245,7596,12,40,6,34,0.995,1.548
2011/8/30,1345,7603,7,44,23,21,0.996,1.12
2011/8/31,945,7570,-47,56,48,8,1.002,0.946
2011/8/31,1045,7599,29,43,0,43,0.999,1.102
2011/8/31,1145,7656,57,67,3,64,0.991,0.804
2011/8/31,1245,7662,6,31,7,24,0.991,1.518
2011/8/31,1345,7707,45,104,7,97,0.987,0.663
2011/9/1,945,7832,82,104,17,87,0.973,0.612
2011/9/1,1045,7820,-12,52,12,40,0.978,0.914
2011/9/1,1145,7781,-39,66,47,19,0.985,1.075
2011/9/1,1245,7731,-51,57,54,3,0.994,1.059
2011/9/1,1345,7700,-31,67,48,19,1,0.849
2011/9/2,945,7699,-26,54,46,8,1.001,1
2011/9/2,1045,7656,-43,42,37,5,1.009,0.949
2011/9/2,1145,7671,14,42,22,20,1.007,1.58
2011/9/2,1245,7705,35,72,27,45,1.003,1.216
2011/9/2,1345,7710,5,28,17,11,1.003,1.592
2011/9/5,945,7510,-40,83,43,40,1.027,0.631
2011/9/5,1045,7491,-19,42,32,10,1.025,1.419
2011/9/5,1145,7524,33,62,21,41,1.017,1.356
2011/9/5,1245,7493,-32,56,48,8,1.017,1.52
2011/9/5,1345,7480,-13,46,33,13,1.016,1.111
2011/9/6,945,7475,71,71,13,58,1.012,0.663
2011/9/6,1045,7353,-122,116,124,-8,1.026,0.752
2011/9/6,1145,7376,26,79,50,29,1.019,0.772
2011/9/6,1245,7351,-25,77,57,20,1.018,0.94
2011/9/6,1345,7340,-11,51,24,27,1.015,0.838
2011/9/7,945,7453,-7,36,29,7,0.998,0.998
2011/9/7,1045,7420,-34,37,29,8,1.002,1.177
2011/9/7,1145,7449,29,49,19,30,0.997,1.522
2011/9/7,1245,7478,29,58,24,34,0.992,1.244
2011/9/7,1345,7536,58,58,1,57,0.984,1.112
2011/9/8,945,7533,-32,48,53,-5,0.987,0.87
2011/9/8,1045,7511,-22,48,39,9,0.991,1.047
2011/9/8,1145,7482,-29,69,64,5,0.997,1.089
2011/9/8,1245,7516,33,41,4,37,0.993,1.206
2011/9/8,1345,7550,34,70,28,42,0.991,0.779
2011/9/9,945,7568,15,87,29,58,0.99,0.787
2011/9/9,1045,7633,65,85,21,64,0.983,0.725
2011/9/9,1145,7568,-65,84,77,7,0.994,0.931
2011/9/9,1245,7562,-5,60,15,45,0.997,1.052
2011/9/9,1345,7602,40,64,7,57,0.993,1.133
2011/9/13,945,7461,-41,86,77,9,1.01,0.954
2011/9/13,1045,7427,-35,42,17,25,1.014,1.077
2011/9/13,1145,7443,17,44,11,33,1.011,1.747
2011/9/13,1245,7385,-58,89,83,6,1.018,1.15
2011/9/13,1345,7370,-14,57,22,35,1.018,0.98
2011/9/14,945,7422,24,49,40,9,1.009,0.871
2011/9/14,1045,7384,-38,72,39,33,1.012,0.895
2011/9/14,1145,7257,-129,151,132,19,1.027,0.723
2011/9/14,1245,7236,-22,92,16,76,1.026,0.735
2011/9/14,1345,7193,-45,100,74,26,1.027,0.763
2011/9/15,945,7347,-13,55,51,4,1.004,0.976
2011/9/15,1045,7422,75,108,28,80,0.992,0.832
2011/9/15,1145,7427,4,42,-4,46,0.991,1.361
2011/9/15,1245,7346,-82,89,88,1,1.002,1.25
2011/9/15,1345,7407,61,87,4,83,0.993,1.058
2011/9/16,945,7568,54,85,24,61,0.974,0.792
2011/9/16,1045,7588,20,38,17,21,0.973,1.393
2011/9/16,1145,7588,-1,47,35,12,0.976,1.352
2011/9/16,1245,7608,20,42,15,27,0.977,1.719
2011/9/16,1345,7617,10,37,11,26,0.981,1.055
2011/9/19,945,7527,-53,59,54,5,0.996,1.044
2011/9/19,1045,7503,-23,52,25,27,1.001,1.007
2011/9/19,1145,7489,-12,51,22,29,1.004,1.326
2011/9/19,1245,7462,-26,60,56,4,1.009,1.43
2011/9/19,1345,7478,18,42,19,23,1.008,1.232
2011/9/20,945,7534,90,143,32,111,1,0.595
2011/9/20,1045,7405,-129,166,135,31,1.017,0.537
2011/9/20,1145,7490,85,114,-7,121,1.003,0.755
2011/9/20,1245,7478,-12,58,18,40,1.003,1.441
2011/9/20,1345,7484,5,59,25,34,1,1.228
2011/9/21,945,7460,-48,56,51,5,1.003,1.34
2011/9/21,1045,7503,42,68,18,50,0.996,1.596
2011/9/21,1145,7542,37,45,3,42,0.991,1.864
2011/9/21,1245,7557,15,51,34,17,0.99,1.875
2011/9/22,945,7336,-26,277,236,41,1.018,0.601
2011/9/22,1045,7291,-42,47,40,7,1.023,1.119
2011/9/22,1145,7268,-24,54,36,18,1.023,1.104
2011/9/22,1245,7268,0,34,19,15,1.021,1.543
2011/9/22,1345,7276,8,38,26,12,1.017,0.925
2011/9/23,945,6990,-47,90,78,12,1.052,0.582
2011/9/23,1045,7095,105,124,1,123,1.029,0.656
2011/9/23,1145,7083,-11,80,21,59,1.026,0.97
2011/9/23,1245,7068,-17,56,22,34,1.022,1.352
2011/9/23,1345,7054,-17,53,20,33,1.017,1.265
2011/9/26,945,7002,-34,112,33,79,1.02,0.621
2011/9/26,1045,7016,15,68,12,56,1.013,1.015
2011/9/26,1145,6948,-68,74,67,7,1.019,1.142
2011/9/26,1245,6912,-34,53,52,1,1.02,1.23
2011/9/26,1345,6881,-31,91,65,26,1.02,0.893
2011/9/27,945,7078,40,52,7,45,0.991,0.933
2011/9/27,1045,7113,35,54,5,49,0.988,1.211
2011/9/27,1145,7104,-8,25,16,9,0.989,2.314
2011/9/27,1245,7051,-54,66,45,21,0.997,0.994
2011/9/27,1345,7135,85,87,-2,89,0.985,1.061
2011/9/28,945,7120,-67,91,54,37,0.989,0.731
2011/9/28,1045,7087,-31,73,53,20,0.995,0.886
2011/9/28,1145,7085,-3,42,35,7,0.996,1.301
2011/9/28,1245,7107,22,40,8,32,0.995,1.752
2011/9/28,1345,7100,-5,32,22,10,0.999,1.231
2011/9/29,945,7073,32,62,12,50,1.003,0.882
2011/9/29,1045,7160,86,117,18,99,0.991,0.714
2011/9/29,1145,7161,1,43,7,36,0.991,1.26
2011/9/29,1245,7178,18,49,24,25,0.99,1.045
2011/9/29,1345,7182,4,47,26,21,0.991,0.935
2011/9/30,945,7181,-1,72,49,23,0.991,0.676
2011/9/30,1045,7174,-7,45,23,22,0.993,0.964
2011/9/30,1145,7141,-34,44,38,6,0.999,1.201
2011/9/30,1245,7168,27,41,4,37,0.996,1.573
2011/9/30,1345,7182,14,42,18,24,0.994,1.11
2011/10/3,945,7068,39,67,17,50,1.01,1.026
2011/10/3,1045,7040,-29,35,26,9,1.014,1.334
2011/10/3,1145,6973,-67,84,73,11,1.022,0.769
2011/10/3,1245,6979,5,37,20,17,1.019,1.746
2011/10/3,1345,7015,36,64,8,56,1.011,1.068
2011/10/4,945,6997,126,146,21,125,1.009,0.555
2011/10/4,1045,6985,-14,45,35,10,1.008,0.992
2011/10/4,1145,6965,-18,64,63,1,1.008,0.99
2011/10/4,1245,7013,48,65,13,52,0.999,1.14
2011/10/4,1345,7094,79,88,-4,92,0.985,0.843
2011/10/5,945,7028,-30,68,59,9,0.995,0.846
2011/10/5,1045,7010,-18,45,26,19,0.997,1.238
2011/10/5,1145,7042,30,46,8,38,0.992,1.38
2011/10/5,1245,7038,-3,38,11,27,0.993,1.782
2011/10/5,1345,6990,-48,73,56,17,1.001,1.148
2011/10/6,945,7162,47,77,23,54,0.98,0.668
2011/10/6,1045,7179,16,28,11,17,0.98,1.536
2011/10/6,1145,7125,-53,78,53,25,0.991,0.931
2011/10/6,1245,7141,16,45,22,23,0.991,1.402
2011/10/6,1345,7122,-22,52,50,2,0.995,0.927
2011/10/7,945,7221,-29,59,21,38,0.984,0.734
2011/10/7,1045,7233,12,41,15,26,0.985,0.969
2011/10/7,1145,7242,10,40,18,22,0.987,1.379
2011/10/7,1245,7225,-18,41,20,21,0.992,1.185
2011/10/7,1345,7191,-34,45,47,-2,0.999,1.175
2011/10/11,945,7375,22,57,18,39,0.978,0.785
2011/10/11,1045,7383,9,22,12,10,0.979,1.76
2011/10/11,1145,7389,6,28,6,22,0.981,1.57
2011/10/11,1245,7392,3,24,10,14,0.985,1.939
2011/10/11,1345,7407,16,32,1,31,0.986,1.077
2011/10/12,945,7356,-14,41,25,16,0.994,0.728
2011/10/12,1045,7378,24,43,18,25,0.993,0.883
2011/10/12,1145,7402,24,38,12,26,0.992,0.999
2011/10/12,1245,7398,-4,26,26,0,0.995,1.237
2011/10/12,1345,7388,-9,22,16,6,0.998,1.042
2011/10/13,945,7399,-55,67,61,6,0.998,0.618
2011/10/13,1045,7404,5,40,11,29,0.998,0.838
2011/10/13,1145,7400,-3,32,13,19,0.999,1.23
2011/10/13,1245,7398,-2,30,24,6,0.999,1.216
2011/10/13,1345,7390,-8,22,25,-3,1,1.252
2011/10/14,945,7393,-7,44,4,40,1,0.71
2011/10/14,1045,7373,-19,35,23,12,1.003,1.115
2011/10/14,1145,7372,-1,19,10,9,1.004,1.947
2011/10/14,1245,7385,14,17,2,15,1.001,1.926
2011/10/14,1345,7377,-6,27,8,19,1.002,1.161
2011/10/17,945,7427,-43,56,37,19,0.996,0.695
2011/10/17,1045,7490,62,60,-2,62,0.988,0.684
2011/10/17,1145,7462,-27,34,25,9,0.993,1.1
2011/10/17,1245,7464,2,19,12,7,0.993,1.916
2011/10/17,1345,7453,-11,38,15,23,0.996,0.791
2011/10/18,945,7356,-5,48,33,15,1.008,0.625
2011/10/18,1045,7326,-30,52,39,13,1.012,0.701
2011/10/18,1145,7329,3,24,9,15,1.011,1.365
2011/10/18,1245,7333,5,15,7,8,1.01,2.479
2011/10/18,1345,7337,4,22,12,10,1.008,1.313
2011/10/19,945,7357,15,27,25,2,1.004,1.167
2011/10/19,1045,7364,7,25,1,24,1.002,1.791
2011/10/19,1145,7353,-11,15,17,-2,1.002,2.773
2011/10/19,1245,7337,-16,39,22,17,1.002,1.79
2011/10/20,945,7289,-67,65,67,-2,1.008,0.485
2011/10/20,1045,7272,-17,26,31,-5,1.009,0.858
2011/10/20,1145,7267,-5,25,17,8,1.008,1.004
2011/10/20,1245,7263,-4,30,22,8,1.008,1.251
2011/10/20,1345,7213,-49,54,54,0,1.014,0.599
2011/10/21,945,7244,17,53,2,51,1.008,0.607
2011/10/21,1045,7225,-19,34,22,12,1.01,1.083
2011/10/21,1145,7206,-20,33,25,8,1.011,1.395
2011/10/21,1245,7224,18,31,8,23,1.006,1.529
2011/10/21,1345,7258,34,50,14,36,0.999,0.987
2011/10/24,945,7448,54,68,8,60,0.974,0.502
2011/10/24,1045,7457,9,20,8,12,0.975,1.453
2011/10/24,1145,7469,11,19,-1,20,0.976,1.914
2011/10/24,1245,7470,1,12,6,6,0.979,2.204
2011/10/24,1345,7494,24,36,9,27,0.978,0.773
2011/10/25,945,7495,-4,30,20,10,0.982,0.801
2011/10/25,1045,7490,-6,31,29,2,0.986,1.099
2011/10/25,1145,7487,-2,22,13,9,0.99,1.565
2011/10/25,1245,7504,17,19,3,16,0.991,2.132
2011/10/25,1345,7470,-34,42,35,7,1,1.018
2011/10/26,945,7448,23,53,13,40,1.003,0.608
2011/10/26,1045,7481,32,48,10,38,0.999,0.805
2011/10/26,1145,7475,-6,21,7,14,1,1.508
2011/10/26,1245,7521,46,56,9,47,0.994,0.753
2011/10/26,1345,7547,28,60,26,34,0.991,0.603
2011/10/27,945,7545,-4,46,3,43,0.992,0.604
2011/10/27,1045,7573,28,50,13,37,0.989,0.796
2011/10/27,1145,7570,-3,33,20,13,0.99,1.106
2011/10/27,1245,7590,20,29,13,16,0.989,1.376
2011/10/27,1345,7590,0,22,4,18,0.99,1.179
2011/10/28,945,7719,-6,73,58,15,0.977,0.613
2011/10/28,1045,7660,-59,75,67,8,0.988,0.824
2011/10/28,1145,7665,4,29,15,14,0.99,1.515
2011/10/28,1245,7615,-50,68,69,-1,0.999,1.218
2011/10/28,1345,7628,14,27,10,17,0.999,0.894
2011/10/31,945,7654,5,34,28,6,0.997,0.997
2011/10/31,1045,7621,-34,51,34,17,1.002,1.026
2011/10/31,1145,7591,-30,63,59,4,1.007,0.98
2011/10/31,1245,7591,-1,33,15,18,1.007,1.584
2011/10/31,1345,7561,-30,63,48,15,1.011,0.939
2011/11/1,945,7579,9,62,5,57,1.007,0.712
2011/11/1,1045,7674,97,105,11,94,0.992,0.603
2011/11/1,1145,7644,-30,54,25,29,0.996,1.03
2011/11/1,1245,7640,-3,38,24,14,0.997,1.336
2011/11/1,1345,7637,-3,26,12,14,0.997,1.374
2011/11/2,945,7542,54,103,12,91,1.008,0.578
2011/11/2,1045,7544,4,36,16,20,1.006,1.2
2011/11/2,1145,7568,24,31,-1,32,1.002,1.725
2011/11/2,1245,7604,36,46,6,40,0.997,1.206
2011/11/2,1345,7609,7,38,25,13,0.996,0.948
2011/11/3,945,7502,-63,64,74,-10,1.01,0.716
2011/11/3,1045,7497,-7,43,11,32,1.01,0.881
2011/11/3,1145,7530,31,48,2,46,1.003,1.009
2011/11/3,1245,7473,-57,59,66,-7,1.01,1.555
2011/11/3,1345,7445,-28,56,49,7,1.011,0.957
2011/11/4,945,7647,42,77,3,74,0.986,0.618
2011/11/4,1045,7636,-11,20,12,8,0.989,1.836
2011/11/4,1145,7645,9,31,-1,32,0.989,1.851
2011/11/4,1245,7644,-1,23,21,2,0.99,1.687
2011/11/4,1345,7630,-14,43,26,17,0.992,1.031
2011/11/7,945,7605,-12,54,40,14,0.996,0.959
2011/11/7,1045,7641,35,59,14,45,0.993,1.076
2011/11/7,1145,7633,-9,25,12,13,0.996,1.802
2011/11/7,1245,7628,-6,16,13,3,0.998,2.787
2011/11/7,1345,7635,7,15,2,13,0.999,1.791
2011/11/8,945,7697,66,84,12,72,0.991,0.535
2011/11/8,1045,7629,-68,115,77,38,1.001,0.523
2011/11/8,1145,7632,4,28,11,17,1,1.314
2011/11/8,1245,7608,-23,39,27,12,1.003,1.426
2011/11/8,1345,7590,-18,59,48,11,1.005,0.811
2011/11/9,945,7656,1,34,16,18,0.997,0.848
2011/11/9,1045,7643,-13,27,19,8,0.999,1.38
2011/11/9,1145,7620,-23,44,30,14,1.002,1.118
2011/11/9,1245,7613,-7,35,7,28,1.003,1.241
2011/11/9,1345,7614,3,38,0,38,1.003,1.006
2011/11/10,945,7407,-23,62,47,15,1.028,0.566
2011/11/10,1045,7344,-64,66,73,-7,1.033,0.801
2011/11/10,1145,7317,-28,42,40,2,1.033,0.92
2011/11/10,1245,7309,-8,50,16,34,1.03,1.005
2011/11/10,1345,7318,8,53,26,27,1.024,0.784
2011/11/11,945,7338,21,43,10,33,1.017,0.889
2011/11/11,1045,7344,5,64,8,56,1.012,0.916
2011/11/11,1145,7370,26,44,9,35,1.004,1.159
2011/11/11,1245,7373,3,15,-3,18,1,2.359
2011/11/11,1345,7356,-16,37,28,9,0.999,1.348
2011/11/14,945,7543,50,63,14,49,0.975,0.66
2011/11/14,1045,7551,7,21,6,15,0.976,1.499
2011/11/14,1145,7557,6,15,6,9,0.978,2.35
2011/11/14,1245,7557,-1,20,1,19,0.981,1.888
2011/11/14,1345,7541,-15,27,18,9,0.987,1.204
2011/11/15,945,7519,-9,44,30,14,0.992,0.766
2011/11/15,1045,7514,-5,23,18,5,0.995,1.428
2011/11/15,1145,7516,3,23,8,15,0.997,2.156
2011/11/15,1245,7491,-24,38,34,4,1.003,1.296
2011/11/15,1345,7501,10,26,6,20,1.003,1.226
2011/11/16,945,7515,-19,49,47,2,1.002,0.766
2011/11/16,1045,7403,-113,134,115,19,1.016,0.549
2011/11/16,1145,7403,-2,42,31,11,1.014,1.309
2011/11/16,1245,7417,15,29,19,10,1.01,1.542
2011/11/17,945,7365,32,139,57,82,1.015,0.403
2011/11/17,1045,7370,6,65,18,47,1.012,0.673
2011/11/17,1145,7370,0,50,14,36,1.01,1.016
2011/11/17,1245,7361,-10,29,21,8,1.009,1.564
2011/11/17,1345,7404,44,47,5,42,1.001,1.097
2011/11/18,945,7266,-12,65,52,13,1.017,0.647
2011/11/18,1045,7306,40,80,24,56,1.008,0.848
2011/11/18,1145,7282,-24,45,33,12,1.008,1.293
2011/11/18,1245,7259,-21,53,34,19,1.01,1.113
2011/11/18,1345,7252,-7,28,10,18,1.009,1.104
2011/11/21,945,7104,-82,111,82,29,1.028,0.612
2011/11/21,1045,7087,-17,62,37,25,1.026,1.008
2011/11/21,1145,7074,-15,32,22,10,1.024,1.703
2011/11/21,1245,7110,35,57,4,53,1.015,1.355
2011/11/21,1345,7050,-62,99,65,34,1.02,0.836
2011/11/22,945,7044,-6,69,58,11,1.018,0.685
2011/11/22,1045,7079,36,61,4,57,1.01,0.988
2011/11/22,1145,7035,-44,49,47,2,1.013,1.682
2011/11/22,1245,7014,-18,70,26,44,1.012,0.929
2011/11/22,1345,7023,9,47,35,12,1.007,0.962
2011/11/23,945,6912,-58,86,75,11,1.02,0.595
2011/11/23,1045,6873,-38,74,72,2,1.023,0.845
2011/11/23,1145,6877,4,52,28,24,1.02,1.328
2011/11/23,1245,6864,-14,35,19,16,1.019,1.755
2011/11/23,1345,6818,-46,87,67,20,1.022,0.788
2011/11/24,945,6812,-16,82,35,47,1.02,0.675
2011/11/24,1045,6893,81,85,-5,90,1.004,1.075
2011/11/24,1145,6857,-37,53,46,7,1.007,1.479
2011/11/24,1245,6841,-16,48,25,23,1.007,1.43
2011/11/24,1345,6832,-9,35,32,3,1.005,1.346
2011/11/25,945,6847,-23,130,109,21,1.002,0.54
2011/11/25,1045,6852,5,45,31,14,1,1.188
2011/11/25,1145,6773,-77,110,80,30,1.011,0.825
2011/11/25,1245,6794,20,93,24,69,1.007,0.977
2011/11/25,1345,6757,-36,87,80,7,1.011,1.003
2011/11/28,945,6892,-17,34,14,20,0.993,1.009
2011/11/28,1045,6880,-12,39,14,25,0.996,1.534
2011/11/28,1145,6873,-8,75,52,23,0.996,0.901
2011/11/28,1245,6897,24,40,3,37,0.993,1.864
2011/11/28,1345,6920,23,40,-2,42,0.991,1.46
2011/11/29,945,6938,-27,59,49,10,0.989,0.825
2011/11/29,1045,6928,-8,38,22,16,0.992,1.318
2011/11/29,1145,6955,27,37,0,37,0.989,1.594
2011/11/29,1245,6952,-3,26,16,10,0.992,1.632
2011/11/29,1345,6975,22,48,21,27,0.991,0.839
2011/11/30,945,6906,-37,55,51,4,1.002,0.717
2011/11/30,1045,6904,-2,32,26,6,1.002,1.15
2011/11/30,1145,6846,-58,53,62,-9,1.011,0.902
2011/11/30,1245,6858,14,42,10,32,1.009,0.961
2011/11/30,1345,6903,44,59,0,59,1.002,0.737
2011/12/1,945,7161,-33,34,19,15,0.969,0.832
2011/12/1,1045,7173,12,32,-1,33,0.97,1.56
2011/12/1,1145,7226,53,54,-2,56,0.967,0.954
2011/12/1,1245,7238,11,34,13,21,0.969,1.285
2011/12/1,1345,7210,-27,49,32,17,0.977,1.001
2011/12/2,945,7153,-49,61,61,0,0.988,0.895
2011/12/2,1045,7150,-3,33,28,5,0.992,1.235
2011/12/2,1145,7136,-15,48,28,20,0.997,1.239
2011/12/2,1245,7161,25,49,13,36,0.998,1.193
2011/12/2,1345,7155,-5,25,17,8,1.003,1.43
2011/12/5,945,7054,-111,96,112,-16,1.017,0.687
2011/12/5,1045,7132,78,76,2,74,1.004,0.774
2011/12/5,1145,7120,-12,41,5,36,1.005,1.251
2011/12/5,1245,7132,12,42,13,29,1.002,1.28
2011/12/5,1345,7133,0,32,9,23,1.001,1.349
2011/12/6,945,7039,-47,60,37,23,1.012,0.688
2011/12/6,1045,7011,-30,34,33,1,1.015,1.1
2011/12/6,1145,7004,-7,26,24,2,1.014,1.502
2011/12/6,1245,6988,-16,37,37,0,1.014,1.52
2011/12/6,1345,6985,-3,49,17,32,1.012,0.77
2011/12/7,945,7044,32,37,15,22,1.002,0.752
2011/12/7,1045,7046,2,24,17,7,1.001,1.231
2011/12/7,1145,7015,-32,51,41,10,1.004,0.886
2011/12/7,1245,7023,8,27,16,11,1.002,1.34
2011/12/7,1345,7054,30,46,6,40,0.996,1.05
2011/12/8,945,6941,-74,73,66,7,1.011,0.59
2011/12/8,1045,6933,-8,41,15,26,1.011,0.951
2011/12/8,1145,6948,15,49,16,33,1.007,1.149
2011/12/8,1245,6949,1,27,18,9,1.006,1.575
2011/12/8,1345,6961,13,43,20,23,1.004,0.839
2011/12/9,945,6862,61,100,28,72,1.015,0.695
2011/12/9,1045,6909,47,72,21,51,1.006,0.83
2011/12/9,1145,6840,-69,71,73,-2,1.014,0.858
2011/12/9,1245,6918,78,88,15,73,1,0.839
2011/12/9,1345,6884,-34,57,40,17,1.003,1.083
2011/12/12,945,6975,0,58,41,17,0.99,0.816
2011/12/12,1045,6949,-26,53,39,14,0.994,1.341
2011/12/12,1145,6953,4,31,14,17,0.994,1.95
2011/12/12,1245,6959,5,26,5,21,0.993,1.954
2011/12/12,1345,6943,-16,27,16,11,0.995,1.358
2011/12/13,945,6851,-4,37,23,14,1.01,0.955
2011/12/13,1045,6872,21,40,21,19,1.006,1.097
2011/12/13,1145,6872,-1,27,8,19,1.006,1.687
2011/12/13,1245,6928,57,60,2,58,0.998,0.917
2011/12/13,1345,6897,-31,38,29,9,1.003,1.065
2011/12/14,945,6864,-19,45,41,4,1.006,0.85
2011/12/14,1045,6908,44,54,3,51,0.998,0.864
2011/12/14,1145,6895,-14,21,14,7,0.999,1.61
2011/12/14,1245,6901,7,16,9,7,0.998,2.172
2011/12/14,1345,6919,18,27,6,21,0.994,1.186
2011/12/15,945,6818,-27,48,34,14,1.009,0.583
2011/12/15,1045,6779,-41,51,43,8,1.014,0.769
2011/12/15,1145,6797,19,36,18,18,1.01,1.196
2011/12/15,1245,6790,-6,22,13,9,1.01,1.808
2011/12/15,1345,6751,-39,54,55,-1,1.014,0.789
2011/12/16,945,6775,3,35,12,23,1.009,0.865
2011/12/16,1045,6762,-13,28,12,16,1.009,1.084
2011/12/16,1145,6791,29,44,7,37,1.003,1.173
2011/12/16,1245,6792,1,16,11,5,1.001,1.656
2011/12/16,1345,6775,-17,32,27,5,1.002,1.233
2011/12/19,945,6683,13,74,58,16,1.013,0.565
2011/12/19,1045,6677,-6,40,18,22,1.012,0.917
2011/12/19,1145,6621,-57,67,59,8,1.019,0.698
2011/12/19,1245,6644,24,45,16,29,1.013,1.084
2011/12/19,1345,6637,-9,30,10,20,1.012,0.915
2011/12/20,945,6682,8,31,22,9,1.004,0.813
2011/12/20,1045,6691,10,21,8,13,1.001,1.242
2011/12/20,1145,6693,2,13,6,7,0.999,2.072
2011/12/20,1245,6683,-10,16,12,4,0.999,2.654
2011/12/20,1345,6671,-12,21,15,6,1,1.676
2011/12/21,945,6922,91,98,15,83,0.966,0.619
2011/12/21,1045,6937,11,21,5,16,0.967,2.085
2011/12/21,1145,6948,11,27,12,15,0.969,2.009
2011/12/21,1245,6950,2,9,5,4,0.974,3.814
2011/12/22,945,6967,17,43,12,31,0.976,0.479
2011/12/22,1045,6946,-21,20,21,-1,0.983,1.233
2011/12/22,1145,6965,19,24,3,21,0.984,1.286
2011/12/22,1245,6958,-6,9,8,1,0.989,2.542
2011/12/22,1345,6954,-4,13,11,2,0.993,1.379
2011/12/23,945,7078,30,50,20,30,0.981,0.54
2011/12/23,1045,7097,18,29,10,19,0.982,1.033
2011/12/23,1145,7100,4,19,12,7,0.984,1.331
2011/12/23,1245,7115,15,23,5,18,0.984,1.46
2011/12/23,1345,7107,-8,23,17,6,0.988,0.875
2011/12/26,945,7083,-25,32,26,6,0.993,0.732
2011/12/26,1045,7097,14,27,4,23,0.993,1.212
2011/12/26,1145,7091,-5,13,5,8,0.996,2.43
2011/12/26,1245,7087,-4,8,7,1,0.998,3.511
2011/12/26,1345,7103,17,19,-1,20,0.998,1.214
2011/12/27,945,7051,-44,77,61,16,1.006,0.415
2011/12/27,1045,7057,6,25,8,17,1.004,0.833
2011/12/27,1145,7077,20,36,11,25,1.001,0.925
2011/12/27,1245,7067,-10,21,15,6,1.002,1.592
2011/12/27,1345,7088,20,19,-5,24,0.999,1.089
2011/12/28,945,7071,9,51,17,34,1,0.568
2011/12/28,1045,7068,-3,20,15,5,1.001,1.283
2011/12/28,1145,7063,-5,15,10,5,1.001,1.684
2011/12/28,1245,7067,4,21,5,16,1,1.472
2011/12/28,1345,7052,-14,17,17,0,1.002,1.511
2011/12/29,945,7012,0,25,13,12,1.006,0.676
2011/12/29,1045,7046,34,33,6,27,1.001,0.733
2011/12/29,1145,7070,24,30,4,26,0.997,0.903
2011/12/29,1245,7064,-5,15,12,3,0.998,1.641
2011/12/29,1345,7073,9,14,4,10,0.997,1.053
2011/12/30,945,7080,-18,57,68,-11,0.996,0.489
2011/12/30,1045,7087,7,19,7,12,0.995,0.909
2011/12/30,1145,7069,-19,48,34,14,0.998,0.89
2011/12/30,1245,7080,11,22,4,18,0.997,1.701
2011/12/30,1345,7040,-39,57,57,0,1.003,0.751
2012/1/2,945,7019,-3,46,32,14,1.006,0.833
2012/1/2,1045,6987,-33,59,47,12,1.01,0.83
2012/1/2,1145,6952,-35,44,37,7,1.015,0.921
2012/1/2,1245,6964,12,27,8,19,1.011,1.925
2012/1/2,1345,6949,-15,66,45,21,1.012,0.663
2012/1/3,945,7025,5,26,3,23,1,0.82
2012/1/3,1045,7041,16,31,12,19,0.997,0.916
2012/1/3,1145,7077,36,46,8,38,0.991,0.92
2012/1/3,1245,7077,-1,16,10,6,0.991,2.228
2012/1/3,1345,7049,-29,38,35,3,0.995,0.862
2012/1/4,945,7093,9,40,16,24,0.99,0.687
2012/1/4,1045,7047,-46,59,55,4,0.997,0.75
2012/1/4,1145,7056,9,18,11,7,0.997,1.549
2012/1/4,1245,7060,4,18,9,9,0.998,2.628
2012/1/4,1345,7073,13,22,4,18,0.997,1.096
2012/1/5,945,7078,-10,60,43,17,0.998,0.658
2012/1/5,1045,7076,-4,24,18,6,0.999,1.155
2012/1/5,1145,7091,15,26,7,19,0.997,1.531
2012/1/5,1245,7085,-6,16,13,3,0.998,1.962
2012/1/5,1345,7119,35,46,5,41,0.993,0.835
2012/1/6,945,7110,10,34,7,27,0.995,0.699
2012/1/6,1045,7070,-40,41,44,-3,1.001,0.774
2012/1/6,1145,7086,16,24,3,21,0.999,1.27
2012/1/6,1245,7095,8,27,13,14,0.998,1.479
2012/1/6,1345,7085,-9,33,18,15,1,0.934
2012/1/9,945,7056,9,44,26,18,1.003,0.827
2012/1/9,1045,7070,14,51,7,44,1.001,0.665
2012/1/9,1145,7064,-6,18,11,7,1.002,1.675
2012/1/9,1245,7057,-6,15,11,4,1.002,2.327
2012/1/9,1345,7055,-2,16,11,5,1.002,1.227
2012/1/10,945,7163,43,48,5,43,0.988,0.536
2012/1/10,1045,7165,2,17,7,10,0.988,1.206
2012/1/10,1145,7172,6,15,5,10,0.988,1.797
2012/1/10,1245,7170,-1,17,5,12,0.99,2.051
2012/1/10,1345,7172,2,16,8,8,0.991,0.959
2012/1/11,945,7180,-5,21,8,13,0.991,0.727
2012/1/11,1045,7178,-1,11,6,5,0.993,1.664
2012/1/11,1145,7191,13,18,3,15,0.993,1.931
2012/1/11,1245,7189,-3,12,6,6,0.995,1.943
2012/1/11,1345,7179,-10,18,11,7,0.998,1.121
2012/1/12,945,7172,-13,33,22,11,1,0.706
2012/1/12,1045,7183,10,15,7,8,0.999,1.016
2012/1/12,1145,7179,-4,20,8,12,1,1.301
2012/1/12,1245,7180,1,7,2,5,1,2.827
2012/1/12,1345,7185,5,8,2,6,0.999,1.022
2012/1/13,945,7225,-10,53,38,15,0.994,0.408
2012/1/13,1045,7214,-11,33,19,14,0.996,0.728
2012/1/13,1145,7211,-4,13,10,3,0.997,1.367
2012/1/13,1245,7210,0,18,4,14,0.998,1.185
2012/1/13,1345,7165,-45,65,47,18,1.004,0.517
2012/1/16,945,7102,-134,159,138,21,1.014,0.331
2012/1/16,1045,7097,-5,62,36,26,1.014,0.7
2012/1/16,1145,7100,3,23,1,22,1.012,1.52
2012/1/16,1245,7100,0,22,4,18,1.011,1.735
2012/1/16,1345,7093,-6,29,24,5,1.011,1.06
2012/1/17,945,7143,-9,46,21,25,1.003,0.885
2012/1/17,1045,7154,9,21,4,17,1,1.167
2012/1/17,1145,7185,30,42,9,33,0.995,0.994
2012/1/17,1245,7196,11,17,4,13,0.993,1.897
2012/1/17,1345,7227,31,34,1,33,0.988,1.128
2012/1/18,945,7232,8,27,5,22,0.988,1.24
2012/1/18,1045,7220,-14,24,20,4,0.991,1.864
2012/1/18,1145,7231,11,14,3,11,0.991,2.787
2012/1/18,1245,7195,-37,45,53,-8,0.998,1.383
2012/1/30,945,7424,72,252,24,228,0.971,0.414
2012/1/30,1045,7429,5,17,6,11,0.974,1.585
2012/1/30,1145,7424,-5,21,14,7,0.978,2.046
2012/1/30,1245,7397,-26,48,37,11,0.985,1.02
2012/1/30,1345,7390,-6,24,23,1,0.989,0.995
2012/1/31,945,7463,19,53,12,41,0.983,0.603
2012/1/31,1045,7498,35,50,2,48,0.981,0.846
2012/1/31,1145,7472,-25,29,31,-2,0.988,1.27
2012/1/31,1245,7462,-11,42,10,32,0.993,0.884
2012/1/31,1345,7467,5,61,31,30,0.995,0.874
2012/2/1,945,7497,5,54,33,21,0.993,0.591
2012/2/1,1045,7529,33,40,9,31,0.99,0.863
2012/2/1,1145,7529,0,25,4,21,0.991,1.548
2012/2/1,1245,7534,5,28,14,14,0.992,1.428
2012/2/1,1345,7522,-12,19,13,6,0.995,1.274
2012/2/2,945,7606,-14,36,26,10,0.987,0.85
2012/2/2,1045,7594,-13,32,26,6,0.99,1.193
2012/2/2,1145,7583,-9,28,11,17,0.993,1.078
2012/2/2,1245,7590,7,21,7,14,0.993,2.028
2012/2/2,1345,7642,53,65,8,57,0.988,0.719
2012/2/3,945,7615,-5,30,17,13,0.994,0.936
2012/2/3,1045,7620,5,29,24,5,0.994,0.955
2012/2/3,1145,7642,22,35,6,29,0.993,1.224
2012/2/3,1245,7637,-6,19,9,10,0.995,1.901
2012/2/3,1345,7642,5,29,8,21,0.996,0.93
2012/2/4,945,7737,17,57,13,44,0.985,0.727
2012/2/4,1045,7731,-6,40,12,28,0.987,1.088
2012/2/4,1145,7733,3,24,9,15,0.989,1.968
2012/2/4,1245,7740,7,27,8,19,0.99,1.834
2012/2/4,1345,7735,-5,34,23,11,0.992,0.903
2012/2/6,945,7682,-24,36,29,7,1,0.608
2012/2/6,1045,7683,-1,27,12,15,1.001,1.039
2012/2/6,1145,7706,23,28,6,22,0.999,1.184
2012/2/6,1245,7679,-27,45,45,0,1.003,0.993
2012/2/6,1345,7685,6,19,6,13,1.003,1.068
2012/2/7,945,7736,30,46,-8,54,0.996,0.617
2012/2/7,1045,7698,-38,51,52,-1,1.001,0.715
2012/2/7,1145,7685,-13,39,29,10,1.002,0.91
2012/2/7,1245,7709,24,40,6,34,0.999,1.274
2012/2/7,1345,7722,14,20,0,20,0.997,1.253
2012/2/8,945,7805,39,32,-8,40,0.987,0.667
2012/2/8,1045,7814,9,33,14,19,0.987,0.927
2012/2/8,1145,7828,13,26,9,17,0.987,1.539
2012/2/8,1245,7837,9,26,11,15,0.987,1.244
2012/2/8,1345,7890,52,60,5,55,0.983,0.641
2012/2/9,945,7835,-25,35,31,4,0.992,0.707
2012/2/9,1045,7882,47,43,-4,47,0.987,1.133
2012/2/9,1145,7872,-10,32,22,10,0.991,1.042
2012/2/9,1245,7873,1,33,11,22,0.993,1.334
2012/2/9,1345,7923,50,61,10,51,0.989,0.903
2012/2/10,945,7886,10,48,42,6,0.995,0.757
2012/2/10,1045,7887,0,33,-1,34,0.996,0.835
2012/2/10,1145,7867,-20,29,25,4,0.999,1.633
2012/2/10,1245,7863,-4,33,20,13,1,1.689
2012/2/10,1345,7866,4,29,14,15,1,1.152
2012/2/13,945,7854,-21,38,25,13,1.002,0.839
2012/2/13,1045,7896,42,52,10,42,0.997,0.901
2012/2/13,1145,7924,28,44,11,33,0.993,1.005
2012/2/13,1245,7914,-9,32,21,11,0.995,1.371
2012/2/13,1345,7907,-7,32,30,2,0.997,1.044
2012/2/14,945,7853,-52,43,61,-18,1.004,0.799
2012/2/14,1045,7847,-6,58,18,40,1.004,0.631
2012/2/14,1145,7865,17,37,10,27,1.001,1.147
2012/2/14,1245,7895,29,50,10,40,0.998,1.184
2012/2/14,1345,7874,-21,35,23,12,1.001,1.134
2012/2/15,945,7911,-13,33,12,21,0.997,1.279
2012/2/15,1045,7960,50,61,7,54,0.991,1.025
2012/2/15,1145,7967,8,29,16,13,0.991,1.757
2012/2/15,1245,7975,7,24,10,14,0.991,3.432
2012/2/16,945,7972,4,47,38,9,0.992,0.595
2012/2/16,1045,7967,-6,39,27,12,0.993,1.004
2012/2/16,1145,7964,-2,23,1,22,0.995,1.082
2012/2/16,1245,7923,-40,37,44,-7,1.002,1.024
2012/2/16,1345,7906,-17,64,25,39,1.004,0.584
2012/2/17,945,7970,-12,48,51,-3,0.997,0.58
2012/2/17,1045,7914,-56,55,67,-12,1.005,0.772
2012/2/17,1145,7892,-20,55,43,12,1.008,0.778
2012/2/17,1245,7897,5,50,39,11,1.006,1.152
2012/2/17,1345,7932,34,45,2,43,1.001,1.091
2012/2/20,945,7945,-44,72,59,13,1,0.889
2012/2/20,1045,7944,-1,29,12,17,1,1.468
2012/2/20,1145,7978,34,43,-2,45,0.995,1.583
2012/2/20,1245,7964,-13,38,17,21,0.997,1.729
2012/2/20,1345,7956,-7,24,14,10,0.998,1.601
2012/2/21,945,7937,-17,43,38,5,1,0.773
2012/2/21,1045,7863,-74,84,75,9,1.009,0.595
2012/2/21,1145,7885,22,66,44,22,1.006,0.656
2012/2/21,1245,7887,2,25,10,15,1.006,1.623
2012/2/21,1345,7947,60,58,0,58,0.998,0.991
2012/2/22,945,7913,-5,47,23,24,1.001,0.809
2012/2/22,1045,7999,86,99,13,86,0.99,0.625
2012/2/22,1145,8027,29,51,9,42,0.987,1.07
2012/2/22,1245,8013,-16,31,23,8,0.99,1.72
2012/2/22,1345,8004,-9,28,21,7,0.991,1.256
2012/2/23,945,7959,-1,34,16,18,0.997,0.995
2012/2/23,1045,7986,28,32,-4,36,0.994,1.684
2012/2/23,1145,7972,-14,28,19,9,0.997,1.661
2012/2/23,1245,7948,-24,20,24,-4,1.001,1.887
2012/2/23,1345,7963,15,15,2,13,1,1.666
2012/2/24,945,7905,-40,73,70,3,1.008,0.726
2012/2/24,1045,7933,28,57,7,50,1.004,0.702
2012/2/24,1145,7932,-1,28,3,25,1.004,1.376
2012/2/24,1245,7944,12,40,24,16,1.001,0.922
2012/2/24,1345,7941,-3,35,17,18,1,0.927
2012/2/29,945,8067,61,68,12,56,0.985,0.589
2012/2/29,1045,8107,40,50,1,49,0.982,0.899
2012/2/29,1145,8107,-2,18,8,10,0.983,1.894
2012/2/29,1245,8102,-4,21,15,6,0.986,2.115
2012/2/29,1345,8114,12,28,12,16,0.986,0.914
2012/3/1,945,8146,3,50,18,32,0.985,0.736
2012/3/1,1045,8156,9,32,18,14,0.986,1.19
2012/3/1,1145,8154,-2,31,6,25,0.989,1.308
2012/3/1,1245,8153,0,34,24,10,0.992,1.462
2012/3/1,1345,8138,-15,31,24,7,0.997,1.179
2012/3/2,945,8162,-18,43,25,18,0.996,0.843
2012/3/2,1045,8141,-22,44,35,9,1,0.875
2012/3/2,1145,8147,6,32,-3,35,0.999,0.975
2012/3/2,1245,8140,-7,21,7,14,1.001,2.083
2012/3/2,1345,8152,12,20,3,17,1,1.187
2012/3/3,945,8111,-19,36,11,25,1.004,0.806
2012/3/3,1045,8115,3,32,12,20,1.004,1.302
2012/3/3,1145,8112,-3,12,8,4,1.003,3.656
2012/3/3,1245,8116,3,15,6,9,1.002,2.65
2012/3/3,1345,8120,4,15,6,9,1.001,1.739
2012/3/5,945,8048,-53,65,53,12,1.009,0.396
2012/3/5,1045,8029,-19,36,31,5,1.01,0.682
2012/3/5,1145,8030,1,16,2,14,1.009,1.121
2012/3/5,1245,8032,2,20,3,17,1.007,1.469
2012/3/5,1345,8040,7,35,-2,37,1.005,0.667
2012/3/6,945,7943,-77,99,91,8,1.016,0.427
2012/3/6,1045,7909,-33,46,40,6,1.018,0.663
2012/3/6,1145,7905,-4,27,23,4,1.016,1.25
2012/3/6,1245,7896,-9,41,16,25,1.014,1.138
2012/3/6,1345,7946,50,58,4,54,1.005,0.771
2012/3/7,945,7895,41,72,17,55,1.009,0.654
2012/3/7,1045,7919,24,37,-4,41,1.004,1.265
2012/3/7,1145,7912,-7,20,17,3,1.003,1.718
2012/3/7,1245,7901,-11,36,10,26,1.003,1.481
2012/3/7,1345,7895,-6,22,14,8,1.002,1.627
2012/3/8,945,7896,-42,36,44,-8,1.001,0.945
2012/3/8,1045,7918,22,42,7,35,0.998,1.058
2012/3/8,1145,7993,75,87,7,80,0.988,0.671
2012/3/8,1245,7984,-9,24,15,9,0.991,1.77
2012/3/8,1345,7976,-10,22,22,0,0.993,1.29
2012/3/9,945,7976,-14,52,18,34,0.994,0.698
2012/3/9,1045,7986,10,71,41,30,0.994,0.646
2012/3/9,1145,8003,16,29,6,23,0.993,1.427
2012/3/9,1245,8014,10,29,8,21,0.993,1.489
2012/3/9,1345,8005,-9,28,25,3,0.995,1.283
2012/3/12,945,7985,-13,35,23,12,0.998,0.919
2012/3/12,1045,7957,-28,45,40,5,1.003,1.068
2012/3/12,1145,7977,21,28,4,24,1.001,1.647
2012/3/12,1245,7966,-11,20,13,7,1.002,2.44
2012/3/12,1345,7921,-44,57,44,13,1.008,0.72
2012/3/13,945,7998,31,58,27,31,0.998,0.56
2012/3/13,1045,8062,64,67,-5,72,0.99,0.653
2012/3/13,1145,8054,-8,16,0,16,0.992,1.705
2012/3/13,1245,8052,-2,18,10,8,0.993,1.904
2012/3/13,1345,8033,-19,29,26,3,0.996,0.957
2012/3/14,945,8166,12,30,22,8,0.981,0.675
2012/3/14,1045,8168,4,15,10,5,0.983,1.747
2012/3/14,1145,8146,-22,44,30,14,0.988,1.141
2012/3/14,1245,8142,-4,19,9,10,0.991,2.68
2012/3/14,1345,8142,0,17,11,6,0.993,1.327
2012/3/15,945,8153,13,44,5,39,0.994,0.779
2012/3/15,1045,8123,-31,58,25,33,1,0.677
2012/3/15,1145,8131,8,25,10,15,0.999,1.459
2012/3/15,1245,8141,10,26,3,23,0.999,1.67
2012/3/15,1345,8134,-6,15,8,7,1.001,1.328
2012/3/16,945,8132,2,42,-5,47,1.001,0.582
2012/3/16,1045,8118,-13,27,11,16,1.002,1.317
2012/3/16,1145,8109,-9,21,8,13,1.003,1.389
2012/3/16,1245,8106,-3,14,11,3,1.003,2.469
2012/3/16,1345,8064,-42,52,46,6,1.007,0.672
2012/3/19,945,8035,-78,97,81,16,1.011,0.506
2012/3/19,1045,8017,-18,32,18,14,1.012,0.738
2012/3/19,1145,8035,18,71,8,63,1.008,0.718
2012/3/19,1245,8035,0,25,13,12,1.007,1.534
2012/3/19,1345,8053,18,51,-1,52,1.003,1.028
2012/3/20,945,8031,-46,51,41,10,1.005,0.84
2012/3/20,1045,7987,-45,52,47,5,1.01,0.779
2012/3/20,1145,7996,9,41,17,24,1.007,1.107
2012/3/20,1245,7982,-14,28,22,6,1.007,1.98
2012/3/20,1345,7984,1,40,8,32,1.005,1.006
2012/3/21,945,7978,12,48,38,10,1.004,1.005
2012/3/21,1045,7990,12,37,12,25,1.002,1.704
2012/3/21,1145,7967,-23,31,25,6,1.005,1.689
2012/3/21,1245,7984,18,40,7,33,1.002,1.604
2012/3/22,945,8071,62,118,19,99,0.991,0.409
2012/3/22,1045,8070,-1,35,25,10,0.991,0.949
2012/3/22,1145,8049,-22,31,27,4,0.994,1.209
2012/3/22,1245,8075,26,32,3,29,0.991,1.92
2012/3/22,1345,8084,9,22,2,20,0.991,1.343
2012/3/23,945,8065,-36,38,31,7,0.995,0.765
2012/3/23,1045,8067,2,26,10,16,0.996,1.352
2012/3/23,1145,8069,3,14,6,8,0.997,2.21
2012/3/23,1245,8067,-3,13,12,1,0.998,3.009
2012/3/23,1345,8080,13,22,4,18,0.998,1.295
2012/3/26,945,7990,-91,116,92,24,1.01,0.356
2012/3/26,1045,7950,-40,54,46,8,1.014,0.651
2012/3/26,1145,7954,4,18,6,12,1.012,1.659
2012/3/26,1245,7964,11,34,8,26,1.009,1.307
2012/3/26,1345,7958,-6,25,10,15,1.009,1.074
2012/3/27,945,7978,-22,34,29,5,1.005,0.719
2012/3/27,1045,8015,38,44,3,41,0.999,1.115
2012/3/27,1145,7995,-20,29,20,9,1.001,1.723
2012/3/27,1245,8004,9,20,3,17,0.999,2.519
2012/3/27,1345,8010,4,21,11,10,0.997,1.293
2012/3/28,945,8023,8,78,56,22,0.995,0.472
2012/3/28,1045,8035,14,36,-3,39,0.994,0.909
2012/3/28,1145,8024,-10,16,13,3,0.996,1.891
2012/3/28,1245,8018,-6,21,16,5,0.998,1.989
2012/3/28,1345,8030,12,16,-1,17,0.997,1.424
2012/3/29,945,7903,-95,114,103,11,1.013,0.394
2012/3/29,1045,7882,-19,48,22,26,1.015,0.689
2012/3/29,1145,7877,-5,21,14,7,1.014,1.879
2012/3/29,1245,7847,-30,64,37,27,1.016,0.939
2012/3/29,1345,7845,-3,39,30,9,1.014,0.901
2012/3/30,945,7839,29,74,21,53,1.013,0.525
2012/3/30,1045,7851,12,38,25,13,1.009,1.089
2012/3/30,1145,7850,0,16,8,8,1.006,2.8
2012/3/30,1245,7877,28,26,3,23,1.001,2.096
2012/3/30,1345,7883,6,36,24,12,0.998,1.136
2012/4/2,945,7888,0,62,16,46,0.996,0.771
2012/4/2,1045,7854,-35,51,32,19,1,1.117
2012/4/2,1145,7875,21,42,3,39,0.997,1.7
2012/4/2,1245,7874,-1,20,11,9,0.997,1.961
2012/4/2,1345,7866,-8,19,14,5,0.999,1.606
2012/4/3,945,7836,-53,73,83,-10,1.004,0.543
2012/4/3,1045,7804,-33,57,35,22,1.008,0.573
2012/4/3,1145,7759,-46,51,54,-3,1.013,1.007
2012/4/3,1245,7756,-4,44,27,17,1.012,0.956
2012/4/3,1345,7780,25,46,2,44,1.008,0.781
2012/4/5,945,7549,-102,111,85,26,1.035,0.489
2012/4/5,1045,7656,107,106,-8,114,1.016,0.727
2012/4/5,1145,7624,-32,35,26,9,1.018,1.521
2012/4/5,1245,7631,6,40,14,26,1.014,1.787
2012/4/5,1345,7618,-13,33,35,-2,1.012,1.408
2012/4/6,945,7647,7,48,14,34,1.005,0.821
2012/4/6,1045,7673,26,55,15,40,0.999,1.132
2012/4/6,1145,7667,-6,20,9,11,0.998,2.707
2012/4/6,1245,7660,-5,17,3,14,0.998,2.287
2012/4/6,1345,7673,13,27,13,14,0.995,1.34
2012/4/9,945,7596,24,95,2,93,1.004,0.518
2012/4/9,1045,7598,2,32,9,23,1.005,1.278
2012/4/9,1145,7603,5,42,30,12,1.003,1.111
2012/4/9,1245,7594,-9,46,29,17,1.004,1.411
2012/4/9,1345,7577,-17,26,22,4,1.006,1.418
2012/4/10,945,7676,43,60,7,53,0.993,0.606
2012/4/10,1045,7658,-18,22,16,6,0.995,1.353
2012/4/10,1145,7626,-31,38,38,0,0.999,1.164
2012/4/10,1245,7600,-28,46,25,21,1.002,0.839
2012/4/10,1345,7609,10,30,18,12,1,1.069
2012/4/11,945,7592,81,88,20,68,1.002,0.531
2012/4/11,1045,7625,32,64,7,57,0.997,0.844
2012/4/11,1145,7627,3,34,16,18,0.998,1.363
2012/4/11,1245,7642,14,30,6,24,0.996,1.56
2012/4/11,1345,7641,-1,19,6,13,0.997,1.256
2012/4/12,945,7629,19,75,14,61,0.998,0.518
2012/4/12,1045,7619,-10,58,29,29,0.999,0.982
2012/4/12,1145,7636,17,32,-1,33,0.996,1.803
2012/4/12,1245,7635,-1,19,9,10,0.996,1.98
2012/4/12,1345,7636,2,20,10,10,0.996,1.591
2012/4/13,945,7755,54,75,5,70,0.984,0.493
2012/4/13,1045,7722,-33,37,43,-6,0.99,1.005
2012/4/13,1145,7734,12,23,9,14,0.99,1.952
2012/4/13,1245,7738,4,17,14,3,0.99,2.269
2012/4/13,1345,7756,18,39,10,29,0.989,1.153
2012/4/16,945,7727,27,41,-3,44,0.994,0.739
2012/4/16,1045,7715,-13,20,13,7,0.997,1.528
2012/4/16,1145,7715,0,17,8,9,0.998,2.353
2012/4/16,1245,7713,-2,11,8,3,1,3.304
2012/4/16,1345,7712,-1,12,8,4,1.001,1.418
2012/4/17,945,7648,-60,114,91,23,1.009,0.388
2012/4/17,1045,7646,0,65,32,33,1.008,0.595
2012/4/17,1145,7628,-17,35,19,16,1.009,1.11
2012/4/17,1245,7603,-25,42,27,15,1.011,1.167
2012/4/17,1345,7592,-11,28,21,7,1.011,0.945
2012/4/18,945,7647,-43,59,38,21,1.004,0.866
2012/4/18,1045,7620,-28,38,31,7,1.006,1.793
2012/4/18,1145,7637,17,42,4,38,1.003,1.365
2012/4/18,1245,7633,-3,22,5,17,1.002,3.105
2012/4/19,945,7608,17,134,36,98,1.004,0.38
2012/4/19,1045,7625,19,54,0,54,1,1.058
2012/4/19,1145,7613,-12,20,11,9,1.002,1.598
2012/4/19,1245,7591,-21,36,26,10,1.004,1.806
2012/4/19,1345,7614,24,24,2,22,1.001,1.609
2012/4/20,945,7560,-21,58,39,19,1.007,0.584
2012/4/20,1045,7551,-11,42,27,15,1.007,1.059
2012/4/20,1145,7556,4,17,6,11,1.005,2.495
2012/4/20,1245,7521,-34,44,36,8,1.009,1.155
2012/4/20,1345,7515,-5,32,6,26,1.008,0.811
2012/4/23,945,7467,-32,59,42,17,1.013,0.515
2012/4/23,1045,7438,-28,58,36,22,1.015,0.808
2012/4/23,1145,7471,34,55,19,36,1.008,1.044
2012/4/23,1245,7453,-18,37,25,12,1.009,2.091
2012/4/23,1345,7479,25,30,1,29,1.004,1.662
2012/4/24,945,7491,40,48,4,44,1,0.643
2012/4/24,1045,7511,19,45,23,22,0.997,0.817
2012/4/24,1145,7451,-61,82,65,17,1.004,0.731
2012/4/24,1245,7463,12,32,5,27,1.001,1.536
2012/4/24,1345,7488,24,40,8,32,0.997,1.251
2012/4/25,945,7545,1,58,28,30,0.99,0.641
2012/4/25,1045,7530,-13,41,21,20,0.993,1.149
2012/4/25,1145,7548,16,20,2,18,0.992,2.002
2012/4/25,1245,7543,-6,20,8,12,0.994,2.712
2012/4/25,1345,7539,-4,13,11,2,0.995,1.785
2012/4/26,945,7533,-44,67,50,17,0.998,0.655
2012/4/26,1045,7538,3,48,14,34,0.998,0.832
2012/4/26,1145,7533,-6,37,20,17,0.999,1.148
2012/4/26,1245,7492,-40,49,43,6,1.005,1.109
2012/4/26,1345,7493,1,26,13,13,1.006,0.999
2012/4/27,945,7501,-45,58,60,-2,1.005,0.581
2012/4/27,1045,7462,-40,59,42,17,1.009,0.687
2012/4/27,1145,7466,3,23,10,13,1.008,1.825
2012/4/27,1245,7464,-3,44,38,6,1.007,0.996
2012/4/27,1345,7446,-18,37,26,11,1.008,0.967
2012/4/30,945,7446,2,58,7,51,1.007,0.693
2012/4/30,1045,7428,-18,34,21,13,1.008,1.768
2012/4/30,1145,7444,16,25,3,22,1.004,2.185
2012/4/30,1245,7442,-2,28,21,7,1.003,1.742
2012/4/30,1345,7464,22,24,5,19,1,1.526
2012/5/2,945,7589,93,89,-6,95,0.982,0.485
2012/5/2,1045,7597,8,18,9,9,0.983,1.226
2012/5/2,1145,7634,37,43,5,38,0.98,1.199
2012/5/2,1245,7662,30,48,16,32,0.978,1.19
2012/5/2,1345,7678,16,26,5,21,0.979,0.868
2012/5/3,945,7651,-25,37,24,13,0.985,0.793
2012/5/3,1045,7653,1,17,15,2,0.988,1.56
2012/5/3,1145,7643,-10,26,18,8,0.992,1.85
2012/5/3,1245,7643,0,15,11,4,0.994,2.991
2012/5/3,1345,7657,15,20,0,20,0.995,1.771
2012/5/4,945,7655,40,79,7,72,0.997,0.466
2012/5/4,1045,7640,-15,40,38,2,1,0.815
2012/5/4,1145,7665,25,32,8,24,0.997,1.597
2012/5/4,1245,7672,8,29,13,16,0.997,1.508
2012/5/4,1345,7662,-10,30,19,11,0.998,0.855
2012/5/7,945,7521,-36,73,57,16,1.015,0.406
2012/5/7,1045,7502,-19,26,21,5,1.016,0.981
2012/5/7,1145,7502,2,18,8,10,1.014,1.905
2012/5/7,1245,7508,7,22,5,17,1.011,2.515
2012/5/7,1345,7500,-8,18,16,2,1.011,1.184
2012/5/8,945,7512,-8,38,33,5,1.008,0.794
2012/5/8,1045,7515,4,30,8,22,1.005,1.036
2012/5/8,1145,7510,-6,22,15,7,1.004,1.935
2012/5/8,1245,7519,10,16,3,13,1.001,2.854
2012/5/8,1345,7523,4,14,6,8,0.999,1.598
2012/5/9,945,7463,-5,73,27,46,1.005,0.369
2012/5/9,1045,7469,5,26,14,12,1.004,1.226
2012/5/9,1145,7449,-21,34,21,13,1.006,0.906
2012/5/9,1245,7460,11,34,2,32,1.004,1.352
2012/5/9,1345,7460,0,27,14,13,1.003,1.043
2012/5/10,945,7475,50,36,5,31,1,0.653
2012/5/10,1045,7484,10,46,32,14,0.998,0.707
2012/5/10,1145,7457,-28,49,34,15,1.002,0.784
2012/5/10,1245,7466,9,17,7,10,1,2.116
2012/5/10,1345,7482,16,18,1,17,0.997,1.594
2012/5/11,945,7371,-87,90,84,6,1.012,0.431
2012/5/11,1045,7392,21,32,8,24,1.008,1.289
2012/5/11,1145,7370,-21,31,19,12,1.009,1.274
2012/5/11,1245,7363,-6,20,13,7,1.009,2.454
2012/5/11,1345,7367,5,22,18,4,1.007,1.043
2012/5/14,945,7374,-2,40,24,16,1.006,0.824
2012/5/14,1045,7352,-21,45,20,25,1.007,0.81
2012/5/14,1145,7367,14,25,6,19,1.004,1.44
2012/5/14,1245,7374,7,18,11,7,1.001,1.902
2012/5/14,1345,7369,-5,14,10,4,1.001,2.135
2012/5/15,945,7326,21,52,16,36,1.005,0.533
2012/5/15,1045,7341,15,40,23,17,1.002,0.839
2012/5/15,1145,7338,-2,20,12,8,1.002,1.608
2012/5/15,1245,7380,41,52,12,40,0.996,1.019
2012/5/15,1345,7385,5,31,21,10,0.995,1.026
2012/5/16,945,7350,-6,53,36,17,1,0.801
2012/5/16,1045,7346,-4,36,18,18,1,1.341
2012/5/16,1145,7307,-40,55,44,11,1.005,1.183
2012/5/16,1245,7298,-8,34,12,22,1.006,1.284
2012/5/17,945,7280,14,50,20,30,1.007,0.499
2012/5/17,1045,7281,1,29,-1,30,1.006,1.096
2012/5/17,1145,7298,17,36,12,24,1.003,0.956
2012/5/17,1245,7330,30,33,0,33,0.998,1.243
2012/5/17,1345,7316,-13,20,17,3,1,1.099
2012/5/18,945,7218,54,57,-13,70,1.011,0.536
2012/5/18,1045,7166,-52,67,64,3,1.016,0.782
2012/5/18,1145,7171,5,31,17,14,1.013,1.401
2012/5/18,1245,7164,-6,28,19,9,1.011,1.618
2012/5/18,1345,7131,-33,37,34,3,1.014,0.861
2012/5/21,945,7199,20,49,6,43,1.003,0.689
2012/5/21,1045,7183,-16,38,26,12,1.004,1.245
2012/5/21,1145,7193,10,27,12,15,1.001,2.059
2012/5/21,1245,7184,-9,28,23,5,1.001,2.205
2012/5/21,1345,7188,5,18,8,10,0.999,1.732
2012/5/22,945,7223,-27,45,33,12,0.995,0.73
2012/5/22,1045,7213,-11,23,12,11,0.996,1.081
2012/5/22,1145,7224,11,17,0,17,0.996,2.188
2012/5/22,1245,7237,14,28,8,20,0.995,1.205
2012/5/22,1345,7237,1,10,7,3,0.996,1.513
2012/5/23,945,7116,-35,73,47,26,1.012,0.442
2012/5/23,1045,7135,18,60,35,25,1.008,0.732
2012/5/23,1145,7126,-9,25,13,12,1.009,1.355
2012/5/23,1245,7124,-1,23,8,15,1.008,1.685
2012/5/23,1345,7137,13,23,-2,25,1.005,1.331
2012/5/24,945,7166,10,35,12,23,1,0.685
2012/5/24,1045,7156,-10,23,12,11,1.001,1.141
2012/5/24,1145,7103,-53,71,55,16,1.007,0.743
2012/5/24,1245,7083,-20,30,31,-1,1.009,1.164
2012/5/24,1345,7131,48,49,1,48,1,0.892
2012/5/25,945,7103,-52,51,50,1,1.004,0.729
2012/5/25,1045,7078,-25,42,30,12,1.007,0.732
2012/5/25,1145,7062,-16,28,19,9,1.008,1.212
2012/5/25,1245,7062,-2,35,23,12,1.008,1.279
2012/5/25,1345,7056,-6,29,21,8,1.008,0.999
2012/5/28,945,7092,20,76,9,67,1.001,0.705
2012/5/28,1045,7074,-18,27,22,5,1.003,1.819
2012/5/28,1145,7081,7,24,14,10,1.001,2.289
2012/5/28,1245,7120,39,54,7,47,0.995,1.093
2012/5/28,1345,7116,-4,21,17,4,0.996,1.263
2012/5/29,945,7251,127,155,9,146,0.977,0.399
2012/5/29,1045,7285,34,18,-1,19,0.974,1.086
2012/5/29,1145,7297,12,25,3,22,0.976,1.88
2012/5/29,1245,7322,24,47,14,33,0.975,1.135
2012/5/29,1345,7292,-30,39,38,1,0.983,0.975
2012/5/30,945,7217,-53,54,50,4,0.996,0.605
2012/5/30,1045,7206,-11,30,20,10,0.999,1.192
2012/5/30,1145,7211,6,30,17,13,1,1.845
2012/5/30,1245,7245,35,43,0,43,0.997,1.541
2012/5/30,1345,7234,-11,24,17,7,1.001,1.19
2012/5/31,945,7120,-22,75,40,35,1.017,0.521
2012/5/31,1045,7134,14,54,36,18,1.013,0.967
2012/5/31,1145,7131,-3,27,26,1,1.011,1.837
2012/5/31,1245,7194,63,67,2,65,1,1.156
2012/5/31,1345,7216,21,72,39,33,0.995,0.675
2012/6/1,945,7122,-78,102,72,30,1.008,0.48
2012/6/1,1045,7182,58,70,-4,74,0.998,0.977
2012/6/1,1145,7130,-52,47,47,0,1.005,1.281
2012/6/1,1245,7112,-17,27,27,0,1.006,1.735
2012/6/1,1345,7100,-13,40,15,25,1.006,0.877
2012/6/4,945,6886,-41,64,44,20,1.034,0.62
2012/6/4,1045,6910,25,50,10,40,1.027,1.348
2012/6/4,1145,6873,-38,65,44,21,1.03,1.297
2012/6/4,1245,6842,-31,40,33,7,1.03,1.706
2012/6/4,1345,6866,24,56,22,34,1.022,0.932
2012/6/5,945,6991,42,53,14,39,1,0.719
2012/6/5,1045,6996,3,43,-1,44,0.997,1.154
2012/6/5,1145,6931,-65,44,63,-19,1.004,1.531
2012/6/5,1245,6960,29,32,5,27,0.997,1.559
2012/6/5,1345,6973,14,21,14,7,0.993,1.266
2012/6/6,945,7001,12,65,22,43,0.99,0.726
2012/6/6,1045,7053,51,54,-4,58,0.984,0.774
2012/6/6,1145,7038,-15,43,15,28,0.988,1.175
2012/6/6,1245,7028,-11,24,20,4,0.992,1.908
2012/6/6,1345,7013,-15,30,29,1,0.997,1.291
2012/6/7,945,7092,-43,76,54,22,0.988,0.597
2012/6/7,1045,7046,-45,42,49,-7,0.996,1.13
2012/6/7,1145,7038,-9,25,24,1,0.998,1.785
2012/6/7,1245,7030,-8,36,33,3,1.001,1.632
2012/6/7,1345,7045,15,31,6,25,1,1.057
2012/6/8,945,6992,-15,74,48,26,1.007,0.56
2012/6/8,1045,6973,-20,44,25,19,1.01,0.817
2012/6/8,1145,6967,-7,30,21,9,1.01,1.49
2012/6/8,1245,6953,-14,26,21,5,1.011,1.855
2012/6/8,1345,6953,1,21,14,7,1.01,1.219
2012/6/11,945,7081,-9,69,55,14,0.991,0.47
2012/6/11,1045,7083,3,27,5,22,0.99,1.318
2012/6/11,1145,7081,-3,27,5,22,0.991,1.997
2012/6/11,1245,7086,5,24,10,14,0.991,2.38
2012/6/11,1345,7093,7,25,9,16,0.991,1.346
2012/6/12,945,7021,45,58,8,50,1.001,0.701
2012/6/12,1045,7016,-5,25,10,15,1.002,1.278
2012/6/12,1145,7010,-6,27,8,19,1.003,1.334
2012/6/12,1245,7025,15,26,13,13,1.002,1.309
2012/6/12,1345,7019,-7,28,18,10,1.003,1.201
2012/6/13,945,7048,-1,41,22,19,0.999,0.607
2012/6/13,1045,7021,-25,40,21,19,1.002,0.686
2012/6/13,1145,7022,1,19,10,9,1.001,1.654
2012/6/13,1245,7025,2,15,11,4,1,1.958
2012/6/13,1345,7050,24,28,2,26,0.995,1.026
2012/6/14,945,7060,18,42,15,27,0.995,0.687
2012/6/14,1045,7058,-2,23,6,17,0.996,1.624
2012/6/14,1145,7097,39,50,4,46,0.991,0.931
2012/6/14,1245,7093,-4,21,14,7,0.993,1.372
2012/6/14,1345,7067,-26,39,29,10,0.997,0.851
2012/6/15,945,7120,70,65,-6,71,0.99,0.605
2012/6/15,1045,7130,10,34,13,21,0.99,0.76
2012/6/15,1145,7132,2,17,7,10,0.991,1.675
2012/6/15,1245,7132,-1,29,13,16,0.992,1.438
2012/6/15,1345,7158,26,19,-6,25,0.99,0.838
2012/6/18,945,7250,-50,77,73,4,0.981,0.577
2012/6/18,1045,7269,20,39,14,25,0.981,1.141
2012/6/18,1145,7281,12,25,6,19,0.983,1.812
2012/6/18,1245,7268,-13,22,20,2,0.987,2.3
2012/6/18,1345,7264,-4,19,19,0,0.99,1.346
2012/6/19,945,7241,-25,36,29,7,0.996,0.714
2012/6/19,1045,7252,11,19,8,11,0.996,1.43
2012/6/19,1145,7247,-5,13,11,2,0.998,2.239
2012/6/19,1245,7244,-3,11,6,5,1,2.135
2012/6/19,1345,7267,23,28,0,28,0.999,1.052
2012/6/20,945,7291,-2,35,29,6,0.995,0.674
2012/6/20,1045,7291,0,18,8,10,0.996,1.745
2012/6/20,1145,7294,3,8,0,8,0.996,3
2012/6/20,1245,7303,10,17,9,8,0.995,1.313
2012/6/21,945,7149,-11,176,163,13,1.015,0.459
2012/6/21,1045,7110,-38,45,43,2,1.019,0.611
2012/6/21,1145,7113,1,18,4,14,1.016,0.879
2012/6/21,1245,7103,-9,21,11,10,1.016,1.544
2012/6/21,1345,7116,14,23,8,15,1.012,0.809
2012/6/22,945,7027,25,42,10,32,1.021,0.474
2012/6/22,1045,7041,15,27,4,23,1.016,1.081
2012/6/22,1145,7033,-7,16,9,7,1.013,1.767
2012/6/22,1245,7038,5,16,9,7,1.009,1.986
2012/6/22,1345,7038,-1,16,3,13,1.005,1.199
2012/6/25,945,6948,-4,33,25,8,1.015,0.593
2012/6/25,1045,6970,22,30,8,22,1.009,1.089
2012/6/25,1145,6965,-5,11,4,7,1.008,1.945
2012/6/25,1245,6953,-13,21,18,3,1.007,1.749
2012/6/25,1345,6948,-4,14,12,2,1.006,1.248
2012/6/26,945,6945,1,35,13,22,1.006,0.606
2012/6/26,1045,6942,-3,19,12,7,1.005,1.679
2012/6/26,1145,6936,-7,17,11,6,1.004,1.597
2012/6/26,1245,6944,8,18,0,18,1.002,1.821
2012/6/26,1345,6939,-5,8,6,2,1.001,1.567
2012/6/27,945,6971,53,81,8,73,0.996,0.388
2012/6/27,1045,6989,18,33,7,26,0.994,0.753
2012/6/27,1145,6997,9,21,8,13,0.993,1.298
2012/6/27,1245,6994,-3,14,6,8,0.994,2.224
2012/6/27,1345,6986,-8,19,16,3,0.995,1.019
2012/6/28,945,7011,-10,24,26,-2,0.993,0.788
2012/6/28,1045,6963,-48,53,52,1,1.001,0.599
2012/6/28,1145,6986,23,27,4,23,0.998,1.126
2012/6/28,1245,6990,3,17,12,5,0.998,1.312
2012/6/28,1345,6999,10,24,7,17,0.997,0.908
2012/6/29,945,7013,31,69,37,32,0.996,0.507
2012/6/29,1045,7017,4,25,15,10,0.996,1.439
2012/6/29,1145,7110,92,105,6,99,0.984,0.454
2012/6/29,1245,7123,13,27,5,22,0.983,1.583
2012/6/29,1345,7114,-8,16,6,10,0.987,1.083
2012/7/2,945,7116,-17,24,15,9,0.988,1.104
2012/7/2,1045,7122,5,16,3,13,0.988,2.5
2012/7/2,1145,7149,27,32,1,31,0.987,1.356
2012/7/2,1245,7144,-6,8,5,3,0.99,4.28
2012/7/2,1345,7135,-9,15,14,1,0.993,1.583
2012/7/3,945,7171,-6,27,17,10,0.991,0.862
2012/7/3,1045,7246,75,79,4,75,0.983,0.551
2012/7/3,1145,7253,7,18,4,14,0.985,1.541
2012/7/3,1245,7270,17,27,10,17,0.985,1.279
2012/7/3,1345,7228,-41,48,47,1,0.993,0.671
2012/7/4,945,7274,6,76,53,23,0.988,0.453
2012/7/4,1045,7288,14,32,6,26,0.988,1.209
2012/7/4,1145,7298,10,18,2,16,0.989,2.152
2012/7/4,1245,7286,-12,23,18,5,0.993,2.203
2012/7/4,1345,7290,2,11,4,7,0.994,1.86
2012/7/5,945,7305,2,32,16,16,0.994,0.784
2012/7/5,1045,7289,-16,19,7,12,0.998,1.164
2012/7/5,1145,7289,0,16,5,11,0.999,1.998
2012/7/5,1245,7291,2,13,8,5,0.999,2.964
2012/7/5,1345,7298,7,16,1,15,0.998,1.674
2012/7/6,945,7299,11,47,20,27,0.998,0.505
2012/7/6,1045,7258,-42,53,41,12,1.004,0.49
2012/7/6,1145,7252,-5,17,13,4,1.005,1.606
2012/7/6,1245,7242,-10,17,13,4,1.006,1.685
2012/7/6,1345,7273,31,38,2,36,1.001,0.824
2012/7/9,945,7266,62,54,3,51,1,0.558
2012/7/9,1045,7250,-18,25,22,3,1.002,1.276
2012/7/9,1145,7230,-21,32,22,10,1.004,0.921
2012/7/9,1245,7238,7,23,6,17,1.002,1.949
2012/7/9,1345,7236,-2,12,6,6,1.002,1.479
2012/7/10,945,7240,-11,36,21,15,1.001,0.814
2012/7/10,1045,7201,-39,49,69,-20,1.005,0.594
2012/7/10,1145,7171,-29,34,27,7,1.009,0.602
2012/7/10,1245,7172,2,18,12,6,1.008,1.948
2012/7/10,1345,7179,7,28,11,17,1.006,0.882
2012/7/11,945,7168,30,36,1,35,1.006,0.766
2012/7/11,1045,7188,21,41,16,25,1.002,0.838
2012/7/11,1145,7166,-23,24,31,-7,1.004,1.472
2012/7/11,1245,7190,23,24,2,22,1,1.97
2012/7/11,1345,7186,-4,17,9,8,1,1.376
2012/7/12,945,7102,-84,82,86,-4,1.011,0.503
2012/7/12,1045,7083,-19,28,17,11,1.012,0.862
2012/7/12,1145,7107,24,19,-15,34,1.006,2.151
2012/7/12,1245,7074,-34,40,35,5,1.01,1.107
2012/7/12,1345,7076,2,28,19,9,1.009,0.877
2012/7/13,945,7089,19,54,10,44,1.006,0.554
2012/7/13,1045,7075,-13,41,33,8,1.007,0.875
2012/7/13,1145,7084,9,28,5,23,1.004,1.617
2012/7/13,1245,7083,-1,22,11,11,1.003,2.498
2012/7/13,1345,7071,-13,17,14,3,1.003,1.795
2012/7/16,945,7071,-18,72,39,33,1.002,0.653
2012/7/16,1045,7040,-32,49,29,20,1.006,0.816
2012/7/16,1145,7062,22,32,3,29,1.002,1.699
2012/7/16,1245,7062,0,21,15,6,1.001,1.848
2012/7/16,1345,7056,-6,25,15,10,1.002,1.339
2012/7/17,945,7089,41,106,47,59,0.997,0.418
2012/7/17,1045,7086,-3,36,32,4,0.997,0.98
2012/7/17,1145,7097,12,30,-2,32,0.996,1.091
2012/7/17,1245,7111,14,19,1,18,0.994,2.001
2012/7/17,1345,7110,-1,18,8,10,0.995,1.364
2012/7/18,945,7099,-11,34,18,16,0.996,1.093
2012/7/18,1045,7076,-23,34,30,4,1,1.513
2012/7/18,1145,7095,19,18,2,16,0.998,2.621
2012/7/18,1245,7091,-4,15,5,10,0.999,3.703
2012/7/19,945,6952,-22,151,144,7,1.018,0.485
2012/7/19,1045,7020,68,47,-18,65,1.006,0.629
2012/7/19,1145,7023,2,22,7,15,1.005,0.803
2012/7/19,1245,7015,-7,19,17,2,1.005,1.545
2012/7/19,1345,7025,10,18,4,14,1.003,1.055
2012/7/20,945,7007,-15,23,19,4,1.004,0.914
2012/7/20,1045,7025,18,29,14,15,1,0.932
2012/7/20,1145,7000,-24,26,22,4,1.002,1.063
2012/7/20,1245,7011,11,18,7,11,1,2.567
2012/7/20,1345,7012,1,21,7,14,0.998,1.339
2012/7/23,945,6875,-40,63,57,6,1.018,0.517
2012/7/23,1045,6858,-19,27,20,7,1.019,0.968
2012/7/23,1145,6851,-8,22,16,6,1.018,2.006
2012/7/23,1245,6853,3,19,11,8,1.015,2.248
2012/7/23,1345,6874,20,30,7,23,1.009,0.81
2012/7/24,945,6880,18,35,5,30,1.006,0.701
2012/7/24,1045,6872,-7,34,17,17,1.005,1.022
2012/7/24,1145,6868,-4,15,7,8,1.004,1.833
2012/7/24,1245,6874,6,26,3,23,1.001,1.658
2012/7/24,1345,6873,-1,12,12,0,0.999,1.287
2012/7/25,945,6856,74,93,12,81,1,0.442
2012/7/25,1045,6874,18,37,9,28,0.997,0.766
2012/7/25,1145,6904,29,43,8,35,0.993,1.02
2012/7/25,1245,6869,-35,45,38,7,0.999,1.144
2012/7/25,1345,6844,-25,35,29,6,1.002,0.899
2012/7/26,945,6843,-13,65,62,3,1.002,0.534
2012/7/26,1045,6874,31,44,4,40,0.997,1.047
2012/7/26,1145,6876,2,17,4,13,0.997,1.977
2012/7/26,1245,6886,10,25,-4,29,0.996,2.197
2012/7/26,1345,6876,-10,20,12,8,0.997,1.326
2012/7/27,945,6964,-5,29,11,18,0.988,0.739
2012/7/27,1045,7026,62,64,-4,68,0.98,0.625
2012/7/27,1145,7022,-4,16,8,8,0.983,1.482
2012/7/27,1245,7022,0,10,6,4,0.985,2.911
2012/7/27,1345,7031,9,23,0,23,0.986,0.844
2012/7/30,945,7082,0,47,20,27,0.982,0.605
2012/7/30,1045,7090,6,25,5,20,0.984,1.352
2012/7/30,1145,7091,1,16,8,8,0.987,1.928
2012/7/30,1245,7080,-10,18,17,1,0.992,2.478
2012/7/30,1345,7077,-3,15,7,8,0.995,1.244
2012/7/31,945,7124,22,67,4,63,0.99,0.5
2012/7/31,1045,7144,21,42,11,31,0.989,0.708
2012/7/31,1145,7129,-15,30,23,7,0.993,1.233
2012/7/31,1245,7142,14,24,10,14,0.993,1.713
2012/7/31,1345,7156,14,41,23,18,0.993,0.71
2012/8/1,945,7154,15,24,7,17,0.994,0.7
2012/8/1,1045,7164,10,23,8,15,0.993,1.127
2012/8/1,1145,7194,30,48,18,30,0.99,0.815
2012/8/1,1245,7189,-6,30,16,14,0.992,1.823
2012/8/1,1345,7194,4,19,4,15,0.993,1.434
2012/8/3,945,7150,10,33,14,19,1,0.806
2012/8/3,1045,7130,-19,40,26,14,1.003,0.855
2012/8/3,1145,7134,4,19,11,8,1.002,1.545
2012/8/3,1245,7133,0,16,6,10,1.002,2.466
2012/8/3,1345,7140,8,16,4,12,1.001,1.421
2012/8/6,945,7276,-2,51,38,13,0.984,0.498
2012/8/6,1045,7267,-10,21,8,13,0.987,1.214
2012/8/6,1145,7258,-8,20,12,8,0.99,1.731
2012/8/6,1245,7263,6,18,5,13,0.99,2.086
2012/8/6,1345,7239,-24,29,26,3,0.994,0.901
2012/8/7,945,7244,11,29,8,21,0.995,0.85
2012/8/7,1045,7254,10,25,9,16,0.995,1.051
2012/8/7,1145,7233,-21,31,23,8,1,1.132
2012/8/7,1245,7234,1,12,10,2,1.001,2.467
2012/8/7,1345,7235,2,14,8,6,1.002,1.403
2012/8/8,945,7301,-5,56,35,21,0.993,0.365
2012/8/8,1045,7320,19,30,9,21,0.991,0.905
2012/8/8,1145,7290,-30,33,34,-1,0.996,1.068
2012/8/8,1245,7296,6,12,9,3,0.996,1.907
2012/8/8,1345,7299,3,24,2,22,0.996,0.908
2012/8/9,945,7394,23,47,-1,48,0.985,0.465
2012/8/9,1045,7403,9,23,5,18,0.986,0.936
2012/8/9,1145,7429,25,38,-1,39,0.984,1.105
2012/8/9,1245,7442,12,27,3,24,0.985,1.173
2012/8/9,1345,7441,-1,21,11,10,0.988,0.882
2012/8/10,945,7450,-3,19,2,17,0.989,1.003
2012/8/10,1045,7457,8,27,8,19,0.99,1.43
2012/8/10,1145,7445,-12,24,16,8,0.993,1.597
2012/8/10,1245,7437,-9,21,15,6,0.996,2.472
2012/8/10,1345,7444,6,20,1,19,0.997,1.333
2012/8/13,945,7446,2,45,29,16,0.998,0.722
2012/8/13,1045,7459,13,18,8,10,0.997,1.349
2012/8/13,1145,7445,-13,23,18,5,1,1.44
2012/8/13,1245,7447,2,16,5,11,1,1.94
2012/8/13,1345,7454,7,11,0,11,0.999,1.517
2012/8/14,945,7529,45,67,16,51,0.989,0.405
2012/8/14,1045,7470,-58,79,60,19,0.998,0.467
2012/8/14,1145,7456,-14,18,22,-4,1,1.672
2012/8/14,1245,7472,16,26,10,16,0.998,1.687
2012/8/14,1345,7498,26,24,-2,26,0.995,1.233
2012/8/15,945,7476,-13,26,21,5,0.999,1.466
2012/8/15,1045,7467,-9,20,12,8,1,1.691
2012/8/15,1145,7461,-6,20,15,5,1.001,2.52
2012/8/15,1245,7446,-16,25,20,5,1.003,2.25
2012/8/16,945,7464,4,38,7,31,1.001,0.539
2012/8/16,1045,7501,38,67,16,51,0.996,0.509
2012/8/16,1145,7504,3,21,8,13,0.995,1.3
2012/8/16,1245,7508,4,20,12,8,0.995,1.476
2012/8/16,1345,7493,-15,33,20,13,0.998,0.795
2012/8/17,945,7489,-14,36,19,17,0.999,0.633
2012/8/17,1045,7480,-9,23,10,13,1,1.054
2012/8/17,1145,7476,-4,19,14,5,1.001,1.778
2012/8/17,1245,7480,4,13,6,7,1,2.82
2012/8/17,1345,7472,-8,16,13,3,1.001,1.719
2012/8/20,945,7422,-42,64,53,11,1.008,0.507
2012/8/20,1045,7417,-5,33,14,19,1.008,0.747
2012/8/20,1145,7422,4,14,5,9,1.007,1.932
2012/8/20,1245,7425,4,14,-1,15,1.005,2.52
2012/8/20,1345,7441,16,22,0,22,1.002,0.952
2012/8/21,945,7516,51,80,22,58,0.991,0.398
2012/8/21,1045,7540,24,36,13,23,0.988,0.827
2012/8/21,1145,7526,-14,26,18,8,0.991,1.261
2012/8/21,1245,7517,-8,28,14,14,0.993,1.392
2012/8/21,1345,7516,-1,13,8,5,0.994,1.299
2012/8/22,945,7476,-18,32,27,5,0.999,0.809
2012/8/22,1045,7465,-11,28,16,12,1.001,1.116
2012/8/22,1145,7482,17,23,4,19,1,1.605
2012/8/22,1245,7489,6,14,8,6,1,1.939
2012/8/22,1345,7491,2,19,17,2,1,1.133
2012/8/23,945,7518,42,60,10,50,0.997,0.468
2012/8/23,1045,7489,-30,51,45,6,1.001,0.747
2012/8/23,1145,7506,16,29,3,26,0.998,1.329
2012/8/23,1245,7507,1,15,1,14,0.997,2.541
2012/8/23,1345,7514,7,9,-2,11,0.996,1.475
2012/8/24,945,7469,19,31,6,25,1.002,0.699
2012/8/24,1045,7467,-2,17,11,6,1.002,1.431
2012/8/24,1145,7474,7,11,3,8,1.001,3.018
2012/8/24,1245,7476,3,16,12,4,1.001,1.556
2012/8/24,1345,7488,13,16,-2,18,0.999,1.35
2012/8/27,945,7484,-51,80,67,13,1,0.413
2012/8/27,1045,7470,-13,31,14,17,1.002,0.84
2012/8/27,1145,7466,-4,17,12,5,1.002,1.877
2012/8/27,1245,7477,11,17,8,9,1,1.707
2012/8/27,1345,7454,-24,28,29,-1,1.003,1.04
2012/8/28,945,7413,-22,24,17,7,1.008,0.59
2012/8/28,1045,7407,-6,28,19,9,1.008,0.865
2012/8/28,1145,7405,-2,16,7,9,1.007,1.48
2012/8/28,1245,7382,-23,29,27,2,1.01,1.312
2012/8/28,1345,7400,18,25,0,25,1.006,0.878
2012/8/29,945,7385,-19,32,28,4,1.006,0.773
2012/8/29,1045,7399,14,24,8,16,1.003,1.452
2012/8/29,1145,7400,1,10,6,4,1.002,3.017
2012/8/29,1245,7403,3,9,2,7,1.001,4.075
2012/8/29,1345,7403,0,10,7,3,1,1.38
2012/8/30,945,7378,18,49,17,32,1.002,0.468
2012/8/30,1045,7374,-4,22,10,12,1.002,1.268
2012/8/30,1145,7351,-22,23,26,-3,1.005,1.321
2012/8/30,1245,7363,12,14,1,13,1.002,1.274
2012/8/30,1345,7367,4,26,0,26,1.001,0.545
2012/8/31,945,7403,28,57,17,40,0.996,0.46
2012/8/31,1045,7381,-22,40,25,15,0.999,0.758
2012/8/31,1145,7385,4,19,9,10,0.999,2.073
2012/8/31,1245,7386,1,14,9,5,0.998,2.518
2012/8/31,1345,7383,-4,10,5,5,0.998,1.385
2012/9/3,945,7438,68,87,1,86,0.991,0.423
2012/9/3,1045,7457,19,31,2,29,0.99,0.983
2012/9/3,1145,7456,-1,16,9,7,0.991,1.796
2012/9/3,1245,7461,6,12,3,9,0.992,2.814
2012/9/3,1345,7443,-17,26,20,6,0.995,0.883
2012/9/4,945,7448,5,40,22,18,0.995,0.66
2012/9/4,1045,7444,-5,18,12,6,0.997,1.991
2012/9/4,1145,7441,-3,11,8,3,0.998,2.861
2012/9/4,1245,7440,-2,9,4,5,0.999,2.856
2012/9/4,1345,7449,8,12,0,12,0.998,2.059
2012/9/5,945,7361,-40,57,50,7,1.011,0.36
2012/9/5,1045,7356,-5,15,2,13,1.01,0.849
2012/9/5,1145,7359,4,12,6,6,1.008,1.597
2012/9/5,1245,7350,-8,14,13,1,1.008,2.454
2012/9/5,1345,7341,-10,12,16,-4,1.008,0.889
2012/9/6,945,7360,28,36,3,33,1.004,0.61
2012/9/6,1045,7350,-10,20,18,2,1.004,1.332
2012/9/6,1145,7304,-47,59,46,13,1.009,0.595
2012/9/6,1245,7303,-1,23,6,17,1.007,1.389
2012/9/6,1345,7332,29,32,1,31,1.002,0.934
2012/9/7,945,7411,-60,69,62,7,0.992,0.481
2012/9/7,1045,7422,11,18,8,10,0.991,1.43
2012/9/7,1145,7444,21,28,4,24,0.989,1.109
2012/9/7,1245,7436,-8,10,8,2,0.991,3.033
2012/9/7,1345,7420,-17,25,24,1,0.995,1.239
2012/9/10,945,7432,11,36,18,18,0.994,0.764
2012/9/10,1045,7461,30,30,2,28,0.991,1.25
2012/9/10,1145,7456,-5,18,13,5,0.993,1.48
2012/9/10,1245,7456,0,11,1,10,0.995,2.17
2012/9/10,1345,7455,-1,14,7,7,0.998,1.241
2012/9/11,945,7457,20,46,33,13,0.997,0.476
2012/9/11,1045,7461,4,15,8,7,0.997,1.304
2012/9/11,1145,7460,-1,11,6,5,0.998,2.515
2012/9/11,1245,7462,2,7,3,4,0.998,3.994
2012/9/11,1345,7466,5,7,0,7,0.997,1.447
2012/9/12,945,7558,33,45,2,43,0.987,0.356
2012/9/12,1045,7570,12,17,2,15,0.987,0.971
2012/9/12,1145,7564,-6,24,17,7,0.989,1.095
2012/9/12,1245,7576,12,17,-1,18,0.989,2.344
2012/9/12,1345,7586,10,16,-4,20,0.989,0.977
2012/9/13,945,7584,-8,29,16,13,0.991,0.594
2012/9/13,1045,7600,15,28,9,19,0.991,0.853
2012/9/13,1145,7599,-1,11,4,7,0.993,2.289
2012/9/13,1245,7593,-6,17,10,7,0.996,2.538
2012/9/13,1345,7576,-17,19,19,0,1,1.219
2012/9/14,945,7700,2,48,19,29,0.986,0.405
2012/9/14,1045,7711,11,16,5,11,0.986,1.289
2012/9/14,1145,7717,6,16,5,11,0.987,1.343
2012/9/14,1245,7744,27,28,-1,29,0.986,1.183
2012/9/14,1345,7739,-5,25,19,6,0.989,0.617
2012/9/17,945,7749,10,25,18,7,0.989,0.681
2012/9/17,1045,7752,3,12,6,6,0.991,1.821
2012/9/17,1145,7738,-14,27,15,12,0.995,1.227
2012/9/17,1245,7744,6,14,0,14,0.996,3.335
2012/9/17,1345,7753,9,10,0,10,0.996,1.545
2012/9/18,945,7737,-5,33,9,24,0.999,0.585
2012/9/18,1045,7748,11,34,20,14,0.998,0.87
2012/9/18,1145,7749,1,28,9,19,0.998,1.406
2012/9/18,1245,7749,-1,13,7,6,0.999,2.906
2012/9/18,1345,7750,1,12,4,8,0.999,1.46
2012/9/19,945,7750,-7,28,19,9,0.999,0.988
2012/9/19,1045,7750,-1,15,4,11,0.999,2.007
2012/9/19,1145,7757,7,15,2,13,0.998,2.473
2012/9/19,1245,7774,17,37,21,16,0.996,0.887
2012/9/20,945,7767,-15,27,19,8,0.998,0.473
2012/9/20,1045,7741,-25,24,31,-7,1.001,0.802
2012/9/20,1145,7727,-16,20,21,-1,1.003,0.78
2012/9/20,1245,7734,8,17,-1,18,1.002,0.971
2012/9/20,1345,7749,17,26,1,25,1,0.726
2012/9/21,945,7766,1,32,14,18,0.998,0.674
2012/9/21,1045,7773,7,32,10,22,0.997,0.959
2012/9/21,1145,7762,-10,15,11,4,0.999,1.823
2012/9/21,1245,7765,3,12,6,6,0.998,2.756
2012/9/21,1345,7762,-3,11,9,2,0.999,1.468
2012/9/24,945,7701,-46,62,46,16,1.006,0.453
2012/9/24,1045,7717,16,29,6,23,1.004,1.19
2012/9/24,1145,7780,62,92,25,67,0.995,0.536
2012/9/24,1245,7781,3,15,4,11,0.996,1.949
2012/9/24,1345,7776,-6,15,6,9,0.997,1.32
2012/9/25,945,7787,-5,40,23,17,0.996,0.693
2012/9/25,1045,7778,-9,21,11,10,0.997,1.538
2012/9/25,1145,7763,-15,24,16,8,0.999,1.284
2012/9/25,1245,7748,-14,26,22,4,1.001,1.7
2012/9/25,1345,7755,8,19,12,7,1,1.296
2012/9/26,945,7715,24,30,10,20,1.005,0.797
2012/9/26,1045,7690,-27,47,27,20,1.008,0.734
2012/9/26,1145,7679,-10,16,14,2,1.009,1.61
2012/9/26,1245,7681,2,23,12,11,1.007,1.503
2012/9/26,1345,7703,21,22,-3,25,1.003,1.037
2012/9/27,945,7698,15,30,11,19,1.003,0.76
2012/9/27,1045,7717,20,26,6,20,0.999,0.952
2012/9/27,1145,7705,-12,16,11,5,1,1.462
2012/9/27,1245,7712,8,22,7,15,0.998,1.852
2012/9/27,1345,7727,15,27,2,25,0.996,0.784
2012/9/28,945,7686,-40,82,62,20,1.001,0.437
2012/9/28,1045,7714,28,36,4,32,0.997,0.891
2012/9/28,1145,7697,-17,18,18,0,1,1.524
2012/9/28,1245,7695,-2,16,9,7,1,1.868
2012/9/28,1345,7720,25,34,2,32,0.997,0.885
2012/10/1,945,7693,3,23,13,10,1.001,1.05
2012/10/1,1045,7668,-25,24,24,0,1.004,1.058
2012/10/1,1145,7677,9,15,8,7,1.002,2.34
2012/10/1,1245,7677,1,11,7,4,1.002,3.795
2012/10/1,1345,7685,9,13,4,9,1,1.524
2012/10/2,945,7699,-17,30,24,6,0.998,0.708
2012/10/2,1045,7714,15,19,0,19,0.997,1.264
2012/10/2,1145,7737,23,37,11,26,0.994,0.575
2012/10/2,1245,7735,-2,11,10,1,0.995,2.04
2012/10/2,1345,7730,-5,16,11,5,0.996,0.837
2012/10/3,945,7725,-15,28,17,11,0.997,0.748
2012/10/3,1045,7724,-1,12,3,9,0.998,1.506
2012/10/3,1145,7719,-5,14,13,1,0.999,1.825
2012/10/3,1245,7693,-26,34,28,6,1.003,0.656
2012/10/3,1345,7705,12,16,3,13,1.001,0.973
2012/10/4,945,7654,-53,58,47,11,1.008,0.398
2012/10/4,1045,7658,4,30,5,25,1.007,0.818
2012/10/4,1145,7694,36,43,4,39,1.001,0.633
2012/10/4,1245,7698,4,26,17,9,1,1.268
2012/10/4,1345,7706,7,18,2,16,0.999,1.515
2012/10/5,945,7731,20,36,-1,37,0.995,0.698
2012/10/5,1045,7716,-14,17,12,5,0.997,1.701
2012/10/5,1145,7704,-11,17,15,2,0.999,1.612
2012/10/5,1245,7691,-13,23,12,11,1,1.209
2012/10/5,1345,7700,8,20,6,14,0.999,1.511
2012/10/8,945,7635,-42,77,57,20,1.007,0.489
2012/10/8,1045,7632,-3,24,11,13,1.007,1.264
2012/10/8,1145,7638,6,17,7,10,1.006,1.856
2012/10/8,1245,7624,-14,27,15,12,1.007,1.315
2012/10/8,1345,7625,0,20,15,5,1.006,1.036
2012/10/9,945,7622,-7,34,25,9,1.005,0.581
2012/10/9,1045,7639,15,39,5,34,1.002,0.807
2012/10/9,1145,7623,-15,22,18,4,1.003,1.712
2012/10/9,1245,7620,-2,14,6,8,1.002,1.676
2012/10/9,1345,7597,-24,23,23,0,1.004,0.958
2012/10/11,945,7494,11,40,12,28,1.016,0.517
2012/10/11,1045,7469,-25,32,33,-1,1.017,1.163
2012/10/11,1145,7476,5,14,11,3,1.014,1.865
2012/10/11,1245,7452,-24,31,31,0,1.015,1.297
2012/10/11,1345,7443,-9,25,26,-1,1.014,0.84
2012/10/12,945,7459,25,28,4,24,1.009,0.868
2012/10/12,1045,7412,-46,42,45,-3,1.013,1.018
2012/10/12,1145,7408,-4,37,16,21,1.011,0.773
2012/10/12,1245,7398,-10,29,16,13,1.009,1.515
2012/10/12,1345,7414,17,34,19,15,1.004,0.87
2012/10/15,945,7412,16,35,13,22,1.003,0.795
2012/10/15,1045,7407,-5,42,27,15,1.003,0.902
2012/10/15,1145,7409,2,15,4,11,1.002,2.189
2012/10/15,1245,7407,-2,21,13,8,1.001,2.21
2012/10/15,1345,7423,17,21,2,19,0.998,1.592
2012/10/16,945,7439,-21,24,23,1,0.996,0.733
2012/10/16,1045,7443,3,16,8,8,0.996,1.876
2012/10/16,1145,7451,10,14,6,8,0.995,2.006
2012/10/16,1245,7452,1,9,5,4,0.995,2.746
2012/10/16,1345,7458,6,15,3,12,0.995,1.106
2012/10/17,945,7501,-9,29,24,5,0.991,0.779
2012/10/17,1045,7479,-22,29,23,6,0.995,0.88
2012/10/17,1145,7493,14,24,3,21,0.994,1.449
2012/10/17,1245,7478,-16,27,17,10,0.998,1.642
2012/10/18,945,7466,-1,30,15,15,1,0.423
2012/10/18,1045,7451,-15,26,19,7,1.002,0.766
2012/10/18,1145,7450,-2,12,7,5,1.002,1.781
2012/10/18,1245,7450,0,10,4,6,1.002,1.945
2012/10/18,1345,7452,2,12,8,4,1.002,1.11
2012/10/19,945,7408,-60,78,61,17,1.008,0.389
2012/10/19,1045,7403,-5,14,11,3,1.008,1.265
2012/10/19,1145,7398,-5,17,7,10,1.007,1.371
2012/10/19,1245,7397,-1,17,11,6,1.006,1.955
2012/10/19,1345,7385,-13,22,24,-2,1.006,0.947
2012/10/22,945,7302,2,29,16,13,1.016,0.597
2012/10/22,1045,7323,21,17,-3,20,1.01,1.361
2012/10/22,1145,7336,13,27,10,17,1.007,1.047
2012/10/22,1245,7345,10,17,3,14,1.004,1.886
2012/10/22,1345,7346,-1,14,14,0,1.003,0.937
2012/10/23,945,7334,-8,29,16,13,1.002,0.731
2012/10/23,1045,7321,-13,25,16,9,1.003,1.129
2012/10/23,1145,7295,-25,29,32,-3,1.006,0.996
2012/10/23,1245,7320,24,26,6,20,1.001,1.338
2012/10/23,1345,7297,-23,23,25,-2,1.003,1.192
2012/10/24,945,7300,70,85,10,75,1.002,0.4
2012/10/24,1045,7291,-9,24,21,3,1.003,1.182
2012/10/24,1145,7296,4,25,10,15,1.002,1.247
2012/10/24,1245,7330,33,48,17,31,0.996,0.893
2012/10/24,1345,7302,-29,44,32,12,1,0.856
2012/10/25,945,7298,-5,32,21,11,1,0.777
2012/10/25,1045,7293,-5,27,14,13,1,1.212
2012/10/25,1145,7286,-7,18,10,8,1.001,1.53
2012/10/25,1245,7270,-16,24,21,3,1.003,1.841
2012/10/25,1345,7258,-12,24,17,7,1.004,0.886
2012/10/26,945,7251,25,54,36,18,1.005,0.536
2012/10/26,1045,7205,-45,41,53,-12,1.011,0.9
2012/10/26,1145,7172,-35,81,42,39,1.014,0.685
2012/10/26,1245,7135,-37,45,45,0,1.018,1.145
2012/10/26,1345,7092,-43,63,66,-3,1.021,0.746
2012/10/29,945,7125,15,37,10,27,1.013,0.826
2012/10/29,1045,7141,16,33,12,21,1.009,1.287
2012/10/29,1145,7119,-23,37,29,8,1.01,1.603
2012/10/29,1245,7121,3,33,5,28,1.007,1.225
2012/10/29,1345,7122,1,31,0,31,1.005,1.226
2012/10/30,945,7186,16,76,34,42,0.995,0.512
2012/10/30,1045,7183,-1,33,12,21,0.995,1.265
2012/10/30,1145,7146,-37,51,46,5,1,1.184
2012/10/30,1245,7178,32,30,-2,32,0.995,1.538
2012/10/30,1345,7161,-17,18,19,-1,0.998,1.409
2012/10/31,945,7172,-20,45,40,5,0.997,0.711
2012/10/31,1045,7148,-23,40,32,8,1.001,0.989
2012/10/31,1145,7146,-2,30,9,21,1.002,1.178
2012/10/31,1245,7146,0,22,14,8,1.002,1.75
2012/10/31,1345,7140,-6,19,15,4,1.003,1.453
2012/11/1,945,7038,-60,79,70,9,1.017,0.462
2012/11/1,1045,7111,74,74,6,68,1.004,0.652
2012/11/1,1145,7127,16,43,17,26,1.001,0.912
2012/11/1,1245,7160,33,65,32,33,0.996,0.896
2012/11/1,1345,7172,12,32,1,31,0.994,1.136
2012/11/2,945,7205,-9,32,9,23,0.99,0.868
2012/11/2,1045,7211,6,30,7,23,0.99,1.39
2012/11/2,1145,7195,-16,29,22,7,0.993,1.7
2012/11/2,1245,7192,-2,18,12,6,0.994,2.652
2012/11/2,1345,7201,9,13,2,11,0.993,2.263
2012/11/5,945,7204,14,76,18,58,0.994,0.572
2012/11/5,1045,7164,-39,46,39,7,1.002,1.126
2012/11/5,1145,7158,-6,21,14,7,1.003,1.477
2012/11/5,1245,7167,8,22,5,17,1.003,2.004
2012/11/5,1345,7180,13,24,5,19,1.001,1.479
2012/11/6,945,7178,-2,28,18,10,1.001,0.912
2012/11/6,1045,7170,-8,15,8,7,1.001,1.506
2012/11/6,1145,7201,30,34,-1,35,0.997,1.237
2012/11/6,1245,7209,8,22,9,13,0.996,0.978
2012/11/6,1345,7259,50,53,-2,55,0.989,0.65
2012/11/7,945,7236,31,46,19,27,0.992,0.523
2012/11/7,1045,7234,-1,67,59,8,0.993,0.477
2012/11/7,1145,7222,-13,47,17,30,0.996,0.683
2012/11/7,1245,7248,27,58,13,45,0.993,0.826
2012/11/7,1345,7257,9,37,21,16,0.993,1.017
2012/11/8,945,7176,8,31,24,7,1.004,0.851
2012/11/8,1045,7192,14,38,12,26,1.002,1.22
2012/11/8,1145,7188,-3,15,8,7,1.002,2.375
2012/11/8,1245,7190,2,19,4,15,1.002,2.504
2012/11/8,1345,7200,10,36,20,16,1,1.304
2012/11/9,945,7186,50,69,15,54,1.001,0.703
2012/11/9,1045,7242,58,61,-6,67,0.993,0.769
2012/11/9,1145,7254,12,24,8,16,0.991,1.062
2012/11/9,1245,7279,25,54,22,32,0.988,0.902
2012/11/9,1345,7285,5,19,9,10,0.988,1.074
2012/11/12,945,7262,-3,49,42,7,0.992,0.851
2012/11/12,1045,7260,-3,29,9,20,0.994,1.065
2012/11/12,1145,7254,-7,25,9,16,0.996,1.671
2012/11/12,1245,7260,6,17,5,12,0.996,2.929
2012/11/12,1345,7241,-19,26,23,3,0.999,1.68
2012/11/13,945,7152,-75,85,86,-1,1.013,0.526
2012/11/13,1045,7130,-22,42,29,13,1.016,0.716
2012/11/13,1145,7122,-10,31,23,8,1.015,1.413
2012/11/13,1245,7104,-17,34,29,5,1.016,1.347
2012/11/13,1345,7096,-8,20,16,4,1.015,0.897
2012/11/14,945,7130,49,48,-5,53,1.007,0.616
2012/11/14,1045,7124,-6,30,18,12,1.006,1.129
2012/11/14,1145,7123,-1,23,11,12,1.004,1.834
2012/11/14,1245,7143,19,23,0,23,1,1.944
2012/11/14,1345,7128,-14,21,22,-1,1,1.618
2012/11/15,945,7093,-2,81,24,57,1.003,0.428
2012/11/15,1045,7141,46,75,15,60,0.996,0.73
2012/11/15,1145,7132,-9,25,17,8,0.997,1.732
2012/11/15,1245,7138,6,19,10,9,0.997,2.474
2012/11/15,1345,7121,-17,28,25,3,0.999,1.314
2012/11/16,945,7146,30,88,33,55,0.996,0.558
2012/11/16,1045,7096,-52,62,64,-2,1.004,0.805
2012/11/16,1145,7121,26,41,4,37,1,1.199
2012/11/16,1245,7105,-15,22,15,7,1.002,2.405
2012/11/16,1345,7107,2,24,5,19,1.001,1.267
2012/11/19,945,7129,-18,34,25,9,0.999,0.801
2012/11/19,1045,7131,3,18,8,10,0.999,1.477
2012/11/19,1145,7159,29,40,9,31,0.995,0.919
2012/11/19,1245,7145,-14,22,13,9,0.997,2.298
2012/11/19,1345,7123,-22,28,25,3,1,1.437
2012/11/20,945,7150,-24,29,28,1,0.997,0.708
2012/11/20,1045,7145,-5,30,16,14,0.998,1.086
2012/11/20,1145,7157,11,22,6,16,0.997,1.76
2012/11/20,1245,7142,-13,16,15,1,1,2.33
2012/11/20,1345,7160,18,21,-1,22,0.998,1.062
2012/11/21,945,7163,-13,27,10,17,0.998,1.025
2012/11/21,1045,7140,-23,34,27,7,1.001,1.541
2012/11/21,1145,7118,-22,35,33,2,1.005,1.031
2012/11/21,1245,7090,-28,74,35,39,1.008,0.656
2012/11/22,945,7093,-3,34,22,12,1.007,0.459
2012/11/22,1045,7089,-4,26,18,8,1.006,1.124
2012/11/22,1145,7095,5,23,14,9,1.005,1.061
2012/11/22,1245,7097,2,10,2,8,1.004,2.643
2012/11/22,1345,7089,-8,14,13,1,1.004,1.601
2012/11/23,945,7223,100,86,5,81,0.985,0.381
2012/11/23,1045,7251,28,35,11,24,0.982,0.813
2012/11/23,1145,7280,28,40,12,28,0.979,1.005
2012/11/23,1245,7296,16,23,6,17,0.979,1.716
2012/11/23,1345,7322,26,36,5,31,0.978,0.842
2012/11/26,945,7376,14,47,33,14,0.974,0.658
2012/11/26,1045,7382,7,28,12,16,0.977,1.526
2012/11/26,1145,7385,3,12,2,10,0.981,3.155
2012/11/26,1245,7382,-2,10,2,8,0.985,4.194
2012/11/26,1345,7388,6,22,15,7,0.988,1.225
2012/11/27,945,7430,20,44,-6,50,0.987,0.631
2012/11/27,1045,7409,-19,30,14,16,0.992,1.169
2012/11/27,1145,7392,-16,33,23,10,0.997,1.367
2012/11/27,1245,7414,24,25,3,22,0.995,1.584
2012/11/27,1345,7424,10,15,-1,16,0.995,1.168
2012/11/28,945,7401,-6,29,18,11,0.999,0.673
2012/11/28,1045,7400,-1,11,3,8,1,1.418
2012/11/28,1145,7408,9,14,6,8,0.999,1.482
2012/11/28,1245,7424,17,34,13,21,0.997,1.039
2012/11/28,1345,7428,4,17,11,6,0.997,1.032
2012/11/29,945,7526,56,58,-3,61,0.985,0.438
2012/11/29,1045,7500,-25,31,25,6,0.989,0.852
2012/11/29,1145,7527,27,27,-3,30,0.987,1.259
2012/11/29,1245,7532,5,15,7,8,0.988,1.222
2012/11/29,1345,7525,-6,34,14,20,0.991,0.656
2012/11/30,945,7544,9,33,13,20,0.99,0.69
2012/11/30,1045,7596,52,53,3,50,0.985,0.591
2012/11/30,1145,7593,-3,20,9,11,0.988,1.515
2012/11/30,1245,7586,-7,27,19,8,0.991,1.446
2012/11/30,1345,7593,6,16,3,13,0.993,1.152
2012/12/3,945,7617,21,50,25,25,0.991,0.646
2012/12/3,1045,7630,12,34,17,17,0.991,1.027
2012/12/3,1145,7624,-6,14,10,4,0.993,2.11
2012/12/3,1245,7579,-45,70,51,19,1,0.904
2012/12/3,1345,7599,20,29,5,24,0.998,1.241
2012/12/4,945,7571,11,21,11,10,1.002,1.025
2012/12/4,1045,7572,1,26,2,24,1.003,0.888
2012/12/4,1145,7596,25,20,-4,24,0.999,1.204
2012/12/4,1245,7582,-13,16,15,1,1.001,2.214
2012/12/4,1345,7594,12,26,9,17,0.999,1.317
2012/12/5,945,7586,-7,25,15,10,1,0.849
2012/12/5,1045,7653,67,74,0,74,0.991,0.537
2012/12/5,1145,7659,6,30,19,11,0.991,0.975
2012/12/5,1245,7661,1,14,11,3,0.991,2.198
2012/12/5,1345,7653,-8,27,12,15,0.993,0.83
2012/12/6,945,7636,-18,44,31,13,0.996,0.687
2012/12/6,1045,7650,14,45,23,22,0.995,1.017
2012/12/6,1145,7639,-11,28,20,8,0.998,1.817
2012/12/6,1245,7643,5,20,10,10,0.998,2.478
2012/12/6,1345,7640,-2,16,7,9,0.999,1.7
2012/12/7,945,7655,-3,49,36,13,0.998,0.555
2012/12/7,1045,7671,15,31,13,18,0.997,1.201
2012/12/7,1145,7664,-7,24,20,4,0.998,1.452
2012/12/7,1245,7656,-8,16,11,5,0.999,1.826
2012/12/7,1345,7660,3,11,3,8,0.999,1.609
2012/12/10,945,7611,-69,82,71,11,1.005,0.508
2012/12/10,1045,7634,24,56,34,22,1.002,0.691
2012/12/10,1145,7623,-11,20,15,5,1.003,1.92
2012/12/10,1245,7627,5,15,1,14,1.002,1.796
2012/12/10,1345,7623,-4,16,9,7,1.003,1.556
2012/12/11,945,7611,-28,39,34,5,1.004,0.705
2012/12/11,1045,7604,-7,35,10,25,1.004,0.585
2012/12/11,1145,7597,-6,20,18,2,1.004,1.531
2012/12/11,1245,7612,15,20,0,20,1.002,1.979
2012/12/11,1345,7638,26,34,1,33,0.998,1.009
2012/12/12,945,7713,56,67,12,55,0.988,0.434
2012/12/12,1045,7676,-37,27,41,-14,0.994,0.994
2012/12/12,1145,7683,8,21,11,10,0.993,1.395
2012/12/12,1245,7694,11,24,11,13,0.993,1.963
2012/12/12,1345,7698,4,18,5,13,0.993,1.301
2012/12/13,945,7730,12,35,13,22,0.99,0.673
2012/12/13,1045,7729,-1,18,8,10,0.992,1.606
2012/12/13,1145,7771,41,46,-1,47,0.988,0.856
2012/12/13,1245,7767,-4,14,8,6,0.991,1.59
2012/12/13,1345,7772,5,23,6,17,0.992,0.964
2012/12/14,945,7705,-33,40,42,-2,1.002,0.602
2012/12/14,1045,7738,34,37,7,30,0.997,0.789
2012/12/14,1145,7716,-20,27,23,4,1.001,1.234
2012/12/14,1245,7720,3,14,7,7,1.001,2.318
2012/12/14,1345,7703,-17,23,21,2,1.003,1.033
2012/12/17,945,7664,-26,65,43,22,1.008,0.494
2012/12/17,1045,7660,-4,39,15,24,1.008,1.126
2012/12/17,1145,7627,-32,36,31,5,1.011,1.041
2012/12/17,1245,7619,-7,21,17,4,1.01,1.97
2012/12/17,1345,7652,32,32,-3,35,1.004,1.038
2012/12/18,945,7632,-28,41,30,11,1.006,0.79
2012/12/18,1045,7634,2,25,19,6,1.005,1.47
2012/12/18,1145,7648,14,25,9,16,1.001,1.521
2012/12/18,1245,7651,3,12,4,8,1,2.88
2012/12/18,1345,7655,4,22,-1,23,0.999,1.433
2012/12/19,945,7679,-19,39,30,9,0.996,0.951
2012/12/19,1045,7674,-5,18,10,8,0.996,1.721
2012/12/19,1145,7669,-5,22,11,11,0.997,1.48
2012/12/19,1245,7672,2,14,8,6,0.997,2.98
2012/12/20,945,7609,-22,92,71,21,1.006,0.365
2012/12/20,1045,7609,0,18,15,3,1.005,1.19
2012/12/20,1145,7593,-16,20,18,2,1.007,1.053
2012/12/20,1245,7581,-10,26,25,1,1.008,1.055
2012/12/20,1345,7560,-22,31,28,3,1.01,0.643
2012/12/21,945,7516,-49,73,62,11,1.015,0.402
2012/12/21,1045,7495,-21,37,22,15,1.015,0.682
2012/12/21,1145,7490,-5,22,4,18,1.013,1.366
2012/12/21,1245,7480,-11,20,14,6,1.012,1.739
2012/12/21,1345,7491,9,40,29,11,1.008,0.849
2012/12/22,945,7537,-19,24,15,9,1.001,1.257
2012/12/22,1045,7536,-1,9,5,4,1,5.846
2012/12/22,1145,7539,2,10,5,5,0.999,6.101
2012/12/22,1245,7534,-5,11,12,-1,0.999,4.022
2012/12/22,1345,7525,-9,15,15,0,1,2.455
2012/12/24,945,7529,29,73,35,38,0.998,0.485
2012/12/24,1045,7537,8,19,10,9,0.997,1.208
2012/12/24,1145,7538,1,10,5,5,0.998,2.855
2012/12/24,1245,7532,-5,8,7,1,0.999,3.453
2012/12/24,1345,7518,-14,14,14,0,1.002,0.826
2012/12/25,945,7547,-8,25,16,9,0.998,0.645
2012/12/25,1045,7548,1,11,7,4,0.998,1.945
2012/12/25,1145,7612,65,73,9,64,0.989,0.399
2012/12/25,1245,7684,72,67,-11,78,0.981,0.572
2012/12/25,1345,7674,-11,39,13,26,0.984,0.606
2012/12/26,945,7665,14,35,20,15,0.988,0.585
2012/12/26,1045,7645,-19,24,21,3,0.992,1.364
2012/12/26,1145,7640,-5,27,10,17,0.994,1.108
2012/12/26,1245,7650,11,30,14,16,0.994,1.45
2012/12/26,1345,7634,-15,31,22,9,0.998,1.386
2012/12/27,945,7656,54,82,10,72,0.995,0.552
2012/12/27,1045,7634,-22,33,23,10,1,1.217
2012/12/27,1145,7646,13,19,6,13,0.999,2.655
2012/12/27,1245,7617,-30,39,30,9,1.003,1.075
2012/12/27,1345,7629,12,35,15,20,1.001,0.957
2012/12/28,945,7680,30,45,28,17,0.994,0.571
2012/12/28,1045,7671,-9,36,26,10,0.996,1.11
2012/12/28,1145,7692,22,23,0,23,0.993,1.777
2012/12/28,1245,7685,-7,15,7,8,0.995,2.187
2012/12/28,1345,7675,-10,17,20,-3,0.997,1.1
2013/1/2,945,7709,-11,27,20,7,0.994,0.69
2013/1/2,1045,7773,64,76,11,65,0.986,0.522
2013/1/2,1145,7793,20,33,8,25,0.986,1.125
2013/1/2,1245,7790,-3,16,14,2,0.988,2.18
2013/1/2,1345,7772,-18,21,16,5,0.992,0.929
2013/1/3,945,7809,-2,28,27,1,0.99,0.562
2013/1/3,1045,7824,15,21,3,18,0.989,1.548
2013/1/3,1145,7817,-6,10,5,5,0.992,3.032
2013/1/3,1245,7823,7,12,2,10,0.993,2.788
2013/1/3,1345,7823,1,10,5,5,0.995,1.289
2013/1/4,945,7785,-15,30,14,16,1.001,0.618
2013/1/4,1045,7777,-8,21,15,6,1.003,1.178
2013/1/4,1145,7761,-16,28,18,10,1.005,0.917
2013/1/4,1245,7765,5,18,13,5,1.004,1.676
2013/1/4,1345,7774,10,14,4,10,1.002,1.134
2013/1/7,945,7720,-23,62,54,8,1.009,0.438
2013/1/7,1045,7752,32,62,10,52,1.003,0.6
2013/1/7,1145,7745,-6,15,7,8,1.003,1.605
2013/1/7,1245,7745,0,17,4,13,1.002,2.234
2013/1/7,1345,7742,-3,16,9,7,1.002,1.581
2013/1/8,945,7702,-30,45,38,7,1.006,0.576
2013/1/8,1045,7686,-16,29,16,13,1.007,0.73
2013/1/8,1145,7692,5,30,28,2,1.005,1.108
2013/1/8,1245,7691,-2,17,4,13,1.004,1.829
2013/1/8,1345,7705,14,32,8,24,1.002,1.056
2013/1/9,945,7731,45,54,5,49,0.997,0.624
2013/1/9,1045,7761,29,44,13,31,0.994,0.658
2013/1/9,1145,7731,-30,39,35,4,0.998,1.046
2013/1/9,1245,7745,14,13,3,10,0.996,2.697
2013/1/9,1345,7740,-5,18,13,5,0.996,1.456
2013/1/10,945,7779,17,54,38,16,0.992,0.474
2013/1/10,1045,7834,55,64,6,58,0.986,0.581
2013/1/10,1145,7839,5,21,7,14,0.987,1.26
2013/1/10,1245,7832,-6,13,8,5,0.99,2.7
2013/1/10,1345,7836,4,22,-1,23,0.991,0.934
2013/1/11,945,7826,-37,51,41,10,0.995,0.753
2013/1/11,1045,7812,-14,34,18,16,0.998,0.926
2013/1/11,1145,7813,1,18,10,8,0.998,2.121
2013/1/11,1245,7829,14,18,2,16,0.997,2.182
2013/1/11,1345,7799,-30,26,30,-4,1.002,1.338
2013/1/14,945,7739,9,52,18,34,1.009,0.496
2013/1/14,1045,7753,15,25,7,18,1.007,1.338
2013/1/14,1145,7771,18,26,5,21,1.004,1.186
2013/1/14,1245,7782,11,35,11,24,1.001,1.531
2013/1/14,1345,7827,46,49,1,48,0.995,0.884
2013/1/15,945,7794,-6,38,18,20,0.998,0.663
2013/1/15,1045,7772,-22,33,29,4,1.001,1.173
2013/1/15,1145,7753,-18,42,21,21,1.003,0.881
2013/1/15,1245,7749,-3,23,2,21,1.002,1.59
2013/1/15,1345,7741,-8,17,20,-3,1.002,1.433
2013/1/16,945,7718,-32,71,51,20,1.006,0.69
2013/1/16,1045,7751,33,49,4,45,1.001,1.498
2013/1/16,1145,7731,-20,29,24,5,1.004,2.56
2013/1/16,1245,7740,8,19,2,17,1.002,4.028
2013/1/17,945,7744,42,57,23,34,1.001,0.42
2013/1/17,1045,7728,-16,33,29,4,1.002,0.911
2013/1/17,1145,7637,-92,100,99,1,1.013,0.55
2013/1/17,1245,7603,-36,60,42,18,1.016,0.717
2013/1/17,1345,7612,9,38,8,30,1.013,0.809
2013/1/18,945,7685,-7,38,23,15,1.002,0.804
2013/1/18,1045,7678,-6,36,24,12,1.002,1.09
2013/1/18,1145,7685,7,25,13,12,1.001,2.278
2013/1/18,1245,7685,0,11,9,2,1,3.772
2013/1/18,1345,7711,26,39,12,27,0.996,1.233
2013/1/21,945,7658,-25,52,39,13,1.003,0.767
2013/1/21,1045,7713,55,69,4,65,0.994,0.887
2013/1/21,1145,7726,13,40,10,30,0.993,1.18
2013/1/21,1245,7715,-11,26,11,15,0.995,1.87
2013/1/21,1345,7703,-11,17,14,3,0.998,1.673
2013/1/22,945,7687,-35,70,55,15,1.001,0.613
2013/1/22,1045,7721,34,51,7,44,0.996,0.743
2013/1/22,1145,7752,30,53,13,40,0.993,0.797
2013/1/22,1245,7749,-3,30,12,18,0.994,1.376
2013/1/22,1345,7751,2,19,6,13,0.995,1.522
2013/1/23,945,7754,-23,31,22,9,0.995,0.959
2013/1/23,1045,7737,-18,34,29,5,0.999,1.046
2013/1/23,1145,7723,-14,24,22,2,1.001,1.172
2013/1/23,1245,7719,-3,20,15,5,1.001,1.747
2013/1/23,1345,7723,4,19,12,7,1.001,1.365
2013/1/24,945,7661,-27,58,22,36,1.009,0.462
2013/1/24,1045,7718,57,65,2,63,1.001,0.638
2013/1/24,1145,7693,-25,48,35,13,1.004,0.949
2013/1/24,1245,7691,-3,12,6,6,1.004,2.48
2013/1/24,1345,7682,-10,30,10,20,1.004,1.063
2013/1/25,945,7656,-6,50,32,18,1.006,0.682
2013/1/25,1045,7643,-13,47,16,31,1.006,0.693
2013/1/25,1145,7630,-12,19,9,10,1.007,1.812
2013/1/25,1245,7641,11,27,6,21,1.004,2.124
2013/1/25,1345,7649,7,25,10,15,1.002,1.479
2013/1/28,945,7685,65,96,37,59,0.996,0.536
2013/1/28,1045,7709,25,35,8,27,0.994,1.111
2013/1/28,1145,7696,-14,18,11,7,0.995,2.859
2013/1/28,1245,7690,-6,17,13,4,0.996,2.719
2013/1/28,1345,7730,40,42,1,41,0.991,1.115
2013/1/29,945,7759,0,39,16,23,0.988,0.588
2013/1/29,1045,7774,14,27,10,17,0.988,0.882
2013/1/29,1145,7777,5,16,1,15,0.989,2.058
2013/1/29,1245,7800,23,28,-2,30,0.988,1.395
2013/1/29,1345,7819,19,32,3,29,0.988,0.856
2013/1/30,945,7821,-25,35,19,16,0.99,0.65
2013/1/30,1045,7843,22,35,15,20,0.989,0.813
2013/1/30,1145,7831,-12,33,28,5,0.993,1.092
2013/1/30,1245,7839,8,17,2,15,0.993,2.151
2013/1/30,1345,7800,-39,53,51,2,1,0.783
2013/1/31,945,7790,-25,43,35,8,1.002,0.697
2013/1/31,1045,7798,9,34,18,16,1.001,1.23
2013/1/31,1145,7810,12,19,8,11,1,1.894
2013/1/31,1245,7821,11,24,8,16,0.999,1.849
2013/1/31,1345,7848,26,42,2,40,0.996,0.866
2013/2/1,945,7832,-27,47,40,7,0.998,0.698
2013/2/1,1045,7864,32,66,37,29,0.994,0.648
2013/2/1,1145,7859,-5,26,9,17,0.995,1.472
2013/2/1,1245,7868,10,20,3,17,0.994,2.702
2013/2/1,1345,7858,-10,22,17,5,0.996,1.352
2013/2/4,945,7936,58,61,-3,64,0.987,0.537
2013/2/4,1045,7927,-9,18,12,6,0.99,1.301
2013/2/4,1145,7942,15,31,5,26,0.99,1.239
2013/2/4,1245,7946,3,13,6,7,0.991,2.368
2013/2/4,1345,7940,-6,23,9,14,0.993,0.98
2013/2/5,945,7895,10,36,9,27,0.999,0.642
2013/2/5,1045,7883,-13,23,15,8,1.002,1.237
2013/2/5,1145,7895,12,26,3,23,1,1.39
2013/2/5,1245,7893,-1,8,4,4,1.001,3.886
2013/2/5,1345,7905,12,27,8,19,1,0.925
2013/2/6,945,7937,21,30,13,17,0.996,0.586
2013/2/6,1045,7935,-2,13,10,3,0.997,2.092
2013/2/6,1145,7935,1,8,4,4,0.997,2.71
2013/2/6,1245,7942,7,19,10,9,0.996,1.444
2013/2/6,1345,7900,-43,54,45,9,1.001,0.577
2013/2/18,945,7950,-17,27,18,9,0.996,0.621
2013/2/18,1045,7926,-24,28,23,5,0.999,1.089
2013/2/18,1145,7939,13,24,-2,26,0.998,1.218
2013/2/18,1245,7945,7,16,4,12,0.998,2.035
2013/2/18,1345,7935,-10,24,22,2,1,1.066
2013/2/19,945,7958,8,25,8,17,0.998,0.749
2013/2/19,1045,7950,-8,22,20,2,0.999,1.208
2013/2/19,1145,7954,4,12,3,9,0.999,2.224
2013/2/19,1245,7953,-1,6,4,2,0.999,4.839
2013/2/19,1345,7959,7,7,2,5,0.998,1.47
2013/2/20,945,8007,-1,27,16,11,0.993,0.599
2013/2/20,1045,7993,-14,34,24,10,0.995,1.151
2013/2/20,1145,8015,22,23,3,20,0.993,1.572
2013/2/20,1245,8017,3,11,3,8,0.994,2.413
2013/2/21,945,7990,3,44,37,7,0.998,0.436
2013/2/21,1045,7975,-15,20,15,5,1,0.736
2013/2/21,1145,7963,-12,13,12,1,1.002,1.082
2013/2/21,1245,7968,5,18,5,13,1.002,1.231
2013/2/21,1345,7949,-19,23,22,1,1.004,0.781
2013/2/22,945,7916,-23,61,48,13,1.008,0.486
2013/2/22,1045,7951,35,48,7,41,1.003,0.602
2013/2/22,1145,7951,1,11,4,7,1.002,2.558
2013/2/22,1245,7960,8,24,16,8,1,1.023
2013/2/22,1345,7951,-9,29,10,19,1.001,1.025
2013/2/23,945,7980,6,15,12,3,0.997,1.279
2013/2/23,1045,7979,-1,11,3,8,0.997,3.458
2013/2/23,1145,7984,5,8,2,6,0.996,4.783
2013/2/23,1245,7989,5,9,1,8,0.996,4.436
2013/2/23,1345,7993,4,9,1,8,0.996,2.114
2013/2/25,945,7953,-32,43,30,13,1.001,0.404
2013/2/25,1045,7962,9,30,3,27,1.001,0.599
2013/2/25,1145,7952,-10,15,16,-1,1.002,1.3
2013/2/25,1245,7955,4,13,10,3,1.002,2.295
2013/2/25,1345,7941,-14,23,17,6,1.003,0.705
2013/2/26,945,7884,-9,24,2,22,1.01,0.528
2013/2/26,1045,7909,26,46,11,35,1.005,0.526
2013/2/26,1145,7900,-9,15,11,4,1.005,1.425
2013/2/26,1245,7890,-10,22,14,8,1.006,1.423
2013/2/26,1345,7885,-7,27,13,14,1.005,0.883
2013/2/27,945,7892,-15,39,9,30,1.003,0.73
2013/2/27,1045,7885,-7,18,10,8,1.003,1.383
2013/2/27,1145,7884,-1,18,13,5,1.002,1.687
2013/2/27,1245,7893,9,9,1,8,1,4.334
2013/2/27,1345,7879,-14,14,14,0,1.001,1.18
2013/3/1,945,7932,-13,25,13,12,0.995,0.695
2013/3/1,1045,7935,3,11,6,5,0.996,1.777
2013/3/1,1145,7939,3,7,-1,8,0.995,3.88
2013/3/1,1245,7939,0,7,1,6,0.996,3.916
2013/3/1,1345,7936,-4,12,6,6,0.997,0.861
2013/3/4,945,7890,-45,45,44,1,1.003,0.373
2013/3/4,1045,7860,-30,37,28,9,1.007,0.487
2013/3/4,1145,7864,5,14,4,10,1.006,1.358
2013/3/4,1245,7828,-35,37,37,0,1.01,0.942
2013/3/4,1345,7845,17,21,3,18,1.007,0.685
2013/3/5,945,7877,10,21,6,15,1.002,0.718
2013/3/5,1045,7876,-1,15,13,2,1.002,1.166
2013/3/5,1145,7882,6,12,1,11,1,2.058
2013/3/5,1245,7921,39,38,0,38,0.995,0.816
2013/3/5,1345,7913,-8,21,18,3,0.995,1.012
2013/3/6,945,7944,-36,63,54,9,0.992,0.473
2013/3/6,1045,7966,22,29,1,28,0.99,1.119
2013/3/6,1145,7961,-5,15,9,6,0.992,1.863
2013/3/6,1245,7954,-7,20,18,2,0.994,2.006
2013/3/6,1345,7947,-8,11,7,4,0.996,1.246
2013/3/7,945,7950,17,61,32,29,0.997,0.54
2013/3/7,1045,7961,11,21,3,18,0.996,1.401
2013/3/7,1145,7947,-13,30,16,14,0.999,1.324
2013/3/7,1245,7952,5,14,2,12,0.999,2.772
2013/3/7,1345,7938,-13,22,21,1,1.002,1.379
2013/3/8,945,8023,55,54,0,54,0.991,0.403
2013/3/8,1045,8014,-9,20,15,5,0.993,1.163
2013/3/8,1145,8018,3,11,5,6,0.993,2.272
2013/3/8,1245,8015,-3,22,17,5,0.994,1.597
2013/3/8,1345,8008,-8,13,11,2,0.996,1.183
2013/3/11,945,8016,6,31,8,23,0.996,0.613
2013/3/11,1045,8024,8,21,6,15,0.996,1.103
2013/3/11,1145,8029,4,11,1,10,0.996,1.919
2013/3/11,1245,8059,30,42,9,33,0.993,0.873
2013/3/11,1345,8043,-17,27,17,10,0.996,0.937
2013/3/12,945,8047,7,26,11,15,0.997,0.779
2013/3/12,1045,8041,-6,15,16,-1,0.998,1.46
2013/3/12,1145,8023,-20,23,22,1,1,1.168
2013/3/12,1245,8002,-21,29,25,4,1.003,0.875
2013/3/12,1345,7999,-4,21,5,16,1.003,0.877
2013/3/13,945,8014,14,35,21,14,1.001,0.638
2013/3/13,1045,7971,-44,49,46,3,1.007,0.638
2013/3/13,1145,7969,-3,30,12,18,1.006,0.828
2013/3/13,1245,7993,24,35,11,24,1.003,0.978
2013/3/13,1345,7990,-3,27,20,7,1.002,1.038
2013/3/14,945,7959,-38,47,29,18,1.005,0.576
2013/3/14,1045,7954,-5,19,16,3,1.005,1.341
2013/3/14,1145,7957,5,19,10,9,1.003,2.292
2013/3/14,1245,7968,11,19,5,14,1.001,2.413
2013/3/14,1345,7953,-15,23,18,5,1.003,1.395
2013/3/15,945,7950,-19,36,36,0,1.003,0.801
2013/3/15,1045,7945,-5,39,4,35,1.002,0.602
2013/3/15,1145,7966,22,35,5,30,0.999,1.092
2013/3/15,1245,7955,-11,15,11,4,1.001,2.18
2013/3/15,1345,7910,-44,52,48,4,1.006,0.733
2013/3/18,945,7835,-22,32,33,-1,1.014,0.64
2013/3/18,1045,7810,-25,34,35,-1,1.016,0.967
2013/3/18,1145,7825,15,23,8,15,1.012,1.548
2013/3/18,1245,7814,-12,18,14,4,1.012,2.323
2013/3/18,1345,7792,-22,26,24,2,1.012,0.889
2013/3/19,945,7827,-11,25,14,11,1.006,0.809
2013/3/19,1045,7839,12,19,7,12,1.003,1.509
2013/3/19,1145,7839,-1,13,4,9,1.002,2.142
2013/3/19,1245,7836,-3,18,16,2,1.001,1.733
2013/3/19,1345,7833,-3,12,5,7,0.999,1.353
2013/3/20,945,7820,40,54,12,42,1,0.748
2013/3/20,1045,7815,-6,31,27,4,1.001,1.345
2013/3/20,1145,7827,11,25,7,18,0.999,1.834
2013/3/20,1245,7815,-12,23,22,1,1.001,2.858
2013/3/21,945,7796,-7,44,29,15,1.003,0.39
2013/3/21,1045,7798,1,22,18,4,1.002,0.845
2013/3/21,1145,7802,5,18,6,12,1.001,1.323
2013/3/21,1245,7799,-3,13,9,4,1.001,2.258
2013/3/21,1345,7797,-3,12,6,6,1.001,1.261
2013/3/22,945,7788,8,50,26,24,1.001,0.52
2013/3/22,1045,7794,6,15,7,8,1.001,1.44
2013/3/22,1145,7797,3,11,2,9,1,2.681
2013/3/22,1245,7799,2,9,5,4,0.999,2.985
2013/3/22,1345,7776,-22,32,31,1,1.002,0.903
2013/3/25,945,7848,6,27,17,10,0.993,0.548
2013/3/25,1045,7836,-12,25,15,10,0.995,0.995
2013/3/25,1145,7840,4,9,4,5,0.995,1.935
2013/3/25,1245,7843,4,10,1,9,0.996,2.632
2013/3/25,1345,7851,8,16,1,15,0.995,1.075
2013/3/26,945,7839,-6,19,7,12,0.997,0.683
2013/3/26,1045,7827,-12,25,20,5,1,0.845
2013/3/26,1145,7837,10,13,4,9,0.999,1.656
2013/3/26,1245,7840,3,14,8,6,0.999,1.895
2013/3/26,1345,7836,-4,10,4,6,1,1.018
2013/3/27,945,7841,0,17,3,14,0.999,0.628
2013/3/27,1045,7860,20,24,16,8,0.997,0.426
2013/3/27,1145,7852,-8,12,10,2,0.998,1.492
2013/3/27,1245,7855,3,8,5,3,0.998,2.907
2013/3/27,1345,7860,5,18,10,8,0.997,0.876
2013/3/28,945,7841,-18,37,34,3,1,0.562
2013/3/28,1045,7838,-3,14,7,7,1,0.995
2013/3/28,1145,7836,-3,9,5,4,1.001,2.307
2013/3/28,1245,7838,2,7,2,5,1.001,3.472
2013/3/28,1345,7842,4,24,2,22,1,0.741
2013/3/29,945,7884,0,26,13,13,0.995,0.73
2013/3/29,1045,7882,-2,10,3,7,0.996,1.776
2013/3/29,1145,7881,-1,9,7,2,0.996,2.196
2013/3/29,1245,7912,31,37,6,31,0.993,0.745
2013/3/29,1345,7923,10,23,12,11,0.992,0.582
2013/4/1,945,7923,-15,24,18,6,0.993,0.837
2013/4/1,1045,7919,-4,19,8,11,0.995,1.22
2013/4/1,1145,7918,0,6,1,5,0.996,3.881
2013/4/1,1245,7914,-3,15,8,7,0.997,1.568
2013/4/1,1345,7920,6,8,-2,10,0.998,1.504
2013/4/2,945,7913,6,40,2,38,0.999,0.389
2013/4/2,1045,7918,4,11,5,6,0.999,1.059
2013/4/2,1145,7913,-5,10,7,3,1,2.433
2013/4/2,1245,7906,-7,22,21,1,1.001,1.161
2013/4/2,1345,7905,-1,22,5,17,1.001,0.76
2013/4/3,945,7926,-18,25,17,8,0.998,0.578
2013/4/3,1045,7921,-4,16,5,11,0.999,0.92
2013/4/3,1145,7917,-3,7,6,1,1,2.45
2013/4/3,1245,7915,-2,10,8,2,1,2.693
2013/4/3,1345,7934,19,19,2,17,0.997,0.797
2013/4/8,945,7767,-92,115,103,12,1.018,0.282
2013/4/8,1045,7747,-20,41,29,12,1.019,0.812
2013/4/8,1145,7760,13,21,0,21,1.015,1.746
2013/4/8,1245,7757,-2,15,10,5,1.014,1.907
2013/4/8,1345,7739,-19,32,26,6,1.014,0.814
2013/4/9,945,7741,24,26,3,23,1.011,0.869
2013/4/9,1045,7726,-15,25,24,1,1.01,1.304
2013/4/9,1145,7715,-12,18,10,8,1.009,1.294
2013/4/9,1245,7715,0,23,5,18,1.007,1.55
2013/4/9,1345,7709,-6,22,21,1,1.005,1.263
2013/4/10,945,7724,-13,21,15,6,1.001,0.845
2013/4/10,1045,7730,6,14,3,11,1,1.686
2013/4/10,1145,7730,0,13,10,3,1,1.693
2013/4/10,1245,7726,-3,13,11,2,1,2.436
2013/4/10,1345,7728,2,14,-1,15,0.999,1.049
2013/4/11,945,7765,-11,11,5,6,0.995,0.701
2013/4/11,1045,7801,37,47,8,39,0.991,0.525
2013/4/11,1145,7809,7,14,3,11,0.991,1.618
2013/4/11,1245,7811,3,9,5,4,0.992,1.919
2013/4/11,1345,7818,7,23,7,16,0.992,0.775
2013/4/12,945,7818,-4,19,12,7,0.993,0.776
2013/4/12,1045,7806,-12,25,19,6,0.996,0.971
2013/4/12,1145,7805,-1,13,7,6,0.997,1.895
2013/4/12,1245,7794,-12,14,13,1,0.999,1.98
2013/4/12,1345,7784,-10,13,13,0,1.002,1.016
2013/4/15,945,7797,34,54,19,35,1,0.507
2013/4/15,1045,7782,-16,31,22,9,1.002,0.747
2013/4/15,1145,7736,-47,55,48,7,1.008,0.736
2013/4/15,1245,7740,3,19,15,4,1.006,1.477
2013/4/15,1345,7763,22,27,3,24,1.003,0.95
2013/4/16,945,7713,3,43,23,20,1.008,0.574
2013/4/16,1045,7719,5,23,4,19,1.005,1.068
2013/4/16,1145,7746,27,33,2,31,1.001,1.246
2013/4/16,1245,7760,14,27,12,15,0.998,0.972
2013/4/16,1345,7780,19,29,6,23,0.995,0.985
2013/4/17,945,7777,-6,26,21,5,0.996,1.081
2013/4/17,1045,7782,4,21,13,8,0.995,2.166
2013/4/17,1145,7791,9,21,12,9,0.994,1.659
2013/4/17,1245,7793,2,19,1,18,0.994,2.268
2013/4/18,945,7744,29,109,65,44,1,0.379
2013/4/18,1045,7764,20,34,11,23,0.998,0.731
2013/4/18,1145,7762,-2,23,12,11,0.999,1.428
2013/4/18,1245,7754,-8,11,10,1,1.001,2.828
2013/4/18,1345,7751,-3,23,9,14,1.001,0.902
2013/4/19,945,7883,99,98,5,93,0.985,0.366
2013/4/19,1045,7912,29,44,15,29,0.982,0.714
2013/4/19,1145,7915,2,19,10,9,0.984,2.011
2013/4/19,1245,7929,13,22,-1,23,0.984,2.364
2013/4/19,1345,7944,15,30,-1,31,0.983,1.142
2013/4/22,945,7967,15,32,9,23,0.984,0.804
2013/4/22,1045,7957,-9,10,8,2,0.988,3.031
2013/4/22,1145,7959,1,11,5,6,0.99,3.841
2013/4/22,1245,7959,0,6,3,3,0.992,6.209
2013/4/22,1345,7953,-6,22,7,15,0.996,1.195
2013/4/23,945,7925,-17,23,21,2,1.001,0.774
2013/4/23,1045,7910,-15,17,12,5,1.004,0.74
2013/4/23,1145,7907,-4,19,8,11,1.004,0.989
2013/4/23,1245,7909,2,11,4,7,1.004,3.187
2013/4/23,1345,7928,19,23,0,23,1.001,0.869
2013/4/24,945,7958,-9,44,35,9,0.997,0.403
2013/4/24,1045,7977,19,36,9,27,0.995,0.801
2013/4/24,1145,8008,32,47,7,40,0.991,0.673
2013/4/24,1245,7989,-20,23,19,4,0.994,1.686
2013/4/24,1345,7991,2,20,19,1,0.994,1.043
2013/4/25,945,7987,11,28,11,17,0.995,0.859
2013/4/25,1045,7992,4,20,5,15,0.995,1.485
2013/4/25,1145,8006,14,19,3,16,0.995,1.226
2013/4/25,1245,7991,-14,18,15,3,0.998,2.076
2013/4/25,1345,8004,13,23,5,18,0.997,1.339
2013/4/26,945,8052,42,64,11,53,0.992,0.507
2013/4/26,1045,8037,-15,31,29,2,0.995,0.978
2013/4/26,1145,8041,4,15,4,11,0.995,1.917
2013/4/26,1245,8024,-18,25,19,6,0.998,1.413
2013/4/26,1345,7998,-25,34,33,1,1.001,0.901
2013/4/29,945,8025,15,30,8,22,0.998,0.765
2013/4/29,1045,8028,2,22,14,8,0.998,1.101
2013/4/29,1145,8019,-10,15,10,5,1,2.07
2013/4/29,1245,8024,5,12,6,6,0.999,2.673
2013/4/29,1345,8023,-1,18,7,11,1,1.26
2013/4/30,945,8103,36,48,19,29,0.991,0.394
2013/4/30,1045,8104,1,15,4,11,0.991,1.521
2013/4/30,1145,8100,-3,10,5,5,0.993,2.733
2013/4/30,1245,8105,5,13,7,6,0.993,1.988
2013/4/30,1345,8098,-7,19,11,8,0.995,0.926
2013/4/30,845,8084,8084,-99999,-8084,-91915,0.897,#DIV/0!
2013/5/2,945,8093,9,25,18,7,0.897,0.656
2013/5/2,1045,8112,19,28,6,22,0.896,0.936
2013/5/2,1145,8123,11,16,2,14,0.896,1.275
2013/5/2,1245,8117,-6,14,10,4,0.897,1.578
2013/5/2,1345,8120,3,10,2,8,0.898,0.853
2013/5/2,845,8150,8150,-99999,-8150,-91849,0.795,#DIV/0!
2013/5/3,945,8152,3,31,22,9,0.795,0.373
2013/5/3,1045,8163,11,13,2,11,0.795,1.11
2013/5/3,1145,8146,-16,24,18,6,0.797,1.083
2013/5/3,1245,8127,-19,30,22,8,0.899,0.846
2013/5/3,1345,8140,13,17,-1,18,0.899,0.94
2013/5/3,845,8205,8205,-99999,-8205,-91794,0.793,#DIV/0!
2013/5/6,945,8174,-29,42,35,7,0.797,0.495
2013/5/6,1045,8166,-9,22,12,10,0.798,0.977
2013/5/6,1145,8167,1,14,1,13,0.799,1.489
2013/5/6,1245,8164,-3,13,8,5,0.899,2.418
2013/5/6,1345,8169,5,12,-1,13,0.899,1.032
2013/5/6,845,8172,8172,-99999,-8172,-91827,0.799,#DIV/0!
2013/5/7,945,8162,-11,23,11,12,0.8,0.522
2013/5/7,1045,8168,7,18,7,11,0.799,0.97
2013/5/7,1145,8173,5,9,-1,10,0.799,1.977
2013/5/7,1245,8177,4,19,10,9,0.899,0.978
2013/5/7,1345,8173,-4,8,6,2,0.899,1.007
2013/5/7,845,8186,8186,-99999,-8186,-91813,0.798,#DIV/0!
2013/5/8,945,8253,65,69,3,66,0.792,0.273
2013/5/8,1045,8277,24,49,25,24,0.79,0.4
2013/5/8,1145,8264,-13,33,15,18,0.793,0.85
2013/5/8,1245,8264,0,18,4,14,0.893,1.647
2013/5/8,1345,8268,4,19,10,9,0.894,0.924
2013/5/8,845,8301,8301,-99999,-8301,-91698,0.792,#DIV/0!
2013/5/9,945,8307,6,34,17,17,0.793,0.561
2013/5/9,1045,8313,6,25,17,8,0.794,0.975
2013/5/9,1145,8307,-5,13,8,5,0.796,2.546
2013/5/9,1245,8314,8,14,7,7,0.895,2.58
2013/5/9,1345,8313,-2,13,4,9,0.897,1.249
2013/5/9,845,8293,8293,-99999,-8293,-91706,0.8,#DIV/0!
2013/5/10,945,8299,3,23,4,19,0.799,0.594
2013/5/10,1045,8295,-2,18,14,4,0.8,1.117
2013/5/10,1145,8290,-5,9,7,2,0.801,1.892
2013/5/10,1245,8290,0,13,4,9,0.901,1.572
2013/5/10,1345,8312,23,21,-5,26,0.898,0.944
2013/5/10,845,8313,8313,-99999,-8313,-91686,0.798,#DIV/0!
2013/5/13,945,8280,-33,46,27,19,0.801,0.362
2013/5/13,1045,8249,-31,41,31,10,0.804,0.568
2013/5/13,1145,8244,-5,26,11,15,0.804,0.878
2013/5/13,1245,8251,7,17,3,14,0.903,2.035
2013/5/13,1345,8260,9,20,4,16,0.902,0.904
2013/5/13,845,8277,8277,-99999,-8277,-91722,0.799,#DIV/0!
2013/5/14,945,8298,20,21,9,12,0.797,0.526
2013/5/14,1045,8282,-16,17,17,0,0.799,1.196
2013/5/14,1145,8264,-18,39,19,20,0.801,0.615
2013/5/14,1245,8272,8,14,3,11,0.9,1.791
2013/5/14,1345,8274,1,19,8,11,0.899,0.956
2013/5/14,845,8300,8300,-99999,-8300,-91699,0.796,#DIV/0!
2013/5/15,945,8279,-21,42,32,10,0.799,0.607
2013/5/15,1045,8279,1,23,4,19,0.799,1.022
2013/5/15,1145,8281,3,19,11,8,0.8,2.018
2013/5/15,1245,8286,5,11,7,4,0.899,4.202
2013/5/15,845,8328,42,25,-24,49,0.895,0.936
2013/5/16,945,8376,49,64,32,32,0.89,0.33
2013/5/16,1045,8401,24,23,-1,24,0.888,0.822
2013/5/16,1145,8419,18,24,17,7,0.888,0.636
2013/5/16,1245,8427,8,19,13,6,0.889,1.288
2013/5/16,1345,8423,-4,20,9,11,0.989,0.87
2013/5/16,845,8405,8405,-99999,-8405,-91594,0.893,#DIV/0!
2013/5/17,945,8410,6,20,2,18,0.894,0.766
2013/5/17,1045,8415,5,15,8,7,0.895,1.479
2013/5/17,1145,8413,-1,11,3,8,0.897,3.055
2013/5/17,1245,8405,-8,11,8,3,0.899,3.335
2013/5/17,1345,8403,-3,20,3,17,0.9,0.846
2013/5/17,845,8399,8399,-99999,-8399,-91600,0.801,#DIV/0!
2013/5/20,945,8374,-25,58,25,33,0.803,0.35
2013/5/20,1045,8377,3,16,6,10,0.802,1.111
2013/5/20,1145,8367,-10,16,13,3,0.803,1.606
2013/5/20,1245,8386,19,17,-1,18,0.901,2.063
2013/5/20,1345,8386,0,16,2,14,0.9,0.799
2013/5/20,845,8379,8379,-99999,-8379,-91620,0.801,#DIV/0!
2013/5/21,945,8393,14,21,6,15,0.799,0.561
2013/5/21,1045,8424,31,50,17,33,0.796,0.47
2013/5/21,1145,8374,-50,71,54,17,0.801,0.487
2013/5/21,1245,8378,4,15,4,11,0.9,1.887
2013/5/21,1345,8390,12,14,2,12,0.899,1.089
2013/5/21,845,8426,8426,-99999,-8426,-91573,0.796,#DIV/0!
2013/5/22,945,8412,-14,42,36,6,0.797,0.497
2013/5/22,1045,8407,-5,20,13,7,0.799,1.147
2013/5/22,1145,8416,9,15,2,13,0.798,2.102
2013/5/22,1245,8410,-7,24,6,18,0.899,1.064
2013/5/22,1345,8394,-16,17,18,-1,0.901,1.461
2013/5/22,845,8336,8336,-99999,-8336,-91663,0.806,#DIV/0!
2013/5/23,945,8353,17,31,0,31,0.804,0.494
2013/5/23,1045,8269,-83,91,78,13,0.811,0.334
2013/5/23,1145,8262,-8,25,15,10,0.811,1.159
2013/5/23,1245,8241,-21,33,23,10,0.913,1.026
2013/5/23,1345,8213,-28,38,35,3,0.914,0.656
2013/5/23,845,8230,8230,-99999,-8230,-91769,0.81,#DIV/0!
2013/5/24,945,8236,4,23,12,11,0.807,0.935
2013/5/24,1045,8235,-3,21,2,19,0.805,1.212
2013/5/24,1145,8227,-8,15,8,7,0.804,2.6
2013/5/24,1245,8149,-78,62,76,-14,0.912,0.793
2013/5/24,1345,8222,74,74,5,69,0.902,0.683
2013/5/24,845,8195,8195,-99999,-8195,-91804,0.803,#DIV/0!
2013/5/27,945,8219,27,38,12,26,0.8,0.705
2013/5/27,1045,8247,28,54,18,36,0.797,0.679
2013/5/27,1145,8250,3,16,8,8,0.796,1.428
2013/5/27,1245,8252,3,10,5,5,0.896,2.664
2013/5/27,1345,8256,4,18,12,6,0.896,0.9
2013/5/27,845,8268,8268,-99999,-8268,-91731,0.795,#DIV/0!
2013/5/28,945,8281,13,35,-1,36,0.794,0.625
2013/5/28,1045,8272,-8,21,7,14,0.796,1.231
2013/5/28,1145,8269,-3,21,3,18,0.797,1.474
2013/5/28,1245,8268,1,13,3,10,0.897,2.112
2013/5/28,1345,8258,-9,13,10,3,0.899,1.196
2013/5/28,845,8257,8257,-99999,-8257,-91742,0.8,#DIV/0!
2013/5/29,945,8301,44,57,15,42,0.796,0.332
2013/5/29,1045,8318,17,29,7,22,0.795,0.875
2013/5/29,1145,8333,14,18,4,14,0.794,0.875
2013/5/29,1245,8338,5,19,7,12,0.894,1.404
2013/5/29,1345,8312,-27,31,29,2,0.897,0.6
2013/5/29,845,8299,8299,-99999,-8299,-91700,0.799,#DIV/0!
2013/5/30,945,8293,-6,34,7,27,0.8,0.555
2013/5/30,1045,8277,-16,28,25,3,0.802,1.161
2013/5/30,1145,8212,-65,80,72,8,0.808,0.503
2013/5/30,1245,8228,16,34,11,23,0.907,1.096
2013/5/30,1345,8231,2,35,20,15,0.906,0.764
2013/5/30,845,8278,8278,-99999,-8278,-91721,0.8,#DIV/0!
2013/5/31,945,8282,6,82,60,22,0.8,0.44
2013/5/31,1045,8276,-5,24,11,13,0.799,1.446
2013/5/31,1145,8250,-26,51,33,18,0.801,0.856
2013/5/31,1245,8246,-4,37,24,13,0.902,1.274
2013/5/31,1345,8242,-2,23,7,16,0.901,0.93
2013/5/31,845,8136,8136,-99999,-8136,-91863,0.811,#DIV/0!
2013/6/3,945,8172,36,76,20,56,0.806,0.501
2013/6/3,1045,8189,17,36,9,27,0.804,1.076
2013/6/3,1145,8194,7,28,10,18,0.803,1.215
2013/6/3,1245,8183,-10,20,22,-2,0.904,2.399
2013/6/3,1345,8193,9,17,8,9,0.902,1.185
2013/6/3,845,8226,8226,-99999,-8226,-91773,0.797,#DIV/0!
2013/6/4,945,8177,-49,50,42,8,0.802,0.576
2013/6/4,1045,8177,0,33,8,25,0.801,0.756
2013/6/4,1145,8164,-14,19,16,3,0.801,1.374
2013/6/4,1245,8175,12,29,4,25,0.9,1.424
2013/6/4,1345,8162,-13,16,15,1,0.902,1.109
2013/6/4,845,8125,8125,-99999,-8125,-91874,0.805,#DIV/0!
2013/6/5,945,8159,34,36,8,28,0.801,0.489
2013/6/5,1045,8179,19,41,17,24,0.799,0.673
2013/6/5,1145,8178,-2,16,6,10,0.799,1.752
2013/6/5,1245,8159,-19,33,22,11,0.901,1.309
2013/6/5,1345,8145,-14,22,19,3,0.902,0.994
2013/6/5,845,8095,8095,-99999,-8095,-91904,0.806,#DIV/0!
2013/6/6,945,8069,-26,68,60,8,0.808,0.338
2013/6/6,1045,8080,9,22,13,9,0.806,1.023
2013/6/6,1145,8084,5,26,8,18,0.804,1.202
2013/6/6,1245,8068,-16,20,15,5,0.906,1.52
2013/6/6,1345,8103,35,38,-3,41,0.901,0.795
2013/6/6,845,8086,8086,-99999,-8086,-91913,0.802,#DIV/0!
2013/6/7,945,8099,16,33,11,22,0.8,0.6
2013/6/7,1045,8075,-24,32,24,8,0.801,0.874
2013/6/7,1145,8072,-4,19,11,8,0.8,1.377
2013/6/7,1245,8069,-3,25,5,20,0.901,1.035
2013/6/7,1345,8087,18,21,3,18,0.898,0.835
2013/6/7,845,8142,8142,-99999,-8142,-91857,0.793,#DIV/0!
2013/6/10,945,8137,-9,36,27,9,0.795,0.582
2013/6/10,1045,8174,36,53,11,42,0.792,0.736
2013/6/10,1145,8168,-6,10,7,3,0.794,1.589
2013/6/10,1245,8164,-4,14,7,7,0.894,1.925
2013/6/10,1345,8147,-18,26,18,8,0.897,0.9
2013/6/10,845,8131,8131,-99999,-8131,-91868,0.799,#DIV/0!
2013/6/11,945,8148,17,29,9,20,0.798,0.699
2013/6/11,1045,8134,-13,19,17,2,0.8,1.296
2013/6/11,1145,8127,-7,28,8,20,0.802,0.599
2013/6/11,1245,8124,-3,11,7,4,0.902,2.05
2013/6/11,1345,8128,4,22,6,16,0.901,0.878
2013/6/11,845,8046,8046,-99999,-8046,-91953,0.809,#DIV/0!
2013/6/13,945,7979,-67,69,69,0,0.815,0.298
2013/6/13,1045,7967,-12,29,13,16,0.814,0.695
2013/6/13,1145,7965,-1,15,12,3,0.811,1.654
2013/6/13,1245,7958,-6,21,13,8,0.912,1.362
2013/6/13,1345,7933,-25,35,33,2,0.913,0.762
2013/6/13,845,7983,7983,-99999,-7983,-92016,0.805,#DIV/0!
2013/6/14,945,7949,-35,38,29,9,0.806,0.71
2013/6/14,1045,7948,-1,24,14,10,0.804,1.211
2013/6/14,1145,7917,-31,37,33,4,0.805,0.973
2013/6/14,1245,7926,9,34,13,21,0.904,1.16
2013/6/14,1345,7920,-6,20,18,2,0.903,1.054
2013/6/14,845,7922,7922,-99999,-7922,-92077,0.802,#DIV/0!
2013/6/17,945,7953,30,41,14,27,0.799,0.559
2013/6/17,1045,7960,7,18,9,9,0.798,1.305
2013/6/17,1145,7980,21,22,-2,24,0.796,1.219
2013/6/17,1245,7971,-9,14,7,7,0.897,2.068
2013/6/17,1345,7973,2,21,9,12,0.897,0.911
2013/6/17,845,7971,7971,-99999,-7971,-92028,0.797,#DIV/0!
2013/6/18,945,7946,-27,43,39,4,0.8,0.466
2013/6/18,1045,7970,24,27,-6,33,0.798,0.974
2013/6/18,1145,8008,38,44,3,41,0.795,0.535
2013/6/18,1245,7997,-11,17,13,4,0.896,1.539
2013/6/18,1345,7994,-2,19,10,9,0.897,0.799
2013/6/18,845,8003,8003,-99999,-8003,-91996,0.797,#DIV/0!
2013/6/19,945,8014,11,30,24,6,0.796,0.659
2013/6/19,1045,7994,-21,29,22,7,0.799,1.037
2013/6/19,1145,8019,25,31,1,30,0.796,1.757
2013/6/19,1245,8013,-6,12,9,3,0.897,2.887
2013/6/19,845,7795,-218,10,229,-219,0.923,1.196
2013/6/20,945,7790,-3,34,29,5,0.921,0.507
2013/6/20,1045,7768,-21,32,12,20,0.922,0.516
2013/6/20,1145,7761,-7,31,16,15,0.919,1.085
2013/6/20,1245,7742,-19,19,17,2,0.919,1.314
2013/6/20,1345,7748,6,21,12,9,1.018,0.776
2013/6/20,845,7604,7604,-99999,-7604,-92395,0.932,#DIV/0!
2013/6/21,945,7638,37,54,5,49,0.922,0.405
2013/6/21,1045,7668,30,46,12,34,0.914,0.667
2013/6/21,1145,7640,-28,34,30,4,0.913,1.206
2013/6/21,1245,7640,-1,30,12,18,0.908,1.23
2013/6/21,1345,7658,18,35,17,18,0.904,0.88
2013/6/21,845,7628,7628,-99999,-7628,-92371,0.805,#DIV/0!
2013/6/24,945,7619,-9,32,21,11,0.804,0.639
2013/6/24,1045,7638,19,33,-3,36,0.8,1.088
2013/6/24,1145,7626,-12,20,10,10,0.8,1.831
2013/6/24,1245,7652,26,42,11,31,0.897,1.165
2013/6/24,1345,7630,-21,33,31,2,0.901,0.959
2013/6/24,845,7608,7608,-99999,-7608,-92391,0.803,#DIV/0!
2013/6/25,945,7649,40,79,18,61,0.798,0.378
2013/6/25,1045,7677,28,36,6,30,0.795,0.762
2013/6/25,1145,7619,-57,92,56,36,0.801,0.603
2013/6/25,1245,7606,-14,42,16,26,0.903,0.913
2013/6/25,1345,7606,-1,44,26,18,0.903,0.683
2013/6/25,845,7654,7654,-99999,-7654,-92345,0.797,#DIV/0!
2013/6/26,945,7647,-7,56,42,14,0.798,0.579
2013/6/26,1045,7627,-20,54,36,18,0.801,0.895
2013/6/26,1145,7637,10,27,8,19,0.799,1.485
2013/6/26,1245,7649,13,31,9,22,0.898,1.666
2013/6/26,1345,7637,-13,27,27,0,0.9,1.087
2013/6/26,845,7735,7735,-99999,-7735,-92264,0.79,#DIV/0!
2013/6/27,945,7710,-25,34,24,10,0.793,0.673
2013/6/27,1045,7728,19,38,17,21,0.792,0.977
2013/6/27,1145,7726,-4,21,7,14,0.794,1.353
2013/6/27,1245,7721,-5,14,7,7,0.895,2.623
2013/6/27,1345,7713,-8,16,15,1,0.896,1.036
2013/6/27,845,7760,7760,-99999,-7760,-92239,0.792,#DIV/0!
2013/6/28,945,7743,-15,25,11,14,0.796,0.603
2013/6/28,1045,7794,50,57,4,53,0.792,0.461
2013/6/28,1145,7792,-2,16,4,12,0.794,1.387
2013/6/28,1245,7793,1,12,7,5,0.894,2.008
2013/6/28,1345,7828,36,71,32,39,0.891,0.473
2013/7/1,945,7850,31,33,2,31,0.89,0.772
2013/7/1,1045,7887,38,55,11,44,0.887,0.764
2013/7/1,1145,7881,-6,32,19,13,0.89,1.251
2013/7/1,1245,7909,28,33,7,26,0.889,1.107
2013/7/1,1345,7903,-4,18,11,7,0.989,1.289
2013/7/1,845,7906,7906,-99999,-7906,-92093,0.891,#DIV/0!
2013/7/2,945,7886,-17,37,34,3,0.895,0.648
2013/7/2,1045,7895,9,21,6,15,0.895,1.338
2013/7/2,1145,7894,-2,17,14,3,0.897,2.143
2013/7/2,1245,7890,-4,10,10,0,0.898,3.727
2013/7/2,1345,7906,15,21,1,20,0.897,1.146
2013/7/2,845,7886,7886,-99999,-7886,-92113,0.8,#DIV/0!
2013/7/3,945,7840,-45,52,54,-2,0.805,0.42
2013/7/3,1045,7831,-9,25,15,10,0.805,0.643
2013/7/3,1145,7824,-7,23,9,14,0.805,0.937
2013/7/3,1245,7815,-9,17,10,7,0.906,1.495
2013/7/3,1345,7811,-4,16,11,5,0.905,0.767
2013/7/3,845,7838,7838,-99999,-7838,-92161,0.802,#DIV/0!
2013/7/4,945,7841,1,28,8,20,0.801,0.596
2013/7/4,1045,7824,-17,38,16,22,0.802,0.784
2013/7/4,1145,7858,35,42,5,37,0.797,0.706
2013/7/4,1245,7840,-18,20,16,4,0.899,1.766
2013/7/4,1345,7844,3,17,6,11,0.898,1.117
2013/7/4,845,7888,7888,-99999,-7888,-92111,0.794,#DIV/0!
2013/7/5,945,7959,71,93,5,88,0.788,#DIV/0!
2013/7/5,1045,7954,-6,23,17,6,0.79,#DIV/0!
2013/7/5,1145,7977,22,23,-2,25,0.789,#DIV/0!
2013/7/5,1245,7964,-13,21,13,8,0.891,#DIV/0!
2013/7/5,1345,7965,0,19,8,11,0.892,#DIV/0!
2013/7/5,845,7957,7957,-99999,-7957,-92042,0.795,#DIV/0!
2013/7/8,945,7872,-86,89,92,-3,0.805,#DIV/0!
2013/7/8,1045,7839,-33,30,19,11,0.808,#DIV/0!
2013/7/8,1145,7841,1,21,12,9,0.808,#DIV/0!
2013/7/8,1245,7836,-5,26,10,16,0.909,#DIV/0!
2013/7/8,1345,7830,-6,21,11,10,0.909,#DIV/0!
2013/7/8,845,7831,7831,-99999,-7831,-92168,0.807,#DIV/0!
2013/7/9,945,7880,50,44,4,40,0.801,#DIV/0!
2013/7/9,1045,7889,9,42,31,11,0.798,#DIV/0!
2013/7/9,1145,7907,19,28,9,19,0.796,#DIV/0!
2013/7/9,1245,7916,9,16,7,9,0.895,#DIV/0!
2013/7/9,1345,7924,8,19,7,12,0.893,#DIV/0!
2013/7/9,845,7941,7941,-99999,-7941,-92058,0.792,#DIV/0!
2013/7/10,945,7999,59,81,15,66,0.788,#DIV/0!
2013/7/10,1045,7973,-26,52,44,8,0.792,#DIV/0!
2013/7/10,1145,7984,10,17,2,15,0.793,#DIV/0!
2013/7/10,1245,7955,-30,44,35,9,0.896,#DIV/0!
2013/7/10,1345,7961,6,42,2,40,0.897,#DIV/0!
2013/7/10,845,8061,8061,-99999,-8061,-91938,0.788,#DIV/0!
2013/7/11,945,8103,39,30,5,25,0.786,#DIV/0!
2013/7/11,1045,8130,27,43,0,43,0.786,#DIV/0!
2013/7/11,1145,8156,25,28,-6,34,0.786,#DIV/0!
2013/7/11,1245,8143,-13,23,11,12,0.887,#DIV/0!
2013/7/11,1345,8163,20,28,3,25,0.888,#DIV/0!
2013/7/11,845,8163,8163,-99999,-8163,-91836,0.79,#DIV/0!
2013/7/12,945,8161,-2,41,18,23,0.792,#DIV/0!
2013/7/12,1045,8156,-4,19,12,7,0.795,#DIV/0!
2013/7/12,1145,8150,-5,20,11,9,0.798,#DIV/0!
2013/7/12,1245,8161,12,19,4,15,0.897,#DIV/0!
2013/7/12,1345,8176,16,29,8,21,0.896,#DIV/0!
2013/7/12,845,8137,8137,-99999,-8137,-91862,0.801,#DIV/0!
2013/7/15,945,8187,47,60,11,49,0.796,#DIV/0!
2013/7/15,1045,8228,41,52,10,42,0.793,#DIV/0!
2013/7/15,1145,8221,-7,15,6,9,0.794,#DIV/0!
2013/7/15,1245,8194,-27,50,26,24,0.897,#DIV/0!
2013/7/15,1345,8216,22,36,10,26,0.895,#DIV/0!
2013/7/15,845,8222,8222,-99999,-8222,-91777,0.795,#DIV/0!
2013/7/16,945,8217,-7,19,7,12,0.797,#DIV/0!
2013/7/16,1045,8210,-6,27,10,17,0.798,#DIV/0!
2013/7/16,1145,8215,5,12,8,4,0.798,#DIV/0!
2013/7/16,1245,8219,4,21,13,8,0.898,#DIV/0!
2013/7/16,1345,8230,11,16,3,13,0.898,#DIV/0!
2013/7/16,845,8214,8214,-99999,-8214,-91785,0.8,#DIV/0!
2013/7/17,945,8230,16,44,27,17,0.798,#DIV/0!
2013/7/17,1045,8242,12,44,4,40,0.797,#DIV/0!
2013/7/17,1145,8232,-10,14,10,4,0.798,#DIV/0!
2013/7/17,1245,8232,-1,15,6,9,0.898,#DIV/0!
2013/7/17,845,8153,-80,15,91,-76,0.907,#DIV/0!
2013/7/18,945,8102,-50,67,67,0,0.912,#DIV/0!
2013/7/18,1045,8101,-1,30,19,11,0.911,#DIV/0!
2013/7/18,1145,8114,13,25,-1,26,0.908,#DIV/0!
2013/7/18,1245,8107,-7,16,5,11,0.908,#DIV/0!
2013/7/18,1345,8096,-11,16,20,-4,1.009,#DIV/0!
2013/7/18,845,8057,8057,-99999,-8057,-91942,0.912,#DIV/0!
2013/7/19,945,7996,-61,84,77,7,0.917,#DIV/0!
2013/7/19,1045,8015,19,39,5,34,0.911,#DIV/0!
2013/7/19,1145,7985,-29,30,28,2,0.912,#DIV/0!
2013/7/19,1245,7960,-25,47,40,7,0.912,#DIV/0!
2013/7/19,1345,7955,-5,27,27,0,0.91,#DIV/0!
2013/7/19,845,7972,7972,-99999,-7972,-92027,0.806,#DIV/0!
2013/7/22,945,8048,76,50,-11,61,0.797,#DIV/0!
2013/7/22,1045,8036,-10,25,6,19,0.798,#DIV/0!
2013/7/22,1145,8023,-13,20,11,9,0.798,#DIV/0!
2013/7/22,1245,8024,1,15,4,11,0.898,#DIV/0!
2013/7/22,1345,8022,-1,13,9,4,0.898,#DIV/0!
2013/7/22,845,8070,8070,-99999,-8070,-91929,0.793,#DIV/0!
2013/7/23,945,8104,34,38,1,37,0.791,#DIV/0!
2013/7/23,1045,8136,32,25,-2,27,0.789,#DIV/0!
2013/7/23,1145,8146,10,21,10,11,0.79,#DIV/0!
2013/7/23,1245,8121,-26,38,33,5,0.893,#DIV/0!
2013/7/23,1345,8134,13,21,10,11,0.893,#DIV/0!
2013/7/23,845,8147,8147,-99999,-8147,-91852,0.793,#DIV/0!
2013/7/24,945,8129,-19,37,16,21,0.796,#DIV/0!
2013/7/24,1045,8115,-12,21,6,15,0.799,#DIV/0!
2013/7/24,1145,8124,10,17,3,14,0.799,#DIV/0!
2013/7/24,1245,8120,-4,13,4,9,0.9,#DIV/0!
2013/7/24,1345,8126,6,12,4,8,0.9,#DIV/0!
2013/7/24,845,8100,8100,-99999,-8100,-91899,0.802,#DIV/0!
2013/7/25,945,8127,28,102,31,71,0.799,#DIV/0!
2013/7/25,1045,8130,4,21,13,8,0.799,#DIV/0!
2013/7/25,1145,8120,-10,25,8,17,0.8,#DIV/0!
2013/7/25,1245,8116,-3,23,18,5,0.9,#DIV/0!
2013/7/25,1345,8107,-9,17,17,0,0.901,#DIV/0!
2013/7/25,845,8108,8108,-99999,-8108,-91891,0.801,#DIV/0!
2013/7/26,945,8100,-9,95,83,12,0.801,#DIV/0!
2013/7/26,1045,8111,13,27,16,11,0.8,#DIV/0!
2013/7/26,1145,8111,2,14,4,10,0.8,#DIV/0!
2013/7/26,1245,8105,-6,23,11,12,0.9,#DIV/0!
2013/7/26,1345,8100,-5,12,7,5,0.901,#DIV/0!
2013/7/26,845,8083,8083,-99999,-8083,-91916,0.802,#DIV/0!
2013/7/29,945,8068,-13,55,40,15,0.803,#DIV/0!
2013/7/29,1045,8061,-6,31,12,19,0.803,#DIV/0!
2013/7/29,1145,8057,-4,15,11,4,0.803,#DIV/0!
2013/7/29,1245,8032,-26,43,36,7,0.906,#DIV/0!
2013/7/29,1345,8035,4,26,8,18,0.905,#DIV/0!
2013/7/29,845,8064,8064,-99999,-8064,-91935,0.801,#DIV/0!
2013/7/30,945,8085,21,34,11,23,0.798,#DIV/0!
2013/7/30,1045,8115,30,32,0,32,0.795,#DIV/0!
2013/7/30,1145,8140,25,22,5,17,0.793,#DIV/0!
2013/7/30,1245,8132,-8,12,9,3,0.894,#DIV/0!
2013/7/30,1345,8130,-3,26,8,18,0.894,#DIV/0!
2013/7/30,845,8120,8120,-99999,-8120,-91879,0.796,#DIV/0!
2013/7/31,945,8101,-19,47,32,15,0.799,#DIV/0!
2013/7/31,1045,8080,-21,27,35,-8,0.801,#DIV/0!
2013/7/31,1145,8085,5,18,3,15,0.801,#DIV/0!
2013/7/31,1245,8078,-6,15,11,4,0.902,#DIV/0!
2013/7/31,1345,8049,-29,42,45,-3,0.906,#DIV/0!
2013/8/1,945,8032,-16,80,48,32,0.907,0.1
2013/8/1,1045,8058,26,32,9,23,0.903,0.431
2013/8/1,1145,8033,-26,38,31,7,0.905,0.532
2013/8/1,1245,8029,-4,19,13,6,0.904,1.202
2013/8/1,1345,8045,16,24,-2,26,1.002,0.587
2013/8/1,845,8100,8100,-99999,-8100,-91899,0.895,#DIV/0!
2013/8/2,945,8124,24,51,22,29,0.892,0.313
2013/8/2,1045,8065,-59,50,60,-10,0.9,0.677
2013/8/2,1145,8066,1,30,12,18,0.899,0.96
2013/8/2,1245,8062,-5,14,8,6,0.899,2.342
2013/8/2,1345,8060,-2,27,20,7,0.9,0.95
2013/8/2,845,8073,8073,-99999,-8073,-91926,0.799,#DIV/0!
2013/8/5,945,8066,-5,53,9,44,0.8,0.51
2013/8/5,1045,8087,22,39,3,36,0.798,1.056
2013/8/5,1145,8105,18,24,-5,29,0.797,1.291
2013/8/5,1245,8094,-10,18,14,4,0.898,1.952
2013/8/5,1345,8098,3,21,8,13,0.898,1.125
2013/8/5,845,8056,8056,-99999,-8056,-91943,0.802,#DIV/0!
2013/8/6,945,8001,-56,69,74,-5,0.807,0.356
2013/8/6,1045,7980,-21,35,27,8,0.808,0.69
2013/8/6,1145,7990,10,20,6,14,0.806,1.565
2013/8/6,1245,7987,-2,17,7,10,0.907,2.33
2013/8/6,1345,7991,4,16,8,8,0.905,0.893
2013/8/6,845,7937,7937,-99999,-7937,-92062,0.81,#DIV/0!
2013/8/7,945,7926,-5,35,9,26,0.809,0.475
2013/8/7,1045,7905,-21,38,25,13,0.809,0.912
2013/8/7,1145,7906,1,12,7,5,0.806,2.509
2013/8/7,1245,7899,-7,12,7,5,0.907,1.878
2013/8/7,1345,7845,-54,49,52,-3,0.911,0.592
2013/8/7,845,7876,7876,-99999,-7876,-92123,0.806,#DIV/0!
2013/8/8,945,7874,-2,22,4,18,0.805,0.56
2013/8/8,1045,7878,5,16,4,12,0.803,1.21
2013/8/8,1145,7886,8,21,7,14,0.801,1.12
2013/8/8,1245,7881,-5,8,9,-1,0.901,3.19
2013/8/8,1345,7846,-35,40,38,2,0.905,0.677
2013/8/8,845,7846,7846,-99999,-7846,-92153,0.804,#DIV/0!
2013/8/9,945,7849,3,58,18,40,0.803,0.349
2013/8/9,1045,7858,8,41,24,17,0.801,0.867
2013/8/9,1145,7817,-41,56,41,15,0.805,0.711
2013/8/9,1245,7827,10,25,5,20,0.904,1.421
2013/8/9,1345,7825,-2,25,12,13,0.903,0.856
2013/8/9,845,7850,7850,-99999,-7850,-92149,0.8,#DIV/0!
2013/8/12,945,7840,-10,38,18,20,0.801,0.666
2013/8/12,1045,7860,20,34,13,21,0.798,0.899
2013/8/12,1145,7864,4,24,18,6,0.797,1.34
2013/8/12,1245,7860,-3,16,8,8,0.898,3.169
2013/8/12,1345,7860,0,17,13,4,0.898,1.338
2013/8/12,845,7893,7893,-99999,-7893,-92106,0.795,#DIV/0!
2013/8/13,945,7938,44,51,12,39,0.791,0.391
2013/8/13,1045,7936,-2,19,9,10,0.792,1.282
2013/8/13,1145,7949,13,24,9,15,0.793,0.993
2013/8/13,1245,7949,-1,11,7,4,0.893,2.417
2013/8/13,1345,7954,5,21,5,16,0.893,0.718
2013/8/13,845,7960,7960,-99999,-7960,-92039,0.794,#DIV/0!
2013/8/14,945,7912,-45,43,43,0,0.8,0.513
2013/8/14,1045,7911,-2,24,10,14,0.801,0.732
2013/8/14,1145,7896,-16,21,13,8,0.803,1.107
2013/8/14,1245,7903,8,15,4,11,0.902,2.167
2013/8/14,1345,7928,25,28,3,25,0.9,0.712
2013/8/14,845,7843,7843,-99999,-7843,-92156,0.808,#DIV/0!
2013/8/15,945,7834,-12,35,6,29,0.808,0.423
2013/8/15,1045,7861,26,44,17,27,0.804,0.651
2013/8/15,1145,7863,2,18,5,13,0.802,1.653
2013/8/15,1245,7862,-2,11,4,7,0.902,4.149
2013/8/15,1345,7861,-2,14,3,11,0.901,1.014
2013/8/15,845,7803,7803,-99999,-7803,-92196,0.807,#DIV/0!
2013/8/16,945,7875,72,80,13,67,0.798,0.386
2013/8/16,1045,7856,-20,37,23,14,0.8,0.908
2013/8/16,1145,7934,79,90,10,80,0.791,0.452
2013/8/16,1245,7930,-4,19,12,7,0.892,1.68
2013/8/16,1345,7916,-14,38,22,16,0.894,0.76
2013/8/16,845,7881,7881,-99999,-7881,-92118,0.799,#DIV/0!
2013/8/19,945,7876,-1,34,13,21,0.799,0.603
2013/8/19,1045,7889,13,35,14,21,0.798,1.108
2013/8/19,1145,7878,-11,13,17,-4,0.8,3.169
2013/8/19,1245,7887,9,13,-2,15,0.899,3.564
2013/8/19,1345,7887,0,12,3,9,0.9,1.696
2013/8/19,845,7851,7851,-99999,-7851,-92148,0.804,#DIV/0!
2013/8/20,945,7913,59,59,1,58,0.797,0.475
2013/8/20,1045,7874,-38,56,44,12,0.801,0.62
2013/8/20,1145,7832,-42,51,46,5,0.804,0.613
2013/8/20,1245,7818,-14,32,17,15,0.906,0.841
2013/8/20,1345,7805,-15,33,28,5,0.907,0.702
2013/8/20,845,7707,7707,-99999,-7707,-92292,0.816,#DIV/0!
2013/8/22,945,7750,43,53,11,42,0.809,0.837
2013/8/22,1045,7761,11,32,19,13,0.807,1.47
2013/8/22,1145,7765,5,23,9,14,0.805,2.676
2013/8/22,1245,7792,27,37,8,29,0.901,1.76
2013/8/22,845,7754,-38,27,69,-42,0.905,1.069
2013/8/23,945,7795,42,41,8,33,0.898,0.46
2013/8/23,1045,7806,10,17,3,14,0.896,0.996
2013/8/23,1145,7801,-6,17,14,3,0.896,1.219
2013/8/23,1245,7807,5,18,9,9,0.895,1.491
2013/8/23,1345,7786,-21,32,29,3,0.998,0.809
2013/8/23,845,7818,7818,-99999,-7818,-92181,0.895,#DIV/0!
2013/8/26,945,7817,-1,45,15,30,0.896,0.491
2013/8/26,1045,7828,11,36,16,20,0.896,0.746
2013/8/26,1145,7828,0,16,11,5,0.897,1.524
2013/8/26,1245,7830,2,12,7,5,0.897,3.06
2013/8/26,1345,7824,-6,15,11,4,0.898,1.136
2013/8/26,845,7803,7803,-99999,-7803,-92196,0.801,#DIV/0!
2013/8/27,945,7800,-3,38,18,20,0.801,0.457
2013/8/27,1045,7806,6,13,5,8,0.801,1.637
2013/8/27,1145,7798,-8,13,8,5,0.801,1.724
2013/8/27,1245,7753,-45,48,52,-4,0.907,0.727
2013/8/27,1345,7757,4,25,15,10,0.905,0.63
2013/8/27,845,7696,7696,-99999,-7696,-92303,0.811,#DIV/0!
2013/8/28,945,7757,63,65,-4,69,0.803,0.36
2013/8/28,1045,7751,-7,28,11,17,0.803,0.67
2013/8/28,1145,7741,-10,31,26,5,0.803,1.132
2013/8/28,1245,7752,11,30,10,20,0.901,1.559
2013/8/28,1345,7780,28,33,-3,36,0.897,0.917
2013/8/28,845,7800,7800,-99999,-7800,-92199,0.795,#DIV/0!
2013/8/29,945,7854,54,64,3,61,0.79,0.492
2013/8/29,1045,7877,23,26,-6,32,0.788,1.032
2013/8/29,1145,7877,0,18,5,13,0.789,1.473
2013/8/29,1245,7880,4,18,13,5,0.889,1.865
2013/8/29,1345,7896,16,24,4,20,0.89,0.665
2013/8/29,845,7901,7901,-99999,-7901,-92098,0.791,#DIV/0!
2013/8/30,945,7884,-16,29,28,1,0.795,0.537
2013/8/30,1045,7898,14,22,4,18,0.795,1.273
2013/8/30,1145,7920,21,32,3,29,0.795,1.185
2013/8/30,1245,7937,17,23,5,18,0.893,1.089
2013/8/30,1345,7969,32,54,14,40,0.891,0.542
2013/8/30,845,7961,7961,-99999,-7961,-92038,0.793,#DIV/0!
2013/9/2,945,7986,22,38,19,19,0.792,0.491
2013/9/2,1045,7980,-6,24,19,5,0.794,1.549
2013/9/2,1145,8020,40,46,-1,47,0.791,0.936
2013/9/2,1245,8017,-3,18,8,10,0.891,1.749
2013/9/2,1345,8018,0,15,7,8,0.893,1.141
2013/9/2,845,8036,8036,-99999,-8036,-91963,0.792,#DIV/0!
2013/9/3,945,8043,6,54,36,18,0.794,0.464
2013/9/3,1045,8047,4,24,19,5,0.795,1.092
2013/9/3,1145,8052,4,19,8,11,0.796,1.513
2013/9/3,1245,8056,4,15,7,8,0.895,1.842
2013/9/3,1345,8052,-3,13,8,5,0.897,1.1
2013/9/3,845,8028,8028,-99999,-8028,-91971,0.8,#DIV/0!
2013/9/4,945,8020,-9,19,7,12,0.801,0.515
2013/9/4,1045,8007,-13,31,29,2,0.803,0.789
2013/9/4,1145,8023,16,18,3,15,0.801,1.337
2013/9/4,1245,8059,36,49,12,37,0.897,0.826
2013/9/4,1345,8071,12,21,2,19,0.896,0.896
2013/9/4,845,8090,8090,-99999,-8090,-91909,0.794,#DIV/0!
2013/9/5,945,8090,-1,43,24,19,0.795,0.403
2013/9/5,1045,8112,24,36,8,28,0.793,0.912
2013/9/5,1145,8128,17,23,-2,25,0.792,1.138
2013/9/5,1245,8121,-7,23,10,13,0.893,1.181
2013/9/5,1345,8130,9,20,11,9,0.893,0.911
2013/9/5,845,8129,8129,-99999,-8129,-91870,0.795,#DIV/0!
2013/9/6,945,8134,4,26,12,14,0.796,0.662
2013/9/6,1045,8139,4,14,3,11,0.796,1.602
2013/9/6,1145,8148,9,16,5,11,0.797,1.332
2013/9/6,1245,8148,0,10,3,7,0.897,2.867
2013/9/6,1345,8139,-9,13,9,4,0.898,0.965
2013/9/6,845,8146,8146,-99999,-8146,-91853,0.798,#DIV/0!
2013/9/9,945,8144,-5,89,40,49,0.799,0.306
2013/9/9,1045,8143,0,32,16,16,0.799,0.755
2013/9/9,1145,8165,22,30,8,22,0.797,1.078
2013/9/9,1245,8157,-8,19,8,11,0.898,1.799
2013/9/9,1345,8159,3,21,10,11,0.898,0.919
2013/9/9,845,8192,8192,-99999,-8192,-91807,0.795,#DIV/0!
2013/9/10,945,8187,-5,44,33,11,0.796,0.468
2013/9/10,1045,8186,-2,14,10,4,0.797,1.538
2013/9/10,1145,8142,-44,53,47,6,0.802,0.64
2013/9/10,1245,8156,14,23,4,19,0.9,1.309
2013/9/10,1345,8171,15,32,5,27,0.899,0.785
2013/9/10,845,8200,8200,-99999,-8200,-91799,0.796,#DIV/0!
2013/9/11,945,8173,-27,49,12,37,0.8,0.438
2013/9/11,1045,8149,-24,43,25,18,0.802,0.754
2013/9/11,1145,8154,6,25,6,19,0.801,1.141
2013/9/11,1245,8165,10,21,1,20,0.9,1.508
2013/9/11,1345,8191,26,29,6,23,0.897,0.792
2013/9/11,845,8187,8187,-99999,-8187,-91812,0.797,#DIV/0!
2013/9/12,945,8214,28,46,-4,50,0.795,0.511
2013/9/12,1045,8206,-8,22,11,11,0.796,1.243
2013/9/12,1145,8202,-3,19,14,5,0.797,1.534
2013/9/12,1245,8190,-13,24,15,9,0.899,1.353
2013/9/12,1345,8194,5,16,10,6,0.898,1.173
2013/9/12,845,8195,8195,-99999,-8195,-91804,0.798,#DIV/0!
2013/9/13,945,8199,5,29,16,13,0.799,0.759
2013/9/13,1045,8166,-33,44,34,10,0.802,0.725
2013/9/13,1145,8166,1,12,7,5,0.802,1.746
2013/9/13,1245,8165,-1,12,5,7,0.902,1.921
2013/9/13,1345,8146,-19,28,30,-2,0.904,0.778
2013/9/13,845,8178,8178,-99999,-8178,-91821,0.8,#DIV/0!
2013/9/14,945,8156,-20,22,14,8,0.802,0.838
2013/9/14,1045,8162,6,9,1,8,0.801,3.194
2013/9/14,1145,8170,8,14,3,11,0.8,2.042
2013/9/14,1245,8166,-3,10,6,4,0.9,3.458
2013/9/14,1345,8162,-3,20,7,13,0.9,1.172
2013/9/14,845,8215,8215,-99999,-8215,-91784,0.795,#DIV/0!
2013/9/16,945,8249,33,56,4,52,0.792,0.255
2013/9/16,1045,8242,-7,11,7,4,0.794,1.111
2013/9/16,1145,8243,1,8,7,1,0.795,1.377
2013/9/16,1245,8254,11,14,2,12,0.893,1.365
2013/9/16,1345,8249,-5,14,10,4,0.895,0.609
2013/9/16,845,8214,8214,-99999,-8214,-91785,0.799,#DIV/0!
2013/9/17,945,8227,13,26,9,17,0.799,0.533
2013/9/17,1045,8233,6,17,2,15,0.799,1.078
2013/9/17,1145,8228,-5,8,6,2,0.8,2.095
2013/9/17,1245,8225,-2,8,4,4,0.9,2.061
2013/9/17,1345,8240,15,17,1,16,0.899,0.781
2013/9/17,845,8259,8259,-99999,-8259,-91740,0.797,#DIV/0!
2013/9/18,945,8244,-15,30,24,6,0.799,0.613
2013/9/18,1045,8244,0,10,2,8,0.799,1.761
2013/9/18,1145,8243,-1,8,6,2,0.799,1.717
2013/9/18,1245,8230,-13,20,13,7,0.9,1.103
2013/9/18,845,8183,-47,17,61,-44,0.905,0.773
2013/9/23,945,8225,42,31,5,26,0.9,0.364
2013/9/23,1045,8254,29,25,11,14,0.897,0.53
2013/9/23,1145,8265,12,18,4,14,0.896,1.004
2013/9/23,1245,8262,-3,14,6,8,0.897,1.691
2013/9/23,1345,8256,-6,16,8,8,0.998,0.755
2013/9/23,845,8251,8251,-99999,-8251,-91748,0.898,#DIV/0!
2013/9/24,945,8252,1,27,21,6,0.898,0.493
2013/9/24,1045,8250,-3,13,12,1,0.898,1.26
2013/9/24,1145,8243,-7,30,8,22,0.899,0.729
2013/9/24,1245,8252,7,12,3,9,0.899,1.615
2013/9/24,1345,8268,16,23,3,20,0.898,0.814
2013/9/24,845,8252,8252,-99999,-8252,-91747,0.8,#DIV/0!
2013/9/25,945,8225,-28,32,29,3,0.802,0.462
2013/9/25,1045,8234,9,34,24,10,0.801,0.821
2013/9/25,1145,8234,-1,15,9,6,0.801,1.257
2013/9/25,1245,8236,2,11,6,5,0.9,2.484
2013/9/25,1345,8233,-4,13,13,0,0.901,0.869
2013/9/25,845,8219,8219,-99999,-8219,-91780,0.802,#DIV/0!
2013/9/26,945,8188,-31,57,53,4,0.804,0.437
2013/9/26,1045,8173,-15,18,5,13,0.805,0.593
2013/9/26,1145,8168,-5,15,13,2,0.805,1.491
2013/9/26,1245,8178,10,16,2,14,0.904,1.998
2013/9/26,1345,8183,5,28,1,27,0.902,0.638
2013/9/26,845,8193,8193,-99999,-8193,-91806,0.801,#DIV/0!
2013/9/27,945,8183,-10,24,24,0,0.801,0.579
2013/9/27,1045,8187,4,14,3,11,0.8,1.356
2013/9/27,1145,8191,4,10,0,10,0.799,2.976
2013/9/27,1245,8180,-11,11,10,1,0.9,2.644
2013/9/27,1345,8183,3,10,8,2,0.899,0.944
2013/9/27,845,8113,8113,-99999,-8113,-91886,0.806,#DIV/0!
2013/9/30,945,8125,12,23,4,19,0.804,0.485
2013/9/30,1045,8136,10,64,11,53,0.803,0.367
2013/9/30,1145,8146,10,16,-2,18,0.801,1.309
2013/9/30,1245,8140,-5,8,6,2,0.902,1.886
2013/9/30,1345,8120,-21,36,36,0,0.903,0.56
2013/10/1,945,8169,18,32,1,31,0.898,0.54
2013/10/1,1045,8162,-8,14,13,1,0.898,1.304
2013/10/1,1145,8157,-5,14,11,3,0.898,1.859
2013/10/1,1245,8147,-9,19,13,6,0.899,0.988
2013/10/1,1345,8150,3,9,3,6,0.999,1.571
2013/10/1,845,8182,8182,-99999,-8182,-91817,0.896,#DIV/0!
2013/10/2,945,8177,-10,20,15,5,0.897,0.561
2013/10/2,1045,8164,-13,18,11,7,0.899,0.922
2013/10/2,1145,8171,7,9,3,6,0.898,1.736
2013/10/2,1245,8168,-4,16,6,10,0.899,1.669
2013/10/2,1345,8157,-11,14,18,-4,0.901,0.923
2013/10/2,845,8171,8171,-99999,-8171,-91828,0.799,#DIV/0!
2013/10/3,945,8306,133,117,-4,121,0.786,0.289
2013/10/3,1045,8331,25,26,9,17,0.786,0.701
2013/10/3,1145,8340,9,20,3,17,0.787,1.448
2013/10/3,1245,8368,28,46,17,29,0.884,1.018
2013/10/3,1345,8378,10,25,0,25,0.885,0.705
2013/10/3,845,8358,8358,-99999,-8358,-91641,0.789,#DIV/0!
2013/10/4,945,8366,10,34,13,21,0.791,0.595
2013/10/4,1045,8392,25,28,-3,31,0.791,1.072
2013/10/4,1145,8380,-12,17,9,8,0.795,1.637
2013/10/4,1245,8374,-7,11,8,3,0.895,2.74
2013/10/4,1345,8366,-9,15,8,7,0.899,0.982
2013/10/4,845,8366,8366,-99999,-8366,-91633,0.799,#DIV/0!
2013/10/7,945,8338,-28,70,28,42,0.802,0.402
2013/10/7,1045,8321,-15,22,14,8,0.804,1.309
2013/10/7,1145,8323,2,11,3,8,0.803,2.496
2013/10/7,1245,8319,-4,9,6,3,0.904,3.48
2013/10/7,1345,8326,6,13,0,13,0.902,1.117
2013/10/7,845,8300,8300,-99999,-8300,-91699,0.804,#DIV/0!
2013/10/8,945,8309,4,35,17,18,0.803,0.477
2013/10/8,1045,8355,46,40,-3,43,0.797,0.608
2013/10/8,1145,8370,15,18,4,14,0.796,0.8
2013/10/8,1245,8375,5,11,2,9,0.895,1.806
2013/10/8,1345,8374,-1,14,9,5,0.895,0.769
2013/10/8,845,8321,8321,-99999,-8321,-91678,0.801,#DIV/0!
2013/10/9,945,8365,43,40,-5,45,0.797,0.566
2013/10/9,1045,8345,-19,43,32,11,0.799,0.629
2013/10/9,1145,8357,11,17,1,16,0.798,1.562
2013/10/9,1245,8350,-7,14,10,4,0.899,2.604
2013/10/9,1345,8335,-14,23,17,6,0.901,0.935
2013/10/9,845,8439,8439,-99999,-8439,-91560,0.792,#DIV/0!
2013/10/11,945,8378,-61,81,68,13,0.798,0.346
2013/10/11,1045,8389,12,20,12,8,0.797,0.769
2013/10/11,1145,8379,-9,19,17,2,0.798,1.36
2013/10/11,1245,8376,-3,14,9,5,0.899,1.957
2013/10/11,1345,8361,-16,24,18,6,0.901,0.842
2013/10/11,845,8343,8343,-99999,-8343,-91656,0.803,#DIV/0!
2013/10/14,945,8297,-46,52,46,6,0.807,0.446
2013/10/14,1045,8302,4,67,38,29,0.806,0.605
2013/10/14,1145,8304,2,18,2,16,0.805,1.585
2013/10/14,1245,8306,2,16,3,13,0.905,2.729
2013/10/14,1345,8294,-10,22,11,11,0.905,0.994
2013/10/14,845,8356,8356,-99999,-8356,-91643,0.798,#DIV/0!
2013/10/15,945,8346,-10,25,17,8,0.798,0.586
2013/10/15,1045,8378,31,44,7,37,0.795,0.769
2013/10/15,1145,8363,-16,37,17,20,0.796,0.939
2013/10/15,1245,8357,-7,15,6,9,0.897,1.973
2013/10/15,1345,8354,-2,9,10,-1,0.897,1.339
2013/10/15,845,8367,8367,-99999,-8367,-91632,0.797,#DIV/0!
2013/10/16,945,8361,-7,31,16,15,0.798,0.827
2013/10/16,1045,8351,-10,17,10,7,0.8,1.343
2013/10/16,1145,8354,4,15,3,12,0.8,2.645
2013/10/16,1245,8346,-8,7,8,-1,0.901,5.452
2013/10/16,845,8380,33,7,-33,40,0.897,1.412
2013/10/17,945,8377,-3,52,45,7,0.898,0.294
2013/10/17,1045,8364,-12,23,16,7,0.899,0.532
2013/10/17,1145,8369,5,16,3,13,0.899,1.308
2013/10/17,1245,8369,0,7,2,5,0.899,2.58
2013/10/17,1345,8363,-7,15,10,5,1,1.043
2013/10/17,845,8381,8381,-99999,-8381,-91618,0.898,#DIV/0!
2013/10/18,945,8384,1,23,12,11,0.898,0.487
2013/10/18,1045,8386,1,9,3,6,0.898,1.511
2013/10/18,1145,8395,8,15,5,10,0.897,1.167
2013/10/18,1245,8427,33,36,0,36,0.894,0.886
2013/10/18,1345,8416,-11,12,12,0,0.896,0.765
2013/10/18,845,8437,8437,-99999,-8437,-91562,0.795,#DIV/0!
2013/10/21,945,8408,-29,26,26,0,0.798,0.511
2013/10/21,1045,8406,-3,19,9,10,0.799,0.941
2013/10/21,1145,8412,7,23,4,19,0.799,1.106
2013/10/21,1245,8404,-8,9,8,1,0.9,2.634
2013/10/21,1345,8401,-3,10,7,3,0.9,1.048
2013/10/21,845,8376,8376,-99999,-8376,-91623,0.803,#DIV/0!
2013/10/22,945,8373,-3,43,22,21,0.803,0.396
2013/10/22,1045,8394,21,23,3,20,0.801,1.087
2013/10/22,1145,8412,19,31,11,20,0.798,0.573
2013/10/22,1245,8415,4,8,4,4,0.898,2.741
2013/10/22,1345,8414,0,12,3,9,0.898,0.953
2013/10/22,845,8436,8436,-99999,-8436,-91563,0.796,#DIV/0!
2013/10/23,945,8410,-27,36,26,10,0.799,0.467
2013/10/23,1045,8408,-1,16,16,0,0.799,1.328
2013/10/23,1145,8367,-42,55,44,11,0.803,0.473
2013/10/23,1245,8356,-11,26,15,11,0.904,1.045
2013/10/23,1345,8361,5,27,6,21,0.903,0.719
2013/10/23,845,8347,8347,-99999,-8347,-91652,0.805,#DIV/0!
2013/10/24,945,8347,1,38,17,21,0.804,0.491
2013/10/24,1045,8365,17,24,11,13,0.801,0.849
2013/10/24,1145,8370,6,15,8,7,0.8,1.851
2013/10/24,1245,8377,8,14,3,11,0.9,2.453
2013/10/24,1345,8391,15,23,9,14,0.897,0.971
2013/10/24,845,8352,8352,-99999,-8352,-91647,0.801,#DIV/0!
2013/10/25,945,8355,3,37,11,26,0.8,0.448
2013/10/25,1045,8316,-39,50,39,11,0.804,0.593
2013/10/25,1145,8294,-23,33,30,3,0.805,0.935
2013/10/25,1245,8297,1,9,10,-1,0.905,2.4
2013/10/25,1345,8322,25,23,3,20,0.902,0.873
2013/10/25,845,8323,8323,-99999,-8323,-91676,0.801,#DIV/0!
2013/10/28,945,8378,55,28,-22,50,0.795,0.677
2013/10/28,1045,8397,21,21,7,14,0.794,0.817
2013/10/28,1145,8394,-3,14,11,3,0.794,2.099
2013/10/28,1245,8393,-2,12,5,7,0.894,2.606
2013/10/28,1345,8388,-4,12,5,7,0.895,1.089
2013/10/28,845,8361,8361,-99999,-8361,-91638,0.798,#DIV/0!
2013/10/29,945,8417,56,41,-17,58,0.794,0.488
2013/10/29,1045,8383,-33,44,52,-8,0.798,0.509
2013/10/29,1145,8384,1,19,8,11,0.799,0.814
2013/10/29,1245,8394,9,10,-4,14,0.898,2.102
2013/10/29,1345,8410,16,24,6,18,0.897,0.65
2013/10/29,845,8422,8422,-99999,-8422,-91577,0.796,#DIV/0!
2013/10/30,945,8418,-5,55,42,13,0.797,0.408
2013/10/30,1045,8423,4,22,17,5,0.797,1.162
2013/10/30,1145,8430,6,18,6,12,0.797,1.856
2013/10/30,1245,8429,-1,8,6,2,0.897,3.843
2013/10/30,1345,8441,11,14,2,12,0.896,0.932
2013/10/30,845,8421,8421,-99999,-8421,-91578,0.799,#DIV/0!
2013/10/31,945,8425,4,21,4,17,0.799,0.577
2013/10/31,1045,8442,18,25,4,21,0.797,0.778
2013/10/31,1145,8457,14,29,8,21,0.797,0.892
2013/10/31,1245,8448,-10,17,10,7,0.898,1.681
2013/10/31,1345,8427,-21,21,20,1,0.9,0.696
2013/10/31,845,8453,8453,-99999,-8453,-91546,0.798,#DIV/0!
2013/11/1,945,8439,-11,48,37,11,0.799,0.429
2013/11/1,1045,8381,-58,57,63,-6,0.805,0.551
2013/11/1,1145,8389,7,33,16,17,0.804,0.835
2013/11/1,1245,8389,-1,16,9,7,0.904,2.061
2013/11/1,1345,8393,3,18,2,16,0.903,0.958
2013/11/1,845,8354,8354,-99999,-8354,-91645,0.806,#DIV/0!
2013/11/4,945,8345,-9,45,24,21,0.806,0.491
2013/11/4,1045,8351,6,17,9,8,0.804,1.656
2013/11/4,1145,8328,-24,41,26,15,0.805,0.772
2013/11/4,1245,8339,12,21,3,18,0.904,2.495
2013/11/4,1345,8339,0,12,11,1,0.903,1.213
2013/11/4,845,8326,8326,-99999,-8326,-91673,0.803,#DIV/0!
2013/11/5,945,8302,-23,57,51,6,0.804,0.4
2013/11/5,1045,8270,-32,47,44,3,0.806,0.616
2013/11/5,1145,8290,20,25,5,20,0.803,1.219
2013/11/5,1245,8278,-12,25,20,5,0.904,2.062
2013/11/5,1345,8268,-9,24,11,13,0.905,0.779
2013/11/5,845,8282,8282,-99999,-8282,-91717,0.802,#DIV/0!
2013/11/6,945,8265,-16,31,23,8,0.803,0.582
2013/11/6,1045,8257,-7,36,10,26,0.803,0.675
2013/11/6,1145,8275,18,25,8,17,0.8,1.031
2013/11/6,1245,8274,-1,20,4,16,0.9,1.925
2013/11/6,1345,8269,-6,15,8,7,0.9,1.257
2013/11/6,845,8268,8268,-99999,-8268,-91731,0.8,#DIV/0!
2013/11/7,945,8257,-11,34,22,12,0.801,0.562
2013/11/7,1045,8253,-4,22,19,3,0.801,1.181
2013/11/7,1145,8240,-14,31,15,16,0.802,0.859
2013/11/7,1245,8253,14,22,5,17,0.901,1.677
2013/11/7,1345,8257,5,24,6,18,0.9,0.959
2013/11/7,845,8230,8230,-99999,-8230,-91769,0.802,#DIV/0!
2013/11/8,945,8245,16,28,8,20,0.801,0.558
2013/11/8,1045,8259,14,28,10,18,0.799,0.807
2013/11/8,1145,8242,-17,18,16,2,0.8,1.164
2013/11/8,1245,8230,-12,16,14,2,0.902,1.589
2013/11/8,1345,8224,-6,20,7,13,0.902,0.667
2013/11/8,845,8230,8230,-99999,-8230,-91769,0.801,#DIV/0!
2013/11/11,945,8217,-11,39,19,20,0.802,0.428
2013/11/11,1045,8209,-7,23,6,17,0.802,0.979
2013/11/11,1145,8191,-19,23,22,1,0.804,1.447
2013/11/11,1245,8190,-2,10,10,0,0.904,2.243
2013/11/11,1345,8195,6,19,3,16,0.903,0.834
2013/11/11,845,8225,8225,-99999,-8225,-91774,0.799,#DIV/0!
2013/11/12,945,8224,-2,29,23,6,0.799,0.453
2013/11/12,1045,8218,-7,21,15,6,0.799,1.233
2013/11/12,1145,8214,-4,14,11,3,0.799,1.354
2013/11/12,1245,8185,-29,49,36,13,0.903,0.827
2013/11/12,1345,8216,31,40,8,32,0.899,0.674
2013/11/12,845,8186,8186,-99999,-8186,-91813,0.802,#DIV/0!
2013/11/13,945,8164,-22,34,28,6,0.803,0.519
2013/11/13,1045,8147,-16,30,24,6,0.805,0.756
2013/11/13,1145,8141,-7,15,10,5,0.805,1.531
2013/11/13,1245,8119,-21,36,29,7,0.907,0.978
2013/11/13,1345,8107,-11,24,18,6,0.907,0.641
2013/11/13,845,8144,8144,-99999,-8144,-91855,0.802,#DIV/0!
2013/11/14,945,8109,-33,32,29,3,0.805,0.686
2013/11/14,1045,8128,18,60,17,43,0.802,0.538
2013/11/14,1145,8146,18,28,11,17,0.799,0.985
2013/11/14,1245,8145,-1,13,2,11,0.899,2.406
2013/11/14,1345,8124,-21,21,21,0,0.901,1.338
2013/11/14,845,8179,8179,-99999,-8179,-91820,0.795,#DIV/0!
2013/11/15,945,8199,22,52,1,51,0.794,0.447
2013/11/15,1045,8208,9,18,2,16,0.793,0.957
2013/11/15,1145,8196,-12,21,18,3,0.796,1.293
2013/11/15,1245,8192,-4,17,12,5,0.896,2.584
2013/11/15,1345,8159,-34,29,32,-3,0.9,0.874
2013/11/15,845,8195,8195,-99999,-8195,-91804,0.797,#DIV/0!
2013/11/18,945,8210,16,33,6,27,0.797,0.559
2013/11/18,1045,8205,-5,22,18,4,0.798,0.925
2013/11/18,1145,8189,-16,31,20,11,0.8,0.922
2013/11/18,1245,8189,-1,12,11,1,0.9,2.384
2013/11/18,1345,8189,1,14,7,7,0.901,1.219
2013/11/18,845,8219,8219,-99999,-8219,-91780,0.797,#DIV/0!
2013/11/19,945,8230,6,28,10,18,0.797,0.422
2013/11/19,1045,8235,5,13,4,9,0.797,1.402
2013/11/19,1145,8237,3,10,1,9,0.797,1.883
2013/11/19,1245,8249,13,16,7,9,0.895,1.098
2013/11/19,1345,8249,0,17,7,10,0.896,0.779
2013/11/19,845,8231,8231,-99999,-8231,-91768,0.798,#DIV/0!
2013/11/20,945,8250,17,28,8,20,0.797,0.9
2013/11/20,1045,8228,-22,29,26,3,0.8,1.206
2013/11/20,1145,8228,0,10,9,1,0.8,2.345
2013/11/20,1245,8223,-6,15,8,7,0.901,1.897
2013/11/20,845,8163,-59,13,67,-54,0.907,1.082
2013/11/21,945,8103,-62,77,63,14,0.913,0.261
2013/11/21,1045,8093,-10,32,22,10,0.913,0.659
2013/11/21,1145,8079,-14,17,14,3,0.913,0.947
2013/11/21,1245,8076,-4,13,9,4,0.911,1.807
2013/11/21,1345,8078,2,23,7,16,1.011,0.714
2013/11/21,845,8080,8080,-99999,-8080,-91919,0.908,#DIV/0!
2013/11/22,945,8080,1,23,20,3,0.906,0.713
2013/11/22,1045,8107,26,26,1,25,0.902,1.158
2013/11/22,1145,8103,-4,15,7,8,0.9,1.595
2013/11/22,1245,8094,-8,9,8,1,0.9,2.728
2013/11/22,1345,8086,-8,9,6,3,0.9,1.109
2013/11/22,845,8150,8150,-99999,-8150,-91849,0.794,#DIV/0!
2013/11/25,945,8203,53,66,15,51,0.789,0.302
2013/11/25,1045,8196,-7,19,8,11,0.791,0.893
2013/11/25,1145,8204,9,13,5,8,0.792,1.669
2013/11/25,1245,8201,-3,13,5,8,0.892,2.018
2013/11/25,1345,8195,-7,14,7,7,0.894,1.002
2013/11/25,845,8158,8158,-99999,-8158,-91841,0.799,#DIV/0!
2013/11/26,945,8206,48,50,-2,52,0.795,0.465
2013/11/26,1045,8215,9,24,8,16,0.796,0.8
2013/11/26,1145,8245,29,36,1,35,0.794,0.847
2013/11/26,1245,8244,-1,12,13,-1,0.894,1.278
2013/11/26,1345,8249,5,40,28,12,0.895,0.479
2013/11/26,845,8238,8238,-99999,-8238,-91761,0.797,#DIV/0!
2013/11/27,945,8285,47,43,-2,45,0.793,0.519
2013/11/27,1045,8277,-8,19,8,11,0.794,1.26
2013/11/27,1145,8294,17,23,5,18,0.794,1.038
2013/11/27,1245,8293,-1,11,2,9,0.894,2.418
2013/11/27,1345,8299,6,9,1,8,0.895,1.107
2013/11/27,845,8352,8352,-99999,-8352,-91647,0.791,#DIV/0!
2013/11/28,945,8373,25,44,9,35,0.79,0.461
2013/11/28,1045,8377,4,20,9,11,0.792,1.363
2013/11/28,1145,8387,10,17,5,12,0.792,1.249
2013/11/28,1245,8373,-14,22,17,5,0.894,1.459
2013/11/28,1345,8378,5,11,3,8,0.895,0.995
2013/11/28,845,8372,8372,-99999,-8372,-91627,0.796,#DIV/0!
2013/11/29,945,8408,36,34,0,34,0.794,0.567
2013/11/29,1045,8411,2,17,7,10,0.795,0.885
2013/11/29,1145,8419,9,19,9,10,0.796,1.015
2013/11/29,1245,8415,-4,13,10,3,0.896,1.673
2013/11/29,1345,8427,13,11,-2,13,0.896,0.83
2013/12/2,945,8410,-21,49,30,19,0.898,0.51
2013/12/2,1045,8420,10,37,27,10,0.898,0.604
2013/12/2,1145,8406,-14,28,21,7,0.9,0.962
2013/12/2,1245,8410,4,13,5,8,0.9,2.283
2013/12/2,1345,8413,3,11,2,9,0.999,1.567
2013/12/3,945,8396,4,32,14,18,1.001,0.558
2013/12/3,1045,8395,0,21,10,11,1.001,1.368
2013/12/3,1145,8398,3,9,2,7,1.001,2.684
2013/12/3,1245,8416,19,31,8,23,0.998,1.172
2013/12/3,1345,8409,-7,18,11,7,0.999,1.129
2013/12/4,945,8387,12,40,27,13,1.001,0.485
2013/12/4,1045,8427,40,50,7,43,0.996,0.59
2013/12/4,1145,8437,11,26,12,14,0.995,0.931
2013/12/4,1245,8438,1,13,8,5,0.995,2.518
2013/12/4,1345,8436,-2,13,4,9,0.996,0.982
2013/12/5,945,8405,-18,41,38,3,1,0.554
2013/12/5,1045,8372,-33,32,42,-10,1.004,0.926
2013/12/5,1145,8369,-3,32,15,17,1.004,0.867
2013/12/5,1245,8384,16,25,4,21,1.002,1.745
2013/12/5,1345,8379,-5,21,16,5,1.002,1.176
2013/12/6,945,8388,11,34,0,34,1.001,0.813
2013/12/6,1045,8395,7,19,7,12,1,1.153
2013/12/6,1145,8400,5,31,5,26,0.999,1.03
2013/12/6,1245,8401,2,14,8,6,0.999,2.369
2013/12/6,1345,8384,-18,28,19,9,1,1.095
2013/12/9,945,8488,33,40,-3,43,0.988,0.543
2013/12/9,1045,8473,-15,23,18,5,0.991,1.47
2013/12/9,1145,8462,-11,21,16,5,0.994,1.515
2013/12/9,1245,8462,0,9,6,3,0.995,3.126
2013/12/9,1345,8456,-6,14,7,7,0.996,1.187
2013/12/10,945,8446,15,25,10,15,0.998,0.666
2013/12/10,1045,8445,-1,17,10,7,0.999,1.284
2013/12/10,1145,8452,7,21,6,15,0.999,1.5
2013/12/10,1245,8451,-2,8,3,5,1,3.079
2013/12/10,1345,8455,4,7,1,6,1,1.748
2013/12/11,945,8478,20,51,32,19,0.997,0.332
2013/12/11,1045,8449,-30,51,35,16,1,0.561
2013/12/11,1145,8433,-18,28,26,2,1.002,1.185
2013/12/11,1245,8427,-6,12,8,4,1.002,1.077
2013/12/11,1345,8432,6,19,9,10,1.001,1.03
2013/12/12,945,8387,-3,42,19,23,1.006,0.561
2013/12/12,1045,8369,-19,33,32,1,1.008,1.155
2013/12/12,1145,8378,9,17,1,16,1.006,1.661
2013/12/12,1245,8378,1,16,9,7,1.005,2.626
2013/12/12,1345,8392,13,22,3,19,1.002,1.228
2013/12/13,945,8387,28,33,-2,35,1.002,0.605
2013/12/13,1045,8377,-9,21,17,4,1.002,1.401
2013/12/13,1145,8398,21,26,2,24,0.998,1.25
2013/12/13,1245,8397,-2,10,7,3,0.998,2.37
2013/12/13,1345,8397,-1,12,1,11,0.998,1.368
2013/12/16,945,8341,-34,53,44,9,1.004,0.477
2013/12/16,1045,8340,0,24,13,11,1.004,1.025
2013/12/16,1145,8333,-7,20,12,8,1.004,1.142
2013/12/16,1245,8331,-1,8,6,2,1.004,3.707
2013/12/16,1345,8336,4,14,7,7,1.003,1.094
2013/12/17,945,8364,-19,17,13,4,1,0.908
2013/12/17,1045,8373,9,15,6,9,0.998,1.279
2013/12/17,1145,8369,-5,9,8,1,0.999,2.847
2013/12/17,1245,8368,-2,8,3,5,0.999,2.227
2013/12/17,1345,8362,-7,12,8,4,0.999,1.229
2013/12/18,945,8356,-24,16,18,-2,1,1.281
2013/12/18,1045,8359,4,17,7,10,1,1.488
2013/12/18,1145,8361,3,7,3,4,1,3.742
2013/12/18,1245,8359,-2,4,2,2,1,4.017
2013/12/19,945,8410,18,93,21,72,0.995,0.267
2013/12/19,1045,8380,-30,28,31,-3,0.999,0.608
2013/12/19,1145,8377,-3,18,12,6,0.999,0.673
2013/12/19,1245,8382,4,10,3,7,0.999,2.233
2013/12/19,1345,8392,10,18,6,12,0.998,0.807
2013/12/20,945,8408,17,32,6,26,0.996,0.651
2013/12/20,1045,8413,5,25,10,15,0.996,0.881
2013/12/20,1145,8421,7,18,7,11,0.996,1.297
2013/12/20,1245,8414,-8,12,9,3,0.997,2.217
2013/12/20,1345,8415,1,10,4,6,0.998,1.337
2013/12/23,945,8478,29,30,11,19,0.991,0.623
2013/12/23,1045,8492,15,20,3,17,0.99,1.184
2013/12/23,1145,8484,-8,10,7,3,0.992,2.926
2013/12/23,1245,8480,-4,9,7,2,0.994,3.531
2013/12/23,1345,8475,-5,10,5,5,0.996,1.07
2013/12/24,945,8472,-8,22,12,10,0.997,0.878
2013/12/24,1045,8480,7,13,2,11,0.997,1.53
2013/12/24,1145,8485,4,8,2,6,0.997,1.629
2013/12/24,1245,8482,-3,5,4,1,0.998,3.744
2013/12/24,1345,8483,1,10,2,8,0.999,1.345
2013/12/25,945,8492,-8,16,12,4,0.998,0.662
2013/12/25,1045,8495,3,7,4,3,0.998,1.224
2013/12/25,1145,8493,-2,5,4,1,0.999,3.468
2013/12/25,1245,8493,0,4,1,3,0.999,2.955
2013/12/25,1345,8500,7,8,0,8,0.998,0.997
2013/12/26,945,8489,-21,29,23,6,1,0.471
2013/12/26,1045,8497,8,9,0,9,0.999,1.573
2013/12/26,1145,8500,3,7,4,3,0.999,1.325
2013/12/26,1245,8502,2,4,0,4,0.999,3.032
2013/12/26,1345,8501,-1,8,7,1,0.999,0.877
2013/12/27,945,8521,25,28,-3,31,0.997,0.352
2013/12/27,1045,8528,6,16,5,11,0.996,0.612
2013/12/27,1145,8531,3,9,4,5,0.996,1.604
2013/12/27,1245,8547,16,23,3,20,0.995,0.87
2013/12/27,1345,8543,-4,11,6,5,0.996,0.713
2013/12/30,945,8596,47,48,3,45,0.99,0.404
2013/12/30,1045,8610,14,34,13,21,0.99,0.644
2013/12/30,1145,8614,4,11,6,5,0.991,1.724
2013/12/30,1245,8628,14,13,-1,14,0.99,2.183
2013/12/30,1345,8625,-2,15,12,3,0.992,0.684
2013/12/31,945,8639,-11,40,25,15,0.992,0.555
2013/12/31,1045,8649,9,20,3,17,0.993,1.563
2013/12/31,1145,8638,-10,8,8,0,0.995,2.643
2013/12/31,1245,8638,0,10,6,4,0.996,3.104
2013/12/31,1345,8633,-5,18,7,11,0.998,1.116
2014/1/2,945,8625,-19,29,9,20,1,0.539
2014/1/2,1045,8587,-38,45,48,-3,1.005,0.518
2014/1/2,1145,8600,13,16,4,12,1.003,1.84
2014/1/2,1245,8613,13,13,2,11,1.001,1.727
2014/1/2,1345,8618,5,10,0,10,1.001,1.328
2014/1/3,945,8564,-31,34,31,3,1.006,0.427
2014/1/3,1045,8534,-30,38,37,1,1.009,0.575
2014/1/3,1145,8542,7,15,3,12,1.007,1.518
2014/1/3,1245,8542,0,10,5,5,1.006,3.109
2014/1/3,1345,8541,-2,10,5,5,1.005,1.218
2014/1/6,945,8514,-25,43,47,-4,1.007,0.534
2014/1/6,1045,8522,7,25,6,19,1.004,0.86
2014/1/6,1145,8540,17,31,5,26,1.001,1.261
2014/1/6,1245,8519,-21,23,20,3,1.003,1.866
2014/1/6,1345,8528,9,16,0,16,1.001,1.375
2014/1/7,945,8556,28,32,2,30,0.997,0.579
2014/1/7,1045,8558,2,21,14,7,0.997,0.897
2014/1/7,1145,8566,7,13,4,9,0.996,2.545
2014/1/7,1245,8560,-5,16,15,1,0.997,1.96
2014/1/7,1345,8551,-9,19,12,7,0.998,1.084
2014/1/8,945,8592,36,45,5,40,0.994,0.501
2014/1/8,1045,8585,-7,15,14,1,0.995,1.351
2014/1/8,1145,8583,-2,13,2,11,0.996,1.404
2014/1/8,1245,8575,-8,10,10,0,0.998,3.347
2014/1/8,1345,8586,11,15,2,13,0.997,1.311
2014/1/9,945,8571,6,45,2,43,0.999,0.408
2014/1/9,1045,8556,-16,18,14,4,1.001,1.432
2014/1/9,1145,8553,-3,18,15,3,1.002,1.384
2014/1/9,1245,8517,-36,40,37,3,1.006,0.666
2014/1/9,1345,8528,11,13,4,9,1.004,1.034
2014/1/10,945,8547,24,31,0,31,1.001,0.586
2014/1/10,1045,8542,-5,11,4,7,1.001,1.642
2014/1/10,1145,8540,-2,9,6,3,1.001,2.886
2014/1/10,1245,8539,-1,9,1,8,1.001,2.395
2014/1/10,1345,8539,0,10,6,4,1,1.577
2014/1/13,945,8615,17,24,14,10,0.992,0.496
2014/1/13,1045,8574,-41,49,43,6,0.997,0.657
2014/1/13,1145,8579,4,15,2,13,0.997,1.818
2014/1/13,1245,8573,-6,12,8,4,0.998,2.516
2014/1/13,1345,8572,-1,7,6,1,0.998,1.538
2014/1/14,945,8539,9,37,20,17,1.002,0.491
2014/1/14,1045,8538,-1,16,8,8,1.002,1.261
2014/1/14,1145,8547,9,12,0,12,1.001,2.012
2014/1/14,1245,8547,0,10,6,4,1.001,2.719
2014/1/14,1345,8547,0,9,3,6,1.002,1.567
2014/1/15,945,8597,27,32,-2,34,0.995,0.689
2014/1/15,1045,8603,7,15,1,14,0.994,1.379
2014/1/15,1145,8608,5,17,5,12,0.994,1.901
2014/1/15,1245,8602,-6,12,7,5,0.995,2.862
2014/1/16,945,8644,-6,64,18,46,0.991,0.387
2014/1/16,1045,8639,-6,15,9,6,0.993,0.94
2014/1/16,1145,8638,0,8,3,5,0.994,2.156
2014/1/16,1245,8631,-8,12,8,4,0.996,1.672
2014/1/16,1345,8618,-12,21,13,8,0.999,0.658
2014/1/17,945,8585,-25,35,40,-5,1.003,0.549
2014/1/17,1045,8587,2,12,2,10,1.003,0.876
2014/1/17,1145,8606,20,29,6,23,1.001,0.916
2014/1/17,1245,8613,7,19,5,14,1,1.534
2014/1/17,1345,8606,-9,13,9,4,1.001,1.363
2014/1/20,945,8626,41,62,7,55,0.998,0.5
2014/1/20,1045,8631,6,22,3,19,0.997,1.075
2014/1/20,1145,8626,-6,21,5,16,0.998,1.359
2014/1/20,1245,8627,0,9,3,6,0.998,3.09
2014/1/20,1345,8622,-4,10,9,1,0.998,1.373
2014/1/21,945,8627,-15,33,19,14,0.998,0.582
2014/1/21,1045,8620,-7,25,16,9,0.999,0.878
2014/1/21,1145,8622,3,12,6,6,0.999,1.809
2014/1/21,1245,8619,-3,10,10,0,1,2.837
2014/1/21,1345,8623,5,8,-1,9,0.999,1.187
2014/1/22,945,8615,20,34,4,30,1,0.57
2014/1/22,1045,8628,13,27,6,21,0.999,0.917
2014/1/22,1145,8625,-4,12,8,4,0.999,1.818
2014/1/22,1245,8624,-1,8,1,7,0.999,1.951
2014/1/22,1345,8635,11,14,-1,15,0.998,1.117
2014/1/23,945,8620,-26,18,21,-3,1,0.641
2014/1/23,1045,8610,-10,15,3,12,1.001,0.624
2014/1/23,1145,8592,-18,29,24,5,1.003,0.748
2014/1/23,1245,8600,8,13,4,9,1.002,1.83
2014/1/23,1345,8596,-4,10,7,3,1.002,1.099
2014/1/24,945,8602,32,56,15,41,1.001,0.495
2014/1/24,1045,8624,22,29,5,24,0.998,0.932
2014/1/24,1145,8618,-6,9,6,3,0.999,1.902
2014/1/24,1245,8613,-5,9,6,3,0.999,2.722
2014/1/24,1345,8619,5,17,0,17,0.998,0.862
2014/1/27,945,8473,-37,95,74,21,1.014,0.308
2014/1/27,1045,8480,7,23,6,17,1.011,1.359
2014/1/27,1145,8484,4,16,11,5,1.009,1.682
2014/1/27,1245,8476,-9,20,12,8,1.009,2.174
2014/1/27,1345,8446,-29,25,31,-6,1.011,0.749
2014/2/5,945,8256,-46,41,50,-9,1.031,0.529
2014/2/5,1045,8233,-22,40,44,-4,1.03,1.101
2014/2/5,1145,8214,-20,49,31,18,1.028,0.967
2014/2/5,1245,8242,28,29,2,27,1.019,1.477
2014/2/5,1345,8243,1,18,5,13,1.015,1.327
2014/2/6,945,8268,-10,32,11,21,1.009,0.676
2014/2/6,1045,8281,12,28,6,22,1.005,1.187
2014/2/6,1145,8281,0,16,11,5,1.002,1.873
2014/2/6,1245,8278,-3,13,2,11,1,2.517
2014/2/6,1345,8275,-3,12,7,5,0.998,1.747
2014/2/7,945,8326,-1,30,19,11,0.992,0.703
2014/2/7,1045,8348,22,47,25,22,0.991,0.601
2014/2/7,1145,8350,2,13,5,8,0.992,2.441
2014/2/7,1245,8351,2,14,10,4,0.993,2.519
2014/2/7,1345,8339,-13,16,16,0,0.996,1.347
2014/2/10,945,8395,20,38,8,30,0.99,0.545
2014/2/10,1045,8382,-12,21,20,1,0.993,1.147
2014/2/10,1145,8365,-17,27,22,5,0.997,1.082
2014/2/10,1245,8368,3,9,5,4,0.997,3.519
2014/2/10,1345,8355,-13,17,15,2,1,1.378
2014/2/11,945,8386,32,35,1,34,0.997,0.719
2014/2/11,1045,8398,13,21,7,14,0.996,0.798
2014/2/11,1145,8397,-1,12,5,7,0.997,2.319
2014/2/11,1245,8402,6,13,3,10,0.997,2.035
2014/2/11,1345,8414,13,18,1,17,0.996,1.074
2014/2/12,945,8453,6,39,26,13,0.992,0.437
2014/2/12,1045,8467,15,30,11,19,0.991,0.856
2014/2/12,1145,8477,10,19,6,13,0.991,1.208
2014/2/12,1245,8478,1,10,8,2,0.992,2.185
2014/2/12,1345,8481,3,18,15,3,0.993,0.916
2014/2/13,945,8456,-39,26,28,-2,0.998,0.738
2014/2/13,1045,8458,1,14,5,9,0.998,1.334
2014/2/13,1145,8468,11,22,7,15,0.998,1.556
2014/2/13,1245,8465,-3,7,4,3,0.999,2.875
2014/2/13,1345,8443,-22,23,23,0,1.002,1.006
2014/2/14,945,8547,51,50,6,44,0.991,0.384
2014/2/14,1045,8542,-5,33,21,12,0.992,0.77
2014/2/14,1145,8538,-3,13,7,6,0.994,2.149
2014/2/14,1245,8523,-14,27,21,6,0.996,1.062
2014/2/14,1345,8508,-15,24,18,6,0.998,0.827
2014/2/17,945,8528,-19,30,29,1,0.997,0.705
2014/2/17,1045,8523,-5,22,17,5,0.998,1.539
2014/2/17,1145,8531,9,22,5,17,0.998,1.546
2014/2/17,1245,8519,-13,17,17,0,1,2.395
2014/2/17,1345,8528,9,10,0,10,1,2.092
2014/2/18,945,8508,-22,25,25,0,1.002,0.685
2014/2/18,1045,8517,9,18,10,8,1.001,1.212
2014/2/18,1145,8529,11,17,3,14,0.999,1.582
2014/2/18,1245,8537,8,15,7,8,0.998,1.072
2014/2/18,1345,8562,25,28,0,28,0.995,0.812
2014/2/19,945,8560,25,28,6,22,0.996,1
2014/2/19,1045,8555,-6,19,14,5,0.996,1.819
2014/2/19,1145,8551,-4,11,7,4,0.997,2.509
2014/2/19,1245,8550,-2,9,7,2,0.998,2.578
2014/2/20,945,8543,13,53,15,38,0.999,0.308
2014/2/20,1045,8503,-39,35,31,4,1.003,0.479
2014/2/20,1145,8507,4,12,10,2,1.003,1.412
2014/2/20,1245,8493,-14,16,16,0,1.004,1.737
2014/2/20,1345,8483,-10,13,16,-3,1.005,0.927
2014/2/21,945,8577,22,25,21,4,0.994,0.532
2014/2/21,1045,8584,7,10,2,8,0.994,1.592
2014/2/21,1145,8584,0,16,11,5,0.994,1.651
2014/2/21,1245,8587,2,7,1,6,0.994,4.528
2014/2/21,1345,8587,1,13,8,5,0.995,1.393
2014/2/24,945,8574,-17,32,31,1,0.997,0.695
2014/2/24,1045,8562,-12,15,15,0,0.999,1.078
2014/2/24,1145,8553,-9,17,19,-2,1,1.184
2014/2/24,1245,8536,-17,24,22,2,1.003,1.202
2014/2/24,1345,8549,13,16,3,13,1.002,1.018
2014/2/25,945,8582,-21,25,18,7,0.999,0.571
2014/2/25,1045,8569,-12,23,19,4,1,1.019
2014/2/25,1145,8579,9,13,3,10,0.999,1.922
2014/2/25,1245,8581,2,8,1,7,0.999,3.378
2014/2/25,1345,8573,-8,14,10,4,1,1.162
2014/2/26,945,8593,28,43,5,38,0.997,0.512
2014/2/26,1045,8622,29,27,0,27,0.994,0.8
2014/2/26,1145,8617,-4,18,10,8,0.995,1.341
2014/2/26,1245,8617,1,12,9,3,0.996,1.779
2014/2/26,1345,8608,-9,18,13,5,0.998,0.917
2014/2/27,945,8615,6,27,14,13,0.997,0.548
2014/2/27,1045,8621,6,13,7,6,0.997,1.076
2014/2/27,1145,8622,1,9,2,7,0.997,2.681
2014/2/27,1245,8616,-5,16,15,1,0.998,1.659
2014/2/27,1345,8624,8,17,4,13,0.998,1.118
2014/3/3,945,8528,-31,34,24,10,1.009,0.409
2014/3/3,1045,8526,-3,27,11,16,1.008,0.782
2014/3/3,1145,8538,12,19,4,15,1.006,1.493
2014/3/3,1245,8556,18,43,24,19,1.003,0.808
2014/3/3,1345,8566,11,24,5,19,1.001,1.128
2014/3/4,945,8568,8,19,14,5,1,0.734
2014/3/4,1045,8549,-20,30,20,10,1.002,0.855
2014/3/4,1145,8560,12,17,2,15,1,2.193
2014/3/4,1245,8562,2,10,3,7,0.999,2.434
2014/3/4,1345,8553,-10,17,11,6,0.999,1.377
2014/3/5,945,8616,-24,25,22,3,0.993,0.642
2014/3/5,1045,8615,0,10,5,5,0.994,1.566
2014/3/5,1145,8626,12,14,2,12,0.994,1.77
2014/3/5,1245,8621,-5,9,5,4,0.995,2.728
2014/3/5,1345,8619,-1,7,8,-1,0.996,1.275
2014/3/6,945,8658,35,41,6,35,0.993,0.46
2014/3/6,1045,8671,13,25,3,22,0.992,0.8
2014/3/6,1145,8685,14,22,-1,23,0.992,1.072
2014/3/6,1245,8693,8,19,7,12,0.992,1.26
2014/3/6,1345,8695,1,17,14,3,0.994,0.745
2014/3/7,945,8758,28,28,0,28,0.988,0.541
2014/3/7,1045,8765,6,17,7,10,0.988,1.231
2014/3/7,1145,8724,-41,48,42,6,0.995,0.694
2014/3/7,1245,8701,-23,49,32,17,0.999,0.837
2014/3/7,1345,8705,5,29,0,29,0.999,0.979
2014/3/10,945,8654,-19,37,40,-3,1.005,0.664
2014/3/10,1045,8666,11,17,7,10,1.004,1.473
2014/3/10,1145,8675,9,22,12,10,1.003,1.623
2014/3/10,1245,8670,-5,14,7,7,1.003,3.105
2014/3/10,1345,8677,7,12,0,12,1.002,1.732
2014/3/11,945,8685,-5,42,38,4,1.001,0.612
2014/3/11,1045,8704,19,33,7,26,0.998,1.198
2014/3/11,1145,8698,-6,20,16,4,0.998,1.761
2014/3/11,1245,8705,7,11,1,10,0.997,4.226
2014/3/11,1345,8715,10,12,0,12,0.996,1.3
2014/3/12,945,8650,-16,28,23,5,1.003,0.41
2014/3/12,1045,8668,18,18,-4,22,1.001,1.183
2014/3/12,1145,8658,-10,14,9,5,1.002,1.921
2014/3/12,1245,8656,-2,8,3,5,1.002,3.057
2014/3/12,1345,8662,6,12,5,7,1.001,1.059
2014/3/13,945,8735,33,43,2,41,0.993,0.441
2014/3/13,1045,8748,13,29,8,21,0.992,0.777
2014/3/13,1145,8747,-1,11,6,5,0.993,1.572
2014/3/13,1245,8745,-2,7,6,1,0.994,3.246
2014/3/13,1345,8740,-6,13,6,7,0.995,0.865
2014/3/14,945,8689,16,29,12,17,1.001,0.618
2014/3/14,1045,8693,4,10,5,5,1.001,1.546
2014/3/14,1145,8689,-3,13,8,5,1.001,1.945
2014/3/14,1245,8688,-1,9,5,4,1.002,2.464
2014/3/14,1345,8693,4,9,0,9,1.002,1.279
2014/3/17,945,8669,-34,60,46,14,1.004,0.419
2014/3/17,1045,8687,18,25,5,20,1.002,0.995
2014/3/17,1145,8678,-9,17,11,6,1.002,1.975
2014/3/17,1245,8678,0,9,6,3,1.001,3.783
2014/3/17,1345,8701,23,26,0,26,0.998,1.105
2014/3/18,945,8718,-27,38,32,6,0.997,0.526
2014/3/18,1045,8720,2,13,7,6,0.997,1.43
2014/3/18,1145,8728,7,12,3,9,0.996,2.034
2014/3/18,1245,8735,7,8,0,8,0.996,2.762
2014/3/18,1345,8727,-8,12,12,0,0.997,1.101
2014/3/19,945,8723,-11,19,15,4,0.998,0.837
2014/3/19,1045,8691,-33,34,27,7,1.002,0.757
2014/3/19,1145,8697,6,13,7,6,1.002,1.932
2014/3/19,1245,8691,-6,14,11,3,1.003,2.276
2014/3/20,945,8584,-54,127,115,12,1.015,0.271
2014/3/20,1045,8580,-4,17,15,2,1.013,0.995
2014/3/20,1145,8565,-15,21,21,0,1.013,1.104
2014/3/20,1245,8575,10,13,-1,14,1.01,1.564
2014/3/20,1345,8568,-7,14,12,2,1.009,0.905
2014/3/21,945,8585,-1,21,13,8,1.006,0.726
2014/3/21,1045,8588,2,16,4,12,1.004,1.58
2014/3/21,1145,8574,-14,15,15,0,1.004,1.861
2014/3/21,1245,8570,-4,19,7,12,1.003,1.176
2014/3/21,1345,8575,5,12,6,6,1.001,1.279
2014/3/24,945,8554,4,77,46,31,1.002,0.342
2014/3/24,1045,8569,15,46,14,32,1,0.829
2014/3/24,1145,8572,4,18,5,13,0.999,2.301
2014/3/24,1245,8584,13,20,6,14,0.998,1.71
2014/3/24,1345,8601,17,24,4,20,0.996,1.175
2014/3/25,945,8611,22,45,10,35,0.995,0.521
2014/3/25,1045,8635,23,25,2,23,0.993,0.973
2014/3/25,1145,8643,9,13,3,10,0.992,1.319
2014/3/25,1245,8644,1,11,10,1,0.993,2.149
2014/3/25,1345,8659,15,18,1,17,0.992,1.264
2014/3/26,945,8702,-6,33,13,20,0.989,0.577
2014/3/26,1045,8706,4,26,16,10,0.99,0.769
2014/3/26,1145,8711,4,11,5,6,0.991,2.339
2014/3/26,1245,8715,4,11,5,6,0.992,2.807
2014/3/26,1345,8711,-4,9,8,1,0.994,1.537
2014/3/27,945,8719,14,40,16,24,0.995,0.498
2014/3/27,1045,8711,-7,28,18,10,0.997,0.988
2014/3/27,1145,8714,4,7,1,6,0.997,2.568
2014/3/27,1245,8726,12,20,8,12,0.997,1.358
2014/3/27,1345,8754,28,29,0,29,0.995,0.889
2014/3/28,945,8772,18,36,4,32,0.993,0.621
2014/3/28,1045,8745,-27,41,27,14,0.997,0.743
2014/3/28,1145,8747,2,16,10,6,0.997,1.781
2014/3/28,1245,8738,-9,13,8,5,0.999,1.625
2014/3/28,1345,8735,-4,13,7,6,0.999,1.211
2014/3/31,945,8758,-21,28,16,12,0.997,0.665
2014/3/31,1045,8743,-13,22,13,9,1,1.062
2014/3/31,1145,8759,17,23,5,18,0.998,1.657
2014/3/31,1245,8764,5,8,2,6,0.998,2.539
2014/3/31,1345,8789,25,31,5,26,0.996,0.702
2014/4/1,945,8812,32,42,6,36,0.993,0.518
2014/4/1,1045,8807,-5,24,14,10,0.994,1.027
2014/4/1,1145,8816,9,14,4,10,0.994,1.823
2014/4/1,1245,8819,2,14,3,11,0.995,2.398
2014/4/1,1345,8829,10,22,4,18,0.994,0.945
2014/4/2,945,8865,15,43,23,20,0.991,0.502
2014/4/2,1045,8865,1,12,3,9,0.992,1.338
2014/4/2,1145,8866,1,11,8,3,0.994,1.662
2014/4/2,1245,8868,3,11,1,10,0.995,2.512
2014/4/2,1345,8855,-14,20,19,1,0.997,1.192
2014/4/3,945,8864,6,29,14,15,0.997,0.6
2014/4/3,1045,8858,-5,22,9,13,0.998,1.02
2014/4/3,1145,8857,-2,10,7,3,0.999,2.136
2014/4/3,1245,8857,1,8,2,6,0.999,2.963
2014/4/3,1345,8868,12,17,0,17,0.999,1.331
2014/4/7,945,8825,14,39,18,21,1.003,0.452
2014/4/7,1045,8835,11,20,10,10,1.001,1.296
2014/4/7,1145,8832,-3,12,10,2,1.001,2.192
2014/4/7,1245,8836,4,9,5,4,1.001,3.003
2014/4/7,1345,8858,21,26,3,23,0.998,0.809
2014/4/8,945,8856,3,28,9,19,0.998,0.417
2014/4/8,1045,8846,-9,28,20,8,0.999,0.793
2014/4/8,1145,8858,12,16,4,12,0.998,1.487
2014/4/8,1245,8869,10,17,5,12,0.996,1.642
2014/4/8,1345,8879,10,19,8,11,0.995,0.926
2014/4/9,945,8891,5,20,7,13,0.995,0.626
2014/4/9,1045,8888,-2,12,9,3,0.996,1.507
2014/4/9,1145,8890,2,10,6,4,0.996,2.502
2014/4/9,1245,8898,8,10,1,9,0.996,2.943
2014/4/9,1345,8896,-2,9,7,2,0.997,1.171
2014/4/10,945,8914,-15,23,25,-2,0.996,0.6
2014/4/10,1045,8885,-29,47,28,19,1,0.468
2014/4/10,1145,8879,-6,18,11,7,1.001,1.357
2014/4/10,1245,8875,-3,13,12,1,1.001,2.329
2014/4/10,1345,8907,32,49,10,39,0.998,0.65
2014/4/11,945,8884,34,33,3,30,1,0.542
2014/4/11,1045,8875,-10,23,16,7,1.001,1.12
2014/4/11,1145,8854,-20,38,24,14,1.003,0.741
2014/4/11,1245,8867,12,21,3,18,1.001,1.55
2014/4/11,1345,8870,3,20,12,8,1.001,0.972
2014/4/14,945,8866,-4,32,19,13,1.001,0.774
2014/4/14,1045,8862,-3,18,15,3,1,1.612
2014/4/14,1145,8862,0,10,5,5,1,2.924
2014/4/14,1245,8866,6,9,5,4,1,2.812
2014/4/14,1345,8858,-8,13,10,3,1,1.464
2014/4/15,945,8886,25,22,4,18,0.997,0.601
2014/4/15,1045,8899,13,18,3,15,0.996,0.984
2014/4/15,1145,8895,-5,6,4,2,0.997,2.155
2014/4/15,1245,8893,-2,11,2,9,0.997,1.7
2014/4/15,1345,8896,3,9,2,7,0.997,1.053
2014/4/16,945,8901,-9,37,23,14,0.997,0.634
2014/4/16,1045,8908,6,17,9,8,0.997,1.585
2014/4/16,1145,8915,7,8,0,8,0.996,3.467
2014/4/16,1245,8916,2,9,7,2,0.997,1.834
2014/4/17,945,8897,13,69,59,10,0.999,0.326
2014/4/17,1045,8881,-15,36,27,9,1.002,0.62
2014/4/17,1145,8882,2,13,7,6,1.001,1.226
2014/4/17,1245,8885,3,12,7,5,1.001,2.292
2014/4/17,1345,8897,12,14,-2,16,0.999,1.044
2014/4/18,945,8931,-30,36,30,6,0.996,0.539
2014/4/18,1045,8926,-5,16,12,4,0.997,1.446
2014/4/18,1145,8924,-1,8,2,6,0.998,2.181
2014/4/18,1245,8925,2,9,3,6,0.998,2.724
2014/4/18,1345,8918,-7,9,10,-1,0.999,1.466
2014/4/21,945,8914,-3,15,8,7,0.999,0.869
2014/4/21,1045,8916,3,15,2,13,0.999,1.368
2014/4/21,1145,8916,1,5,1,4,1,4.502
2014/4/21,1245,8919,3,5,0,5,1,4.417
2014/4/21,1345,8923,4,8,3,5,1,1.115
2014/4/22,945,8943,18,32,6,26,0.997,0.417
2014/4/22,1045,8945,2,9,7,2,0.997,0.844
2014/4/22,1145,8957,12,14,3,11,0.996,1.111
2014/4/22,1245,8958,2,13,2,11,0.996,1.295
2014/4/22,1345,8950,-7,17,12,5,0.997,0.773
2014/4/23,945,8973,3,20,7,13,0.995,0.46
2014/4/23,1045,8966,-7,8,6,2,0.997,1.479
2014/4/23,1145,8920,-46,56,47,9,1.003,0.479
2014/4/23,1245,8918,-2,20,12,8,1.003,1.171
2014/4/23,1345,8922,3,13,7,6,1.002,1.117
2014/4/24,945,8925,-3,22,12,10,1.002,0.749
2014/4/24,1045,8940,15,24,2,22,1,1.122
2014/4/24,1145,8926,-14,17,15,2,1.002,1.827
2014/4/24,1245,8924,-2,7,3,4,1.002,2.022
2014/4/24,1345,8937,14,15,-2,17,1,1.553
2014/4/25,945,8880,-45,48,48,0,1.006,0.368
2014/4/25,1045,8798,-82,89,75,14,1.014,0.409
2014/4/25,1145,8764,-34,55,35,20,1.016,0.488
2014/4/25,1245,8770,6,33,6,27,1.014,0.943
2014/4/25,1345,8750,-20,28,24,4,1.014,1.091
2014/4/28,945,8727,29,64,33,31,1.014,0.583
2014/4/28,1045,8783,57,78,15,63,1.005,0.854
2014/4/28,1145,8798,15,36,16,20,1.002,1.327
2014/4/28,1245,8826,27,37,9,28,0.997,1.742
2014/4/28,1345,8819,-7,27,14,13,0.997,2.024
2014/4/29,945,8835,7,23,15,8,0.994,1.037
2014/4/29,1045,8829,-6,31,11,20,0.994,1.326
2014/4/29,1145,8835,6,24,14,10,0.994,1.552
2014/4/29,1245,8846,11,21,7,14,0.993,2.375
2014/4/29,1345,8840,-6,25,15,10,0.995,1.155
2014/4/30,945,8822,-28,39,31,8,0.999,0.671
2014/4/30,1045,8798,-24,39,23,16,1.003,0.67
2014/4/30,1145,8775,-23,36,33,3,1.005,1.147
2014/4/30,1245,8758,-17,26,19,7,1.007,1.076
2014/4/30,1345,8758,0,24,16,8,1.006,0.892
2014/5/2,945,8820,52,72,23,49,0.999,0.518
2014/5/2,1045,8825,5,23,10,13,0.998,1.478
2014/5/2,1145,8825,0,10,3,7,0.998,3.112
2014/5/2,1245,8817,-8,15,10,5,0.999,2.413
2014/5/2,1345,8841,24,23,0,23,0.996,1.42
2014/5/5,945,8839,-25,55,49,6,0.996,0.623
2014/5/5,1045,8819,-20,28,11,17,0.998,0.775
2014/5/5,1145,8828,10,27,8,19,0.998,1.727
2014/5/5,1245,8828,0,16,5,11,0.998,2.573
2014/5/5,1345,8827,-1,13,8,5,0.999,1.765
2014/5/6,945,8839,-10,48,22,26,0.999,0.531
2014/5/6,1045,8843,4,27,14,13,0.998,0.989
2014/5/6,1145,8875,32,35,4,31,0.995,0.924
2014/5/6,1245,8884,8,22,5,17,0.995,1.433
2014/5/6,1345,8885,1,19,-2,21,0.995,1.259
2014/5/7,945,8837,-8,28,24,4,1,0.592
2014/5/7,1045,8816,-22,24,17,7,1.003,0.752
2014/5/7,1145,8839,22,25,4,21,1,1.198
2014/5/7,1245,8837,-2,18,11,7,1,1.168
2014/5/7,1345,8840,2,12,4,8,1,1.606
2014/5/8,945,8843,-17,41,34,7,1,0.559
2014/5/8,1045,8865,22,25,4,21,0.998,1.107
2014/5/8,1145,8882,17,21,2,19,0.996,1.436
2014/5/8,1245,8884,2,11,3,8,0.996,2.531
2014/5/8,1345,8881,-3,9,5,4,0.996,1.536
2014/5/9,945,8849,-39,37,35,2,1,0.65
2014/5/9,1045,8847,-2,29,15,14,1.001,1.085
2014/5/9,1145,8849,2,17,8,9,1.001,1.884
2014/5/9,1245,8846,-4,14,10,4,1.001,2.466
2014/5/9,1345,8842,-4,14,8,6,1.002,1.252
2014/5/12,945,8811,-31,60,39,21,1.005,0.484
2014/5/12,1045,8821,11,21,1,20,1.004,0.898
2014/5/12,1145,8816,-5,16,13,3,1.004,1.272
2014/5/12,1245,8803,-13,24,18,6,1.004,1.442
2014/5/12,1345,8821,18,18,0,18,1.001,1.196
2014/5/13,945,8867,12,22,8,14,0.996,0.544
2014/5/13,1045,8852,-15,21,16,5,0.998,1.153
2014/5/13,1145,8830,-22,32,26,6,1,0.98
2014/5/13,1245,8831,1,20,10,10,1,1.652
2014/5/13,1345,8830,-1,11,8,3,1,1.495
2014/5/14,945,8833,-22,31,29,2,1,0.659
2014/5/14,1045,8843,10,16,5,11,0.999,1.296
2014/5/14,1145,8864,22,26,4,22,0.997,0.945
2014/5/14,1245,8866,2,14,11,3,0.997,1.298
2014/5/14,1345,8882,16,21,2,19,0.996,1.067
2014/5/15,945,8867,-1,30,20,10,0.998,0.548
2014/5/15,1045,8870,2,15,9,6,0.997,1.601
2014/5/15,1145,8869,-1,8,4,4,0.998,2.951
2014/5/15,1245,8871,2,10,5,5,0.998,2.883
2014/5/15,1345,8877,6,10,4,6,0.998,1.59
2014/5/16,945,8845,3,18,11,7,1.001,0.752
2014/5/16,1045,8832,-13,29,13,16,1.003,0.549
2014/5/16,1145,8832,0,8,2,6,1.003,2.733
2014/5/16,1245,8860,27,31,3,28,0.999,0.98
2014/5/16,1345,8876,16,25,7,18,0.997,0.663
2014/5/19,945,8888,12,29,10,19,0.996,0.547
2014/5/19,1045,8887,-2,13,5,8,0.996,1.88
2014/5/19,1145,8892,5,11,4,7,0.996,2.483
2014/5/19,1245,8893,1,13,8,5,0.996,1.618
2014/5/19,1345,8888,-5,10,10,0,0.997,1.479
2014/5/20,945,8912,10,21,0,21,0.995,0.672
2014/5/20,1045,8915,3,16,11,5,0.995,0.884
2014/5/20,1145,8898,-17,14,16,-2,0.998,1.544
2014/5/20,1245,8904,6,11,5,6,0.998,2.265
2014/5/20,1345,8897,-7,15,8,7,0.999,1.015
2014/5/21,945,8891,-1,17,14,3,1,1.021
2014/5/21,1045,8902,11,9,0,9,0.999,1.545
2014/5/21,1145,8903,1,8,6,2,0.999,1.843
2014/5/21,1245,8889,-14,22,15,7,1.001,1.159
2014/5/22,945,8876,3,45,19,26,1.002,0.343
2014/5/22,1045,8926,50,49,4,45,0.996,0.438
2014/5/22,1145,8939,14,20,3,17,0.995,0.997
2014/5/22,1245,8940,1,16,8,8,0.995,1.34
2014/5/22,1345,8959,19,22,-1,23,0.993,0.906
2014/5/23,945,8990,19,32,8,24,0.991,0.598
2014/5/23,1045,8996,5,20,8,12,0.991,1.312
2014/5/23,1145,8990,-6,12,10,2,0.993,3.308
2014/5/23,1245,9008,18,24,2,22,0.992,1.803
2014/5/23,1345,9013,5,17,-1,18,0.993,1.18
2014/5/26,945,9025,5,19,3,16,0.993,0.945
2014/5/26,1045,9041,15,22,6,16,0.993,1.098
2014/5/26,1145,9041,0,10,5,5,0.994,2.746
2014/5/26,1245,9044,4,11,5,6,0.995,2.597
2014/5/26,1345,9041,-4,12,6,6,0.996,1.414
2014/5/27,945,9031,-16,23,17,6,0.998,0.625
2014/5/27,1045,9042,11,21,9,12,0.998,0.916
2014/5/27,1145,9045,3,12,4,8,0.998,2.186
2014/5/27,1245,9043,-2,6,6,0,0.999,3.514
2014/5/27,1345,9056,13,14,1,13,0.998,1.083
2014/5/28,945,9083,21,27,-1,28,0.995,0.508
2014/5/28,1045,9088,6,29,23,6,0.995,0.473
2014/5/28,1145,9095,6,22,13,9,0.995,1.043
2014/5/28,1245,9126,31,38,8,30,0.992,0.729
2014/5/28,1345,9136,10,19,8,11,0.992,0.646
2014/5/29,945,9140,8,22,9,13,0.992,0.633
2014/5/29,1045,9126,-14,25,18,7,0.995,0.92
2014/5/29,1145,9135,9,10,1,9,0.995,2.241
2014/5/29,1245,9124,-11,15,11,4,0.997,2.042
2014/5/29,1345,9116,-9,23,18,5,0.999,1.032
2014/5/30,945,9122,1,29,8,21,0.999,0.658
2014/5/30,1045,9105,-18,24,23,1,1.001,1.452
2014/5/30,1145,9111,7,14,7,7,1.001,1.656
2014/5/30,1245,9104,-7,12,10,2,1.002,2.806
2014/5/30,1345,9091,-13,39,34,5,1.003,0.579
2014/6/3,945,9102,-10,32,31,1,1.001,0.607
2014/6/3,1045,9088,-14,43,16,27,1.003,0.627
2014/6/3,1145,9101,13,21,5,16,1.001,1.363
2014/6/3,1245,9095,-7,12,10,2,1.001,3.764
2014/6/3,1345,9104,9,35,9,26,1,0.858
2014/6/4,945,9101,-17,27,23,4,1,0.734
2014/6/4,1045,9117,16,18,2,16,0.998,1.598
2014/6/4,1145,9117,0,11,3,8,0.998,2.867
2014/6/4,1245,9113,-4,11,9,2,0.999,2.404
2014/6/4,1345,9102,-10,16,15,1,1,1.212
2014/6/5,945,9098,-19,37,13,24,1,0.493
2014/6/5,1045,9094,-4,16,10,6,1.001,1.222
2014/6/5,1145,9093,-2,15,5,10,1.001,1.519
2014/6/5,1245,9097,5,11,1,10,1.001,2.776
2014/6/5,1345,9118,21,23,0,23,0.998,0.734
2014/6/6,945,9135,-3,32,23,9,0.997,0.513
2014/6/6,1045,9139,4,16,8,8,0.997,1.497
2014/6/6,1145,9129,-10,12,13,-1,0.998,1.669
2014/6/6,1245,9122,-7,11,9,2,0.999,1.548
2014/6/6,1345,9125,3,10,6,4,0.999,1.278
2014/6/9,945,9133,-7,14,10,4,0.998,0.77
2014/6/9,1045,9150,17,15,-1,16,0.996,1.05
2014/6/9,1145,9149,0,10,6,4,0.997,1.837
2014/6/9,1245,9147,-2,5,5,0,0.998,3.663
2014/6/9,1345,9146,-1,10,6,4,0.999,1.076
2014/6/10,945,9181,22,38,14,24,0.995,0.394
2014/6/10,1045,9173,-9,18,10,8,0.996,0.83
2014/6/10,1145,9186,13,15,2,13,0.995,1.355
2014/6/10,1245,9193,7,11,1,10,0.995,1.52
2014/6/10,1345,9185,-8,18,17,1,0.997,0.646
2014/6/11,945,9190,-4,13,6,7,0.997,0.854
2014/6/11,1045,9195,5,12,6,6,0.997,1.443
2014/6/11,1145,9193,-2,6,5,1,0.998,4.021
2014/6/11,1245,9196,3,5,1,4,0.998,4.095
2014/6/11,1345,9211,14,22,1,21,0.997,0.739
2014/6/12,945,9185,-10,11,7,4,1,0.797
2014/6/12,1045,9196,10,17,3,14,0.999,0.969
2014/6/12,1145,9195,-1,9,7,2,0.999,2.027
2014/6/12,1245,9198,3,7,1,6,0.999,2.493
2014/6/12,1345,9204,6,18,11,7,0.998,0.627
2014/6/13,945,9158,-12,33,31,2,1.003,0.362
2014/6/13,1045,9176,18,19,4,15,1.001,0.893
2014/6/13,1145,9183,7,15,8,7,1,1.316
2014/6/13,1245,9193,9,15,3,12,0.999,1.782
2014/6/13,1345,9198,5,10,-1,11,0.998,1.162
2014/6/16,945,9183,3,11,7,4,1,0.951
2014/6/16,1045,9193,10,15,0,15,0.998,1.351
2014/6/16,1145,9200,9,7,-2,9,0.998,2.492
2014/6/16,1245,9211,12,19,3,16,0.996,1.248
2014/6/16,1345,9200,-9,14,12,2,0.998,1.071
2014/6/17,945,9210,3,19,12,7,0.997,0.589
2014/6/17,1045,9230,20,22,0,22,0.996,0.764
2014/6/17,1145,9231,1,11,7,4,0.996,1.062
2014/6/17,1245,9243,11,16,5,11,0.995,1.172
2014/6/17,1345,9241,-2,8,6,2,0.996,0.878
2014/6/18,945,9253,12,26,11,15,0.995,0.737
2014/6/18,1045,9249,-5,11,11,0,0.997,2.04
2014/6/18,1145,9234,-15,22,21,1,0.999,1.264
2014/6/18,1245,9232,-2,30,6,24,0.999,0.7
2014/6/19,945,9188,1,123,119,4,1.004,0.345
2014/6/19,1045,9197,9,13,3,10,1.003,1.478
2014/6/19,1145,9210,12,15,2,13,1.001,1.177
2014/6/19,1245,9233,24,29,4,25,0.998,0.864
2014/6/19,1345,9225,-8,25,10,15,0.999,0.798
2014/6/20,945,9217,-10,17,11,6,1,0.927
2014/6/20,1045,9218,1,16,12,4,1,1.389
2014/6/20,1145,9206,-12,15,13,2,1.001,1.36
2014/6/20,1245,9191,-15,26,19,7,1.002,0.915
2014/6/20,1345,9180,-11,20,18,2,1.002,0.956
2014/6/23,945,9186,7,31,10,21,1.002,0.789
2014/6/23,1045,9192,4,14,14,0,1.001,1.096
2014/6/23,1145,9174,-18,37,23,14,1.003,0.795
2014/6/23,1245,9162,-12,26,15,11,1.004,1.025
2014/6/23,1345,9166,4,11,1,10,1.003,1.281
2014/6/24,945,9192,18,19,-3,22,0.999,0.717
2014/6/24,1045,9193,1,12,5,7,0.999,1.495
2014/6/24,1145,9175,-18,25,21,4,1.001,1.233
2014/6/24,1245,9175,-1,16,6,10,1,1.817
2014/6/24,1345,9172,-3,7,7,0,1,1.686
2014/6/25,945,9151,5,33,19,14,1.002,0.545
2014/6/25,1045,9158,7,17,5,12,1.001,1.377
2014/6/25,1145,9153,-4,11,5,6,1.001,1.938
2014/6/25,1245,9165,11,11,-3,14,1,2.641
2014/6/25,1345,9157,-8,13,8,5,1.001,1.187
2014/6/26,945,9200,19,24,0,24,0.996,0.569
2014/6/26,1045,9230,30,40,5,35,0.993,0.573
2014/6/26,1145,9229,-2,11,8,3,0.993,1.799
2014/6/26,1245,9231,2,10,2,8,0.994,2.306
2014/6/26,1345,9233,1,14,2,12,0.994,0.881
2014/6/27,945,9239,8,20,3,17,0.995,0.734
2014/6/27,1045,9230,-9,18,12,6,0.996,1.373
2014/6/27,1145,9227,-3,13,6,7,0.998,1.575
2014/6/27,1245,9229,2,7,1,6,0.998,3.943
2014/6/27,1345,9207,-22,33,32,1,1.001,0.653
2014/6/30,945,9261,41,42,1,41,0.996,0.531
2014/6/30,1045,9281,20,33,4,29,0.994,0.709
2014/6/30,1145,9290,8,14,2,12,0.994,1.627
2014/6/30,1245,9295,5,9,6,3,0.994,2.023
2014/6/30,1345,9290,-5,20,17,3,0.995,0.711
2014/7/1,945,9328,29,46,7,39,0.992,0.544
2014/7/1,1045,9365,38,49,10,39,0.989,0.607
2014/7/1,1145,9400,35,37,1,36,0.987,0.966
2014/7/1,1245,9391,-9,20,8,12,0.989,1.278
2014/7/1,1345,9384,-7,22,9,13,0.992,1.087
2014/7/2,945,9433,29,30,5,25,0.989,0.577
2014/7/2,1045,9481,48,53,7,46,0.986,0.712
2014/7/2,1145,9407,-76,97,78,19,0.995,0.536
2014/7/2,1245,9376,-31,105,39,66,1,0.542
2014/7/2,1345,9402,25,49,4,45,0.998,1.058
2014/7/3,945,9380,-16,34,21,13,1.001,0.963
2014/7/3,1045,9440,61,68,9,59,0.996,0.837
2014/7/3,1145,9443,3,27,13,14,0.996,1.475
2014/7/3,1245,9447,3,22,16,6,0.996,2.185
2014/7/3,1345,9455,8,15,6,9,0.996,1.981
2014/7/4,945,9428,-60,83,66,17,1,0.63
2014/7/4,1045,9459,31,51,9,42,0.996,1.252
2014/7/4,1145,9453,-6,29,12,17,0.997,1.948
2014/7/4,1245,9454,1,21,9,12,0.997,2.611
2014/7/4,1345,9453,-2,12,4,8,0.998,2.595
2014/7/7,945,9443,-9,31,1,30,1,0.895
2014/7/7,1045,9419,-24,51,30,21,1.003,0.795
2014/7/7,1145,9422,3,15,1,14,1.002,2.093
2014/7/7,1245,9436,14,19,6,13,1.001,1.829
2014/7/7,1345,9451,16,28,2,26,0.999,1.171
2014/7/8,945,9468,16,30,2,28,0.997,0.58
2014/7/8,1045,9456,-12,23,17,6,0.998,1.018
2014/7/8,1145,9476,20,25,2,23,0.996,1.451
2014/7/8,1245,9484,8,12,2,10,0.996,1.464
2014/7/8,1345,9477,-7,19,15,4,0.997,1.139
2014/7/9,945,9461,11,20,16,4,0.998,0.83
2014/7/9,1045,9463,2,30,3,27,0.998,0.666
2014/7/9,1145,9467,4,19,7,12,0.998,1.49
2014/7/9,1245,9467,0,16,5,11,0.999,1.814
2014/7/9,1345,9465,-2,10,4,6,0.999,1.718
2014/7/10,945,9513,47,64,14,50,0.995,0.445
2014/7/10,1045,9523,10,31,2,29,0.994,0.742
2014/7/10,1145,9544,21,30,3,27,0.992,1.105
2014/7/10,1245,9537,-9,13,11,2,0.994,1.708
2014/7/10,1345,9553,15,19,1,18,0.993,1.146
2014/7/11,945,9549,9,29,0,29,0.994,0.614
2014/7/11,1045,9550,1,24,16,8,0.995,0.911
2014/7/11,1145,9505,-45,56,47,9,1.001,0.552
2014/7/11,1245,9474,-31,58,34,24,1.004,0.511
2014/7/11,1345,9487,13,24,3,21,1.003,1.194
2014/7/14,945,9506,27,27,7,20,1.001,1.102
2014/7/14,1045,9519,14,21,10,11,1,1.178
2014/7/14,1145,9515,-4,20,8,12,1,1.967
2014/7/14,1245,9523,7,13,2,11,0.999,4.334
2014/7/14,1345,9525,1,11,3,8,0.999,1.859
2014/7/15,945,9572,-3,39,9,30,0.994,0.712
2014/7/15,1045,9568,-3,23,4,19,0.995,1.781
2014/7/15,1145,9550,-18,20,21,-1,0.997,1.841
2014/7/15,1245,9554,4,22,2,20,0.997,0.905
2014/7/15,1345,9561,6,11,1,10,0.997,1.631
2014/7/16,945,9552,5,27,12,15,0.999,0.948
2014/7/16,1045,9527,-26,35,26,9,1.002,1.002
2014/7/16,1145,9519,-8,17,13,4,1.003,1.955
2014/7/16,1245,9481,-38,43,42,1,1.007,0.859
2014/7/17,945,9387,-5,138,114,24,1.015,0.339
2014/7/17,1045,9364,-23,25,25,0,1.016,1.257
2014/7/17,1145,9334,-30,45,37,8,1.017,0.575
2014/7/17,1245,9337,3,15,8,7,1.014,1.848
2014/7/17,1345,9356,20,26,4,22,1.01,1.103
2014/7/18,945,9350,65,61,3,58,1.007,0.604
2014/7/18,1045,9367,18,36,5,31,1.004,0.895
2014/7/18,1145,9340,-27,35,30,5,1.004,1.43
2014/7/18,1245,9352,12,15,2,13,1.001,2.867
2014/7/18,1345,9339,-14,27,28,-1,1.001,1.373
2014/7/21,945,9401,21,30,5,25,0.994,0.849
2014/7/21,1045,9362,-39,45,43,2,0.998,1.014
2014/7/21,1145,9371,9,18,7,11,0.997,2.004
2014/7/21,1245,9380,9,21,-1,22,0.997,1.772
2014/7/21,1345,9364,-17,15,15,0,0.999,1.594
2014/7/22,945,9386,2,38,4,34,0.998,0.61
2014/7/22,1045,9415,29,50,15,35,0.995,0.545
2014/7/22,1145,9425,10,22,7,15,0.994,1.403
2014/7/22,1245,9427,2,12,5,7,0.995,1.952
2014/7/22,1345,9433,7,11,1,10,0.995,1.046
2014/7/24,945,9458,2,24,11,13,0.993,0.569
2014/7/24,1045,9453,-5,16,11,5,0.995,1.416
2014/7/24,1145,9441,-12,24,18,6,0.997,1.421
2014/7/24,1245,9444,3,12,0,12,0.997,2.051
2014/7/24,1345,9469,25,32,1,31,0.995,1.001
2014/7/25,945,9446,-14,18,16,2,0.998,0.857
2014/7/25,1045,9401,-45,50,46,4,1.004,0.5
2014/7/25,1145,9396,-6,37,24,13,1.004,0.909
2014/7/25,1245,9371,-25,24,25,-1,1.007,1.207
2014/7/25,1345,9390,20,37,4,33,1.004,0.842
2014/7/28,945,9390,20,56,8,48,1.003,0.579
2014/7/28,1045,9417,27,39,5,34,1,0.73
2014/7/28,1145,9386,-31,35,34,1,1.002,1.61
2014/7/28,1245,9396,10,30,2,28,1.001,1.462
2014/7/28,1345,9387,-8,27,24,3,1.001,1.286
2014/7/29,945,9418,-7,33,28,5,0.998,0.82
2014/7/29,1045,9383,-36,47,45,2,1.001,0.857
2014/7/29,1145,9357,-26,43,44,-1,1.004,0.881
2014/7/29,1245,9366,8,30,7,23,1.002,0.966
2014/7/29,1345,9361,-5,21,10,11,1.003,1.324
2014/7/30,945,9398,31,47,18,29,0.999,0.685
2014/7/30,1045,9409,13,40,20,20,0.998,0.854
2014/7/30,1145,9407,-3,25,13,12,0.998,1.648
2014/7/30,1245,9416,8,24,2,22,0.997,2.315
2014/7/30,1345,9416,0,9,1,8,0.997,1.83
2014/7/31,945,9350,-83,172,87,85,1.004,0.475
2014/7/31,1045,9318,-32,53,33,20,1.007,0.775
2014/7/31,1145,9323,5,27,6,21,1.006,1.424
2014/7/31,1245,9318,-5,30,20,10,1.006,1.921
2014/7/31,1345,9290,-27,30,30,0,1.009,1.22
2014/8/1,945,9246,10,50,13,37,1.012,0.546
2014/8/1,1045,9231,-15,36,16,20,1.012,1.147
2014/8/1,1145,9253,21,33,7,26,1.008,2.034
2014/8/1,1245,9260,7,16,4,12,1.005,1.805
2014/8/1,1345,9253,-7,15,9,6,1.004,1.801
2014/8/4,945,9250,-10,33,16,17,1.003,0.804
2014/8/4,1045,9254,5,26,10,16,1.001,1.313
2014/8/4,1145,9274,20,29,10,19,0.998,1.226
2014/8/4,1245,9282,8,16,3,13,0.997,2.655
2014/8/4,1345,9286,3,18,11,7,0.996,0.967
2014/8/5,945,9199,-50,57,53,4,1.006,0.407
2014/8/5,1045,9152,-47,58,43,15,1.01,0.501
2014/8/5,1145,9122,-30,56,43,13,1.013,0.964
2014/8/5,1245,9113,-9,36,13,23,1.012,1.32
2014/8/5,1345,9095,-17,30,18,12,1.013,0.963
2014/8/6,945,9100,21,57,29,28,1.01,0.561
2014/8/6,1045,9094,-6,41,20,21,1.009,1.129
2014/8/6,1145,9073,-21,45,31,14,1.01,1.351
2014/8/6,1245,9107,34,49,4,45,1.004,1.39
2014/8/6,1345,9098,-10,19,19,0,1.003,1.687
2014/8/7,945,9099,-12,33,35,-2,1.001,0.943
2014/8/7,1045,9099,0,39,5,34,1,1.111
2014/8/7,1145,9097,-2,26,17,9,1,1.834
2014/8/7,1245,9096,-2,22,7,15,1,2.564
2014/8/7,1345,9092,-4,25,10,15,1,1.492
2014/8/8,945,9045,-7,54,32,22,1.005,0.483
2014/8/8,1045,9008,-37,67,50,17,1.008,0.697
2014/8/8,1145,9029,21,37,6,31,1.005,1.153
2014/8/8,1245,9047,17,27,-2,29,1.003,1.7
2014/8/8,1345,9090,42,54,3,51,0.997,0.922
2014/8/11,945,9135,3,33,8,25,0.992,0.725
2014/8/11,1045,9153,18,36,8,28,0.991,1.012
2014/8/11,1145,9148,-7,17,14,3,0.992,2.129
2014/8/11,1245,9158,11,18,-1,19,0.992,2.46
2014/8/11,1345,9141,-17,20,17,3,0.994,1.835
2014/8/12,945,9130,-22,47,20,27,0.996,0.605
2014/8/12,1045,9126,-4,33,32,1,0.998,0.82
2014/8/12,1145,9132,6,26,6,20,0.998,1.463
2014/8/12,1245,9129,-2,15,7,8,1,2.485
2014/8/12,1345,9121,-7,13,10,3,1.002,1.48
2014/8/13,945,9137,5,27,10,17,1,0.785
2014/8/13,1045,9192,56,64,9,55,0.994,0.455
2014/8/13,1145,9186,-5,21,12,9,0.995,1.474
2014/8/13,1245,9193,7,19,9,10,0.994,1.882
2014/8/13,1345,9199,6,14,5,9,0.994,1.099
2014/8/14,945,9235,7,25,18,7,0.991,0.579
2014/8/14,1045,9217,-19,39,30,9,0.994,0.806
2014/8/14,1145,9228,11,18,4,14,0.994,1.825
2014/8/14,1245,9212,-16,17,16,1,0.997,2.428
2014/8/14,1345,9218,6,18,3,15,0.997,1.284
2014/8/15,945,9182,-28,36,26,10,1.002,0.688
2014/8/15,1045,9168,-14,36,22,14,1.004,0.852
2014/8/15,1145,9208,41,51,10,41,0.999,0.815
2014/8/15,1245,9200,-8,15,11,4,1,1.887
2014/8/15,1345,9203,3,11,5,6,1,1.691
2014/8/18,945,9180,-32,56,43,13,1.002,0.586
2014/8/18,1045,9140,-41,47,44,3,1.006,0.78
2014/8/18,1145,9142,2,27,11,16,1.005,1.031
2014/8/18,1245,9147,5,18,10,8,1.004,2.079
2014/8/18,1345,9141,-6,24,22,2,1.004,1.148
2014/8/19,945,9215,54,44,1,43,0.995,0.593
2014/8/19,1045,9233,18,17,4,13,0.993,0.988
2014/8/19,1145,9232,-1,12,2,10,0.994,2.392
2014/8/19,1245,9246,15,20,1,19,0.993,1.79
2014/8/19,1345,9239,-8,15,10,5,0.994,1.32
2014/8/20,945,9257,4,37,24,13,0.993,0.819
2014/8/20,1045,9278,21,24,1,23,0.991,1.52
2014/8/20,1145,9262,-16,19,23,-4,0.995,2.033
2014/8/20,1245,9264,2,24,8,16,0.996,1.528
2014/8/21,945,9222,-38,66,61,5,1.001,0.376
2014/8/21,1045,9224,2,27,3,24,1.002,0.677
2014/8/21,1145,9209,-14,34,37,-3,1.004,0.865
2014/8/21,1245,9230,21,26,4,22,1.001,1.5
2014/8/21,1345,9231,1,10,3,7,1.001,1.428
2014/8/22,945,9339,90,66,-6,72,0.989,0.428
2014/8/22,1045,9356,19,14,1,13,0.988,1.169
2014/8/22,1145,9385,30,34,2,32,0.986,1.146
2014/8/22,1245,9378,-6,15,10,5,0.988,2.26
2014/8/22,1345,9378,-1,17,7,10,0.99,1.239
2014/8/25,945,9389,3,34,10,24,0.99,0.785
2014/8/25,1045,9378,-10,20,14,6,0.993,1.527
2014/8/25,1145,9382,4,16,5,11,0.994,2.334
2014/8/25,1245,9389,8,16,5,11,0.995,2.651
2014/8/25,1345,9391,2,9,2,7,0.996,1.963
2014/8/26,945,9399,13,33,9,24,0.997,0.534
2014/8/26,1045,9399,0,15,3,12,0.998,1.53
2014/8/26,1145,9397,-2,9,5,4,0.998,2.357
2014/8/26,1245,9401,5,7,2,5,0.998,3.492
2014/8/26,1345,9390,-11,14,12,2,1,1.165
2014/8/27,945,9465,44,39,4,35,0.992,0.375
2014/8/27,1045,9484,19,25,1,24,0.991,0.797
2014/8/27,1145,9481,-3,21,17,4,0.992,0.92
2014/8/27,1245,9467,-14,15,19,-4,0.995,1.467
2014/8/27,1345,9477,9,27,11,16,0.995,0.766
2014/8/28,945,9479,-13,26,21,5,0.995,0.595
2014/8/28,1045,9481,2,12,8,4,0.996,1.691
2014/8/28,1145,9493,12,23,-1,24,0.996,1.265
2014/8/28,1245,9480,-13,15,14,1,0.998,2.56
2014/8/28,1345,9479,-2,12,10,2,0.999,1.73
2014/8/29,945,9467,11,42,7,35,1.001,0.52
2014/8/29,1045,9480,13,22,5,17,0.999,0.981
2014/8/29,1145,9464,-17,27,20,7,1.001,1.15
2014/8/29,1245,9473,9,9,2,7,1,2.459
2014/8/29,1345,9473,0,21,6,15,1,0.905
2014/9/1,945,9539,66,67,11,56,0.993,0.42
2014/9/1,1045,9535,-5,13,11,2,0.994,1.444
2014/9/1,1145,9530,-5,13,10,3,0.995,2.087
2014/9/1,1245,9536,5,9,2,7,0.995,3.642
2014/9/1,1345,9528,-7,18,13,5,0.996,1.253
2014/9/2,945,9472,-40,37,32,5,1.003,0.462
2014/9/2,1045,9454,-18,36,15,21,1.005,0.583
2014/9/2,1145,9452,-3,20,6,14,1.004,1.289
2014/9/2,1245,9418,-35,47,38,9,1.008,0.761
2014/9/2,1345,9410,-8,31,9,22,1.008,0.716
2014/9/3,945,9428,13,49,20,29,1.006,0.607
2014/9/3,1045,9465,38,52,17,35,1.001,0.613
2014/9/3,1145,9468,3,16,6,10,1,2.754
2014/9/3,1245,9446,-22,30,22,8,1.001,1.506
2014/9/3,1345,9451,5,19,9,10,1,1.584
2014/9/4,945,9426,-21,66,20,46,1.002,0.517
2014/9/4,1045,9410,-16,28,32,-4,1.003,1.594
2014/9/4,1145,9418,8,20,4,16,1.002,1.663
2014/9/4,1245,9422,4,19,11,8,1.001,2.208
2014/9/4,1345,9425,2,17,5,12,1.001,1.585
2014/9/5,945,9421,-23,55,42,13,1.001,0.608
2014/9/5,1045,9389,-33,43,36,7,1.005,0.73
2014/9/5,1145,9384,-5,26,12,14,1.004,1.212
2014/9/5,1245,9383,0,22,15,7,1.004,2.084
2014/9/5,1345,9407,24,35,10,25,1,0.988
2014/9/9,945,9468,42,84,62,22,0.994,0.513
2014/9/9,1045,9452,-16,31,27,4,0.996,1.538
2014/9/9,1145,9459,7,21,5,16,0.995,1.975
2014/9/9,1245,9454,-5,16,8,8,0.996,3.234
2014/9/9,1345,9428,-26,29,30,-1,1,1.551
2014/9/10,945,9332,-48,75,70,5,1.009,0.447
2014/9/10,1045,9325,-6,27,12,15,1.009,0.934
2014/9/10,1145,9328,3,16,4,12,1.008,2.357
2014/9/10,1245,9348,20,25,-2,27,1.005,1.781
2014/9/10,1345,9347,-1,21,18,3,1.005,0.793
2014/9/11,945,9360,-16,37,17,20,1.003,0.629
2014/9/11,1045,9345,-14,26,14,12,1.003,1.213
2014/9/11,1145,9355,10,18,2,16,1.001,2.333
2014/9/11,1245,9344,-11,17,11,6,1.001,3.01
2014/9/11,1345,9302,-42,44,43,1,1.005,0.884
2014/9/12,945,9276,-49,60,52,8,1.007,0.467
2014/9/12,1045,9257,-19,34,27,7,1.008,0.567
2014/9/12,1145,9244,-14,30,23,7,1.009,1.223
2014/9/12,1245,9252,8,30,10,20,1.007,1.323
2014/9/12,1345,9245,-7,25,9,16,1.007,0.943
2014/9/15,945,9220,14,72,24,48,1.008,0.493
2014/9/15,1045,9222,2,34,2,32,1.006,1.043
2014/9/15,1145,9231,9,21,4,17,1.004,2.021
2014/9/15,1245,9222,-10,18,9,9,1.003,2.626
2014/9/15,1345,9218,-5,20,6,14,1.003,1.588
2014/9/16,945,9193,-26,51,40,11,1.004,0.671
2014/9/16,1045,9189,-4,14,6,8,1.004,1.536
2014/9/16,1145,9169,-19,25,19,6,1.005,1.237
2014/9/16,1245,9152,-17,21,17,4,1.006,1.381
2014/9/16,1345,9154,2,25,12,13,1.005,1.005
2014/9/17,945,9223,28,51,0,51,0.997,0.697
2014/9/17,1045,9233,10,25,15,10,0.996,1.157
2014/9/17,1145,9232,-1,17,5,12,0.996,3.234
2014/9/17,1245,9191,-40,38,44,-6,1.001,1.831
2014/9/18,945,9226,-8,117,39,78,0.997,0.355
2014/9/18,1045,9230,5,28,18,10,0.997,0.901
2014/9/18,1145,9234,5,16,8,8,0.997,2.413
2014/9/18,1245,9231,-3,17,5,12,0.997,1.788
2014/9/18,1345,9243,13,19,1,18,0.997,1.48
2014/9/19,945,9283,2,34,17,17,0.994,0.592
2014/9/19,1045,9257,-26,34,30,4,0.998,1.006
2014/9/19,1145,9257,1,22,5,17,0.998,1.28
2014/9/19,1245,9270,13,24,1,23,0.997,1.808
2014/9/19,1345,9265,-5,31,19,12,0.998,0.958
2014/9/22,945,9120,-82,81,83,-2,1.013,0.396
2014/9/22,1045,9103,-17,27,24,3,1.014,0.862
2014/9/22,1145,9116,13,18,4,14,1.011,2.137
2014/9/22,1245,9134,18,35,9,26,1.008,1.209
2014/9/22,1345,9128,-5,16,6,10,1.008,1.196
2014/9/23,945,9126,20,37,15,22,1.006,0.699
2014/9/23,1045,9123,-3,27,29,-2,1.005,1.064
2014/9/23,1145,9133,10,16,4,12,1.002,2.906
2014/9/23,1245,9110,-23,26,25,1,1.003,1.642
2014/9/23,1345,9117,7,19,8,11,1.001,1.365
2014/9/24,945,9128,33,61,14,47,0.998,0.554
2014/9/24,1045,9109,-19,29,17,12,1,0.877
2014/9/24,1145,9115,6,12,7,5,1,1.783
2014/9/24,1245,9123,9,16,7,9,0.999,1.871
2014/9/24,1345,9127,4,13,1,12,0.998,1.516
2014/9/25,945,9122,-36,38,34,4,0.999,0.547
2014/9/25,1045,9039,-83,72,86,-14,1.009,0.516
2014/9/25,1145,9038,0,39,17,22,1.008,0.847
2014/9/25,1245,9022,-16,31,22,9,1.009,1.236
2014/9/25,1345,9028,7,36,3,33,1.007,0.792
2014/9/26,945,8973,15,53,17,36,1.012,0.562
2014/9/26,1045,9003,31,61,19,42,1.006,0.83
2014/9/26,1145,8999,-3,30,17,13,1.006,1.795
2014/9/26,1245,8979,-19,39,21,18,1.007,1.506
2014/9/26,1345,8980,2,30,27,3,1.005,1.447
2014/9/29,945,8992,1,50,16,34,1.002,0.771
2014/9/29,1045,8956,-36,56,43,13,1.004,0.954
2014/9/29,1145,8967,12,29,19,10,1.002,1.606
2014/9/29,1245,8972,6,23,11,12,1.001,2.442
2014/9/29,1345,8982,10,33,11,22,0.999,1.07
2014/9/30,945,8926,-35,63,49,14,1.005,0.587
2014/9/30,1045,8871,-55,58,58,0,1.011,0.769
2014/9/30,1145,8923,52,59,13,46,1.004,0.933
2014/9/30,1245,9005,82,109,16,93,0.994,0.634
2014/9/30,1345,8991,-12,40,29,11,0.996,1.058
2014/10/1,945,9008,65,96,-1,97,0.993,0.551
2014/10/1,1045,9004,-3,30,11,19,0.994,1.197
2014/10/1,1145,8982,-23,38,22,16,0.997,1.608
2014/10/1,1245,8995,14,25,3,22,0.996,2.659
2014/10/1,1345,8980,-15,26,24,2,0.997,1.784
2014/10/2,945,8924,4,47,28,19,1.003,0.66
2014/10/2,1045,8932,8,28,8,20,1.002,1.508
2014/10/2,1145,8983,50,71,16,55,0.997,0.855
2014/10/2,1245,9002,19,42,18,24,0.996,1.053
2014/10/2,1345,8993,-8,27,12,15,0.997,1.49
2014/10/3,945,9021,17,54,27,27,0.994,0.531
2014/10/3,1045,9063,41,44,3,41,0.99,0.763
2014/10/3,1145,9074,10,21,2,19,0.989,1.9
2014/10/3,1245,9089,14,35,18,17,0.989,1.305
2014/10/3,1345,9101,12,11,1,10,0.989,1.67
2014/10/6,945,9075,-23,41,22,19,0.993,0.711
2014/10/6,1045,9086,11,37,24,13,0.994,0.973
2014/10/6,1145,9091,5,27,3,24,0.995,1.543
2014/10/6,1245,9091,1,15,1,14,0.996,2.905
2014/10/6,1345,9084,-6,17,10,7,0.998,2.096
2014/10/7,945,8996,-38,72,52,20,1.008,0.424
2014/10/7,1045,9039,43,55,6,49,1.003,0.868
2014/10/7,1145,9023,-16,39,23,16,1.004,1.27
2014/10/7,1245,9018,-5,21,15,6,1.004,2.166
2014/10/7,1345,9017,0,22,4,18,1.004,1.153
2014/10/8,945,8994,8,38,18,20,1.005,0.67
2014/10/8,1045,9015,21,22,1,21,1.002,1.456
2014/10/8,1145,9021,6,14,8,6,1,1.358
2014/10/8,1245,9003,-19,24,21,3,1.002,2.133
2014/10/8,1345,8933,-70,70,70,0,1.008,0.803
2014/10/9,945,9014,17,51,25,26,0.999,0.53
2014/10/9,1045,8982,-33,58,30,28,1.003,0.575
2014/10/9,1145,8951,-30,34,36,-2,1.006,1.449
2014/10/9,1245,8982,30,40,15,25,1.001,1.365
2014/10/9,1345,8981,-1,37,4,33,1.001,0.999
2014/10/13,945,8794,-4,72,21,51,1.02,0.45
2014/10/13,1045,8745,-48,50,61,-11,1.024,1.294
2014/10/13,1145,8766,22,25,10,15,1.018,2.122
2014/10/13,1245,8737,-29,31,31,0,1.019,2.029
2014/10/13,1345,8712,-25,32,32,0,1.018,1.003
2014/10/14,945,8710,-20,35,27,8,1.016,0.795
2014/10/14,1045,8750,40,45,3,42,1.007,1.062
2014/10/14,1145,8730,-20,35,29,6,1.007,1.826
2014/10/14,1245,8731,1,19,8,11,1.004,2.784
2014/10/14,1345,8745,13,24,12,12,1,1.314
2014/10/15,945,8691,-52,70,72,-2,1.006,0.691
2014/10/15,1045,8687,-2,31,27,4,1.005,1.3
2014/10/15,1145,8699,12,42,13,29,1.003,1.47
2014/10/15,1245,8692,-7,23,11,12,1.003,2.288
2014/10/16,945,8535,-48,189,160,29,1.019,0.316
2014/10/16,1045,8553,18,61,26,35,1.015,0.71
2014/10/16,1145,8658,105,100,-1,101,1.001,0.623
2014/10/16,1245,8653,-5,56,30,26,1,0.946
2014/10/16,1345,8632,-20,41,30,11,1.002,1.302
2014/10/17,945,8634,-24,68,39,29,1.001,0.659
2014/10/17,1045,8595,-40,87,49,38,1.004,0.629
2014/10/17,1145,8555,-41,56,48,8,1.008,1.473
2014/10/17,1245,8542,-13,51,30,21,1.008,1.32
2014/10/17,1345,8500,-42,46,43,3,1.011,1.296
2014/10/20,945,8628,29,45,5,40,0.996,0.816
2014/10/20,1045,8641,15,30,23,7,0.996,1.373
2014/10/20,1145,8625,-16,35,27,8,0.998,2.08
2014/10/20,1245,8670,45,60,11,49,0.993,1.52
2014/10/20,1345,8661,-9,25,16,9,0.994,1.858
2014/10/21,945,8633,-22,34,23,11,0.997,0.822
2014/10/21,1045,8640,7,47,23,24,0.997,0.966
2014/10/21,1145,8631,-9,18,13,5,0.998,2.166
2014/10/21,1245,8633,2,15,6,9,0.999,3.117
2014/10/21,1345,8636,3,14,7,7,0.999,1.677
2014/10/22,945,8724,-24,28,18,10,0.991,0.642
2014/10/22,1045,8756,32,40,8,32,0.989,0.737
2014/10/22,1145,8748,-9,15,13,2,0.991,2.222
2014/10/22,1245,8736,-13,15,11,4,0.994,1.558
2014/10/22,1345,8744,8,19,4,15,0.993,1.149
2014/10/23,945,8722,-10,27,13,14,0.997,0.736
2014/10/23,1045,8715,-7,36,25,11,0.999,0.707
2014/10/23,1145,8715,1,17,4,13,0.999,1.564
2014/10/23,1245,8720,5,15,8,7,1,2.12
2014/10/23,1345,8721,1,11,9,2,1.001,1.562
2014/10/24,945,8663,-79,113,83,30,1.007,0.335
2014/10/24,1045,8653,-8,27,14,13,1.008,0.942
2014/10/24,1145,8627,-26,47,35,12,1.01,1.02
2014/10/24,1245,8624,-2,19,4,15,1.009,1.633
2014/10/24,1345,8642,17,29,0,29,1.005,1.034
2014/10/27,945,8597,-78,77,89,-12,1.01,0.591
2014/10/27,1045,8640,44,40,5,35,1.003,0.959
2014/10/27,1145,8641,1,29,27,2,1.002,1.323
2014/10/27,1245,8625,-17,31,32,-1,1.003,2.313
2014/10/27,1345,8642,18,23,1,22,1,1.608
2014/10/28,945,8768,102,108,6,102,0.985,0.393
2014/10/28,1045,8761,-7,27,24,3,0.987,1.021
2014/10/28,1145,8774,13,15,2,13,0.987,2.67
2014/10/28,1245,8792,18,24,3,21,0.986,1.646
2014/10/28,1345,8793,1,18,12,6,0.988,1.13
2014/10/29,945,8847,14,36,7,29,0.984,0.581
2014/10/29,1045,8856,9,21,4,17,0.986,1.479
2014/10/29,1145,8888,32,40,7,33,0.985,1.055
2014/10/29,1245,8891,3,11,2,9,0.987,3.319
2014/10/29,1345,8879,-12,28,26,2,0.991,1.08
2014/10/30,945,8862,-16,33,24,9,0.996,0.701
2014/10/30,1045,8857,-4,24,5,19,0.997,0.991
2014/10/30,1145,8862,5,21,8,13,0.998,2.039
2014/10/30,1245,8883,20,39,6,33,0.997,1.101
2014/10/30,1345,8881,-1,15,6,9,0.998,1.211
2014/10/31,945,8918,31,66,15,51,0.994,0.461
2014/10/31,1045,8891,-27,43,31,12,0.998,0.965
2014/10/31,1145,8908,18,30,8,22,0.997,1.314
2014/10/31,1245,8907,-1,23,9,14,0.997,1.864
2014/10/31,1345,8978,71,69,0,69,0.989,0.527
2014/11/3,945,8972,-6,55,25,30,0.991,0.6
2014/11/3,1045,9023,51,56,4,52,0.987,0.865
2014/11/3,1145,9020,-4,21,5,16,0.989,1.865
2014/11/3,1245,9004,-15,26,19,7,0.992,2.149
2014/11/3,1345,8982,-22,30,21,9,0.996,1.05
2014/11/4,945,8990,6,44,26,18,0.996,0.7
2014/11/4,1045,9031,42,64,24,40,0.992,0.657
2014/11/4,1145,8993,-38,53,41,12,0.998,0.894
2014/11/4,1245,8978,-15,30,37,-7,1.001,1.644
2014/11/4,1345,8992,13,36,18,18,1,1.478
2014/11/5,945,8975,-55,68,64,4,1.003,0.671
2014/11/5,1045,8973,-3,28,15,13,1.003,0.922
2014/11/5,1145,8984,10,31,9,22,1.001,1.524
2014/11/5,1245,8975,-10,18,13,5,1.002,2.667
2014/11/5,1345,8984,9,25,3,22,1,1.346
2014/11/6,945,8977,1,63,28,35,1.001,0.568
2014/11/6,1045,8970,-6,32,18,14,1.002,1.415
2014/11/6,1145,8961,-8,15,9,6,1.002,1.92
2014/11/6,1245,8914,-48,52,49,3,1.007,0.799
2014/11/6,1345,8902,-12,30,18,12,1.008,0.924
2014/11/7,945,8878,-46,46,52,-6,1.009,0.66
2014/11/7,1045,8930,52,76,8,68,1.002,0.713
2014/11/7,1145,8931,1,28,8,20,1.002,1.221
2014/11/7,1245,8928,-2,27,15,12,1.001,2.137
2014/11/7,1345,8939,11,14,-2,16,0.999,2.018
2014/11/10,945,9079,114,118,-9,127,0.984,0.437
2014/11/10,1045,9083,5,18,9,9,0.985,1.357
2014/11/10,1145,9070,-13,23,17,6,0.987,2.085
2014/11/10,1245,9068,-2,19,16,3,0.989,2.553
2014/11/10,1345,9074,5,21,8,13,0.99,1.264
2014/11/11,945,9077,-11,39,28,11,0.991,0.665
2014/11/11,1045,9076,-2,29,15,14,0.994,1.172
2014/11/11,1145,9072,-3,13,9,4,0.996,2.534
2014/11/11,1245,9065,-6,26,9,17,0.998,1.228
2014/11/11,1345,9063,-2,19,13,6,1,1.573
2014/11/12,945,8973,-55,64,59,5,1.01,0.408
2014/11/12,1045,8956,-17,45,37,8,1.011,0.729
2014/11/12,1145,8942,-15,26,20,6,1.011,1.197
2014/11/12,1245,8929,-14,20,15,5,1.011,1.397
2014/11/12,1345,8905,-24,27,23,4,1.012,0.78
2014/11/13,945,8954,34,62,11,51,1.005,0.615
2014/11/13,1045,8935,-20,46,43,3,1.006,0.954
2014/11/13,1145,8936,1,28,14,14,1.004,1.712
2014/11/13,1245,8941,5,21,7,14,1.002,1.983
2014/11/13,1345,8959,17,30,13,17,0.999,1.147
2014/11/14,945,8956,-24,43,20,23,0.998,0.615
2014/11/14,1045,8982,25,57,11,46,0.995,0.901
2014/11/14,1145,8985,3,23,11,12,0.995,2.161
2014/11/14,1245,8960,-25,41,27,14,0.999,1.329
2014/11/14,1345,8962,3,15,8,7,0.999,1.982
2014/11/17,945,8903,-56,147,140,7,1.006,0.389
2014/11/17,1045,8903,-1,59,28,31,1.005,0.744
2014/11/17,1145,8917,14,29,14,15,1.003,1.43
2014/11/17,1245,8911,-6,44,24,20,1.004,1.441
2014/11/17,1345,8900,-11,18,14,4,1.005,1.616
2014/11/18,945,8918,-33,44,36,8,1.002,0.722
2014/11/18,1045,8898,-20,24,15,9,1.004,1.168
2014/11/18,1145,8865,-34,49,42,7,1.007,1.247
2014/11/18,1245,8855,-10,34,18,16,1.007,1.573
2014/11/18,1345,8872,17,31,4,27,1.004,1.202
2014/11/19,945,8936,31,64,5,59,0.996,0.887
2014/11/19,1045,8973,37,36,10,26,0.992,1.115
2014/11/19,1145,8978,4,21,7,14,0.992,2.777
2014/11/19,1245,8951,-27,58,31,27,0.996,1.824
2014/11/20,945,9070,39,136,8,128,0.984,0.402
2014/11/20,1045,9086,16,22,6,16,0.984,1.124
2014/11/20,1145,9099,14,19,-1,20,0.984,1.922
2014/11/20,1245,9093,-5,15,11,4,0.987,1.857
2014/11/20,1345,9093,0,15,10,5,0.99,1.176
2014/11/21,945,9096,-23,44,29,15,0.992,0.554
2014/11/21,1045,9091,-4,24,17,7,0.995,1.2
2014/11/21,1145,9103,11,19,6,13,0.995,2.113
2014/11/21,1245,9102,-1,12,4,8,0.997,2.979
2014/11/21,1345,9103,0,9,3,6,0.998,1.976
2014/11/24,945,9125,-10,61,45,16,0.997,0.472
2014/11/24,1045,9139,15,28,6,22,0.996,1.205
2014/11/24,1145,9136,-4,15,5,10,0.997,2.655
2014/11/24,1245,9121,-15,24,17,7,0.999,1.8
2014/11/24,1345,9130,9,17,2,15,0.998,1.612
2014/11/25,945,9104,-12,51,16,35,1.001,0.429
2014/11/25,1045,9132,28,30,3,27,0.998,0.777
2014/11/25,1145,9134,3,21,16,5,0.998,1.18
2014/11/25,1245,9136,2,14,3,11,0.998,1.997
2014/11/25,1345,9107,-28,45,42,3,1.002,0.819
2014/11/26,945,9141,15,35,-4,39,0.998,0.631
2014/11/26,1045,9124,-17,13,11,2,1,1.432
2014/11/26,1145,9118,-5,17,4,13,1,1.285
2014/11/26,1245,9121,3,13,7,6,1,2.365
2014/11/26,1345,9123,3,12,7,5,1,1.529
2014/11/27,945,9234,98,67,-3,70,0.988,0.391
2014/11/27,1045,9196,-38,41,32,9,0.993,0.793
2014/11/27,1145,9203,7,19,5,14,0.993,2.046
2014/11/27,1245,9204,0,12,3,9,0.994,3.491
2014/11/27,1345,9176,-28,51,41,10,0.998,0.744
2014/11/28,945,9194,-8,34,14,20,0.997,0.667
2014/11/28,1045,9192,-2,14,7,7,0.997,2.025
2014/11/28,1145,9194,2,8,2,6,0.998,3.352
2014/11/28,1245,9192,-2,4,2,2,0.999,7.288
2014/11/28,1345,9181,-11,15,12,3,1.001,1.103
2014/12/1,945,9128,92,143,6,137,1.006,0.275
2014/12/1,1045,9145,17,60,37,23,1.003,0.531
2014/12/1,1145,9145,1,24,4,20,1.002,1.628
2014/12/1,1245,9107,-38,55,42,13,1.006,1.156
2014/12/1,1345,9119,12,28,8,20,1.003,1.193
2014/12/2,945,9026,-66,66,72,-6,1.012,0.455
2014/12/2,1045,9037,11,43,7,36,1.009,0.653
2014/12/2,1145,9043,6,26,7,19,1.007,1.775
2014/12/2,1245,9025,-18,36,22,14,1.007,2.059
2014/12/2,1345,9031,5,21,8,13,1.005,1.576
2014/12/3,945,9121,70,97,11,86,0.995,0.491
2014/12/3,1045,9148,27,34,2,32,0.992,1.082
2014/12/3,1145,9178,30,54,23,31,0.989,0.938
2014/12/3,1245,9182,4,20,12,8,0.989,2.427
2014/12/3,1345,9211,30,27,-4,31,0.986,1.453
2014/12/4,945,9220,7,62,46,16,0.987,0.627
2014/12/4,1045,9223,2,31,9,22,0.989,1.368
2014/12/4,1145,9236,13,26,8,18,0.989,1.912
2014/12/4,1245,9226,-10,25,17,8,0.992,2.498
2014/12/4,1345,9220,-6,11,9,2,0.995,2.39
2014/12/5,945,9199,-4,46,29,17,0.999,0.599
2014/12/5,1045,9203,5,37,28,9,0.999,0.845
2014/12/5,1145,9215,12,19,5,14,0.999,2.32
2014/12/5,1245,9209,-7,18,13,5,1,3.181
2014/12/5,1345,9216,8,9,-2,11,0.999,2.119
2014/12/8,945,9197,-67,90,61,29,1.002,0.395
2014/12/8,1045,9217,19,48,11,37,1,0.802
2014/12/8,1145,9200,-16,24,20,4,1.001,1.559
2014/12/8,1245,9184,-16,14,14,0,1.003,2.053
2014/12/8,1345,9185,1,20,8,12,1.002,1.456
2014/12/9,945,9136,-6,53,38,15,1.007,0.448
2014/12/9,1045,9157,22,36,5,31,1.004,1.096
2014/12/9,1145,9140,-17,23,21,2,1.005,1.884
2014/12/9,1245,9134,-7,15,11,4,1.005,2.348
2014/12/9,1345,9132,-3,13,13,0,1.004,1.85
2014/12/10,945,9119,27,44,17,27,1.004,0.482
2014/12/10,1045,9015,-103,122,113,9,1.015,0.38
2014/12/10,1145,9033,18,20,2,18,1.01,1.068
2014/12/10,1245,9029,-5,24,20,4,1.009,1.369
2014/12/10,1345,9046,17,45,2,43,1.005,0.942
2014/12/11,945,9018,42,71,11,60,1.007,0.522
2014/12/11,1045,9035,18,38,11,27,1.004,1.17
2014/12/11,1145,9038,3,20,10,10,1.002,2.258
2014/12/11,1245,9014,-25,39,25,14,1.003,1.702
2014/12/11,1345,9010,-4,16,15,1,1.002,1.958
2014/12/12,945,9046,23,49,23,26,0.998,0.786
2014/12/12,1045,9034,-12,43,24,19,0.998,1.02
2014/12/12,1145,9032,-2,13,9,4,0.999,3.546
2014/12/12,1245,9011,-21,35,32,3,1.001,1.458
2014/12/12,1345,9006,-5,15,15,0,1.001,1.698
2014/12/15,945,8958,0,53,20,33,1.007,0.471
2014/12/15,1045,8967,8,42,8,34,1.005,0.912
2014/12/15,1145,8994,26,22,10,12,1.001,1.046
2014/12/15,1245,8995,1,21,4,17,1,2.186
2014/12/15,1345,9036,41,44,-4,48,0.996,1.196
2014/12/16,945,8993,22,58,37,21,1,0.553
2014/12/16,1045,9031,39,64,10,54,0.995,0.721
2014/12/16,1145,9014,-18,32,21,11,0.997,1.565
2014/12/16,1245,9008,-7,25,11,14,0.997,1.794
2014/12/16,1345,8981,-26,46,28,18,1,1.097
2014/12/17,945,8928,-42,53,57,-4,1.006,0.737
2014/12/17,1045,8912,-17,33,23,10,1.008,1.295
2014/12/17,1145,8896,-16,30,17,13,1.009,1.826
2014/12/17,1245,8861,-35,52,47,5,1.012,1.745
2014/12/18,945,8903,1,93,24,69,1.006,0.427
2014/12/18,1045,8884,-18,39,24,15,1.008,0.979
2014/12/18,1145,8891,7,20,3,17,1.006,1.974
2014/12/18,1245,8867,-25,29,25,4,1.007,1.581
2014/12/18,1345,8857,-9,15,16,-1,1.006,1.303
2014/12/19,945,8978,16,35,15,20,0.992,0.506
2014/12/19,1045,9034,56,62,4,58,0.986,0.629
2014/12/19,1145,9029,-6,14,11,3,0.988,2.298
2014/12/19,1245,8972,-57,68,57,11,0.995,0.739
2014/12/19,1345,9019,46,44,-1,45,0.991,1.072
2014/12/22,945,9056,25,35,2,33,0.988,0.761
2014/12/22,1045,9081,25,46,17,29,0.987,0.863
2014/12/22,1145,9071,-11,26,22,4,0.991,1.831
2014/12/22,1245,9083,13,20,0,20,0.991,2.576
2014/12/22,1345,9096,12,21,4,17,0.992,1.387
2014/12/23,945,9115,-19,32,25,7,0.992,0.849
2014/12/23,1045,9113,-3,23,7,16,0.994,1.317
2014/12/23,1145,9110,-3,19,14,5,0.995,2.604
2014/12/23,1245,9108,-1,12,7,5,0.996,3.383
2014/12/23,1345,9115,7,17,8,9,0.997,1.477
2014/12/24,945,9131,11,45,17,28,0.996,0.563
2014/12/24,1045,9159,27,37,12,25,0.994,0.661
2014/12/24,1145,9166,7,20,10,10,0.994,1.11
2014/12/24,1245,9172,6,16,6,10,0.994,2.288
2014/12/24,1345,9176,4,11,7,4,0.995,0.96
2014/12/25,945,9173,2,33,22,11,0.996,0.684
2014/12/25,1045,9173,-1,19,12,7,0.996,1.662
2014/12/25,1145,9179,6,7,-1,8,0.996,4.797
2014/12/25,1245,9177,-2,7,5,2,0.997,4.678
2014/12/25,1345,9183,5,8,0,8,0.997,2.424
2014/12/26,945,9212,34,51,12,39,0.995,0.52
2014/12/26,1045,9187,-25,33,25,8,0.998,0.768
2014/12/26,1145,9196,10,20,11,9,0.998,1.286
2014/12/26,1245,9203,7,14,7,7,0.997,2.06
2014/12/26,1345,9226,23,27,3,24,0.995,0.708
2014/12/27,945,9234,-1,23,15,8,0.995,0.88
2014/12/27,1045,9242,7,9,2,7,0.995,2.906
2014/12/27,1145,9242,0,5,4,1,0.995,4.269
2014/12/27,1245,9242,0,9,2,7,0.996,3.571
2014/12/27,1345,9256,14,14,-1,15,0.995,1.74
2014/12/29,945,9308,63,58,-5,63,0.99,0.294
2014/12/29,1045,9323,14,35,12,23,0.99,0.513
2014/12/29,1145,9323,-1,17,13,4,0.991,1.352
2014/12/29,1245,9315,-8,29,15,14,0.994,0.915
2014/12/29,1345,9314,0,13,5,8,0.995,0.967
2014/12/30,945,9323,3,32,20,12,0.995,0.48
2014/12/30,1045,9288,-34,57,37,20,1,0.616
2014/12/30,1145,9293,5,19,11,8,0.999,1.633
2014/12/30,1245,9280,-13,30,20,10,1.001,1.707
2014/12/30,1345,9286,6,23,8,15,1.001,1.18
2014/12/31,945,9284,-2,31,19,12,1.002,0.737
2014/12/31,1045,9269,-15,36,19,17,1.003,0.952
2014/12/31,1145,9268,-1,15,8,7,1.003,1.866
2014/12/31,1245,9280,13,19,3,16,1.001,2.722
2014/12/31,1345,9283,3,19,14,5,1,0.947
2015/1/5,945,9172,-66,73,56,17,1.011,0.407
2015/1/5,1045,9217,45,55,10,45,1.005,0.783
2015/1/5,1145,9247,30,51,6,45,1.001,1.112
2015/1/5,1245,9266,19,26,7,19,0.998,1.223
2015/1/5,1345,9252,-14,28,24,4,1,1.064
2015/1/6,945,9106,-38,51,47,4,1.014,0.463
2015/1/6,1045,9081,-25,48,44,4,1.015,0.848
2015/1/6,1145,9062,-20,31,24,7,1.015,1.201
2015/1/6,1245,9039,-23,42,20,22,1.015,1.08
2015/1/6,1345,9058,20,35,12,23,1.01,0.905
2015/1/7,945,9042,0,35,26,9,1.01,0.847
2015/1/7,1045,9085,43,49,3,46,1.004,1.034
2015/1/7,1145,9073,-12,24,19,5,1.004,1.917
2015/1/7,1245,9084,11,21,8,13,1.001,2.754
2015/1/7,1345,9045,-39,43,41,2,1.003,1.337
2015/1/8,945,9227,111,95,-10,105,0.983,0.432
2015/1/8,1045,9222,-6,30,19,11,0.985,1.009
2015/1/8,1145,9235,13,24,11,13,0.985,1.774
2015/1/8,1245,9251,16,21,3,18,0.985,2.238
2015/1/8,1345,9257,6,20,1,19,0.987,1.019
2015/1/9,945,9243,-85,110,92,18,0.991,0.453
2015/1/9,1045,9238,-4,48,27,21,0.994,0.997
2015/1/9,1145,9245,8,29,9,20,0.995,1.964
2015/1/9,1245,9235,-10,33,25,8,0.998,2.203
2015/1/9,1345,9230,-5,15,8,7,1,1.775
2015/1/12,945,9188,-2,81,50,31,1.005,0.51
2015/1/12,1045,9213,25,47,12,35,1.002,1.318
2015/1/12,1145,9191,-22,44,27,17,1.004,1.467
2015/1/12,1245,9195,3,18,8,10,1.004,3.242
2015/1/12,1345,9185,-10,21,11,10,1.004,1.639
2015/1/13,945,9198,4,45,6,39,1.001,0.612
2015/1/13,1045,9263,64,85,12,73,0.994,0.484
2015/1/13,1145,9257,-7,29,17,12,0.995,1.384
2015/1/13,1245,9260,3,15,9,6,0.994,2.889
2015/1/13,1345,9249,-11,37,11,26,0.996,0.743
2015/1/14,945,9178,-57,71,69,2,1.004,0.48
2015/1/14,1045,9187,9,35,5,30,1.003,0.992
2015/1/14,1145,9157,-31,39,41,-2,1.006,1.207
2015/1/14,1245,9181,24,20,5,15,1.003,2.359
2015/1/14,1345,9171,-10,19,17,2,1.004,1.517
2015/1/15,945,9136,-51,80,94,-14,1.008,0.539
2015/1/15,1045,9179,43,56,15,41,1.002,0.895
2015/1/15,1145,9169,-10,21,15,6,1.002,2.245
2015/1/15,1245,9168,-1,19,15,4,1.002,3.099
2015/1/15,1345,9195,27,28,2,26,0.998,1.365
2015/1/16,945,9087,-88,134,142,-8,1.009,0.358
2015/1/16,1045,9113,26,45,20,25,1.005,0.827
2015/1/16,1145,9123,10,25,5,20,1.003,2.019
2015/1/16,1245,9121,-2,32,31,1,1.003,1.4
2015/1/16,1345,9115,-6,23,15,8,1.003,1.309
2015/1/19,945,9200,-11,72,60,12,0.994,0.478
2015/1/19,1045,9189,-11,30,22,8,0.996,1.336
2015/1/19,1145,9176,-13,26,24,2,0.997,2.424
2015/1/19,1245,9155,-21,39,26,13,1,1.838
2015/1/19,1345,9181,26,31,2,29,0.997,1.483
2015/1/20,945,9218,-2,50,15,35,0.993,0.583
2015/1/20,1045,9243,25,45,12,33,0.992,0.808
2015/1/20,1145,9259,17,30,6,24,0.992,1.493
2015/1/20,1245,9253,-6,25,9,16,0.994,2.142
2015/1/20,1345,9268,16,18,1,17,0.993,1.539
2015/1/21,945,9279,-3,39,34,5,0.993,0.815
2015/1/21,1045,9292,13,32,16,16,0.993,1.434
2015/1/21,1145,9290,-2,12,8,4,0.994,4.059
2015/1/21,1245,9299,9,20,11,9,0.994,2.868
2015/1/22,945,9400,40,106,0,106,0.986,0.375
2015/1/22,1045,9366,-34,43,38,5,0.991,0.905
2015/1/22,1145,9371,4,17,13,4,0.992,1.529
2015/1/22,1245,9377,6,11,5,6,0.993,2.287
2015/1/22,1345,9388,11,20,0,20,0.993,1.225
2015/1/23,945,9485,30,44,2,42,0.985,0.493
2015/1/23,1045,9469,-15,20,19,1,0.989,1.32
2015/1/23,1145,9471,1,15,7,8,0.991,2.746
2015/1/23,1245,9465,-5,16,11,5,0.993,2.547
2015/1/23,1345,9461,-4,18,17,1,0.995,1.275
2015/1/26,945,9471,23,35,-3,38,0.995,0.611
2015/1/26,1045,9455,-16,27,23,4,0.998,1.285
2015/1/26,1145,9459,2,18,6,12,0.998,1.815
2015/1/26,1245,9455,-4,9,6,3,1,4.684
2015/1/26,1345,9466,10,17,6,11,0.999,1.219
2015/1/27,945,9516,-6,27,23,4,0.995,0.504
2015/1/27,1045,9494,-21,28,14,14,0.997,0.614
2015/1/27,1145,9483,-10,23,22,1,0.999,1.415
2015/1/27,1245,9495,12,11,1,10,0.998,2.917
2015/1/27,1345,9523,28,33,4,29,0.995,0.766
2015/1/28,945,9514,36,43,4,39,0.996,0.572
2015/1/28,1045,9515,1,15,6,9,0.997,1.39
2015/1/28,1145,9531,16,24,2,22,0.996,1.324
2015/1/28,1245,9528,-3,11,6,5,0.997,1.917
2015/1/28,1345,9526,-2,18,5,13,0.998,0.983
2015/1/29,945,9458,-39,64,44,20,1.004,0.413
2015/1/29,1045,9445,-13,32,20,12,1.005,0.832
2015/1/29,1145,9440,-6,24,10,14,1.005,1.082
2015/1/29,1245,9446,6,20,14,6,1.004,1.656
2015/1/29,1345,9428,-18,32,31,1,1.006,0.749
2015/1/30,945,9407,-53,63,64,-1,1.008,0.612
2015/1/30,1045,9437,31,39,8,31,1.003,1.049
2015/1/30,1145,9428,-9,21,15,6,1.003,2.137
2015/1/30,1245,9417,-11,22,14,8,1.003,1.905
2015/1/30,1345,9400,-16,41,26,15,1.004,0.904
2015/2/2,945,9392,3,63,41,22,1.004,0.527
2015/2/2,1045,9398,5,28,10,18,1.002,1.367
2015/2/2,1145,9399,1,22,11,11,1.002,2.048
2015/2/2,1245,9400,1,15,5,10,1.001,2.785
2015/2/2,1345,9419,19,29,3,26,0.999,1.352
2015/2/3,945,9463,29,46,-10,56,0.994,0.527
2015/2/3,1045,9476,13,29,9,20,0.993,0.788
2015/2/3,1145,9478,0,13,4,9,0.993,2.406
2015/2/3,1245,9464,-14,24,15,9,0.995,1.412
2015/2/3,1345,9464,0,12,5,7,0.996,1.441
2015/2/4,945,9514,-12,43,42,1,0.992,0.419
2015/2/4,1045,9529,15,17,3,14,0.992,1.428
2015/2/4,1145,9533,5,17,10,7,0.993,1.54
2015/2/4,1245,9536,3,7,2,5,0.994,3.645
2015/2/4,1345,9521,-15,16,16,0,0.997,1.314
2015/2/5,945,9471,-50,38,42,-4,1.003,0.554
2015/2/5,1045,9486,16,18,4,14,1.001,1.041
2015/2/5,1145,9490,4,13,6,7,1.001,2.144
2015/2/5,1245,9491,1,8,2,6,1.001,3.46
2015/2/5,1345,9514,23,30,6,24,0.999,0.971
2015/2/6,945,9465,-71,68,70,-2,1.004,0.409
2015/2/6,1045,9472,5,16,5,11,1.003,1.05
2015/2/6,1145,9484,12,23,16,7,1.001,1.05
2015/2/6,1245,9475,-9,23,15,8,1.002,1.843
2015/2/6,1345,9469,-7,18,8,10,1.002,1.082
2015/2/9,945,9440,1,38,14,24,1.004,0.56
2015/2/9,1045,9442,2,15,6,9,1.003,1.67
2015/2/9,1145,9452,11,25,14,11,1.002,1.032
2015/2/9,1245,9446,-7,16,8,8,1.002,2.442
2015/2/9,1345,9450,3,12,4,8,1.001,1.532
2015/2/10,945,9455,-13,44,13,31,1,0.486
2015/2/10,1045,9441,-14,26,18,8,1.001,0.957
2015/2/10,1145,9422,-19,25,22,3,1.003,1.102
2015/2/10,1245,9433,11,14,2,12,1.001,2.356
2015/2/10,1345,9432,-1,13,7,6,1.001,1.167
2015/2/11,945,9471,9,30,16,14,0.997,0.528
2015/2/11,1045,9497,26,42,12,30,0.994,0.692
2015/2/11,1145,9501,4,10,2,8,0.995,2.89
2015/2/11,1245,9492,-8,16,12,4,0.996,1.981
2015/2/11,1345,9480,-12,25,17,8,0.998,1.136
2015/2/12,945,9469,-30,30,31,-1,0.999,0.72
2015/2/12,1045,9470,1,14,5,9,0.999,1.288
2015/2/12,1145,9476,6,8,1,7,0.999,2.537
2015/2/12,1245,9480,4,13,3,10,0.999,2.384
2015/2/12,1345,9480,0,18,11,7,1,1.015
2015/2/13,945,9532,22,43,16,27,0.995,0.426
2015/2/13,1045,9534,2,13,8,5,0.995,1.566
2015/2/13,1145,9537,2,9,3,6,0.995,2.314
2015/2/13,1245,9534,-3,12,10,2,0.996,2.009
2015/2/13,1345,9514,-19,22,21,1,0.998,0.759
2015/2/24,945,9631,49,47,4,43,0.987,0.634
2015/2/24,1045,9631,0,11,3,8,0.989,2.673
2015/2/24,1145,9635,4,11,3,8,0.99,3.16
2015/2/24,1245,9628,-7,20,12,8,0.992,2.665
2015/2/25,945,9667,-27,79,29,50,0.991,0.406
2015/2/25,1045,9675,8,11,2,9,0.992,1.304
2015/2/25,1145,9691,16,17,0,17,0.991,1.136
2015/2/25,1245,9681,-10,10,10,0,0.994,2.007
2015/2/25,1345,9684,3,16,11,5,0.995,0.98
2015/2/26,945,9648,-43,35,34,1,1.001,0.544
2015/2/26,1045,9648,1,23,8,15,1.001,0.821
2015/2/26,1145,9658,10,16,2,14,1,1.296
2015/2/26,1245,9658,-1,8,0,8,1.001,2.494
2015/2/26,1345,9649,-9,18,10,8,1.002,0.909
2015/3/2,945,9640,-18,43,43,0,1.002,0.512
2015/3/2,1045,9624,-17,31,25,6,1.004,0.737
2015/3/2,1145,9626,0,13,7,6,1.003,1.713
2015/3/2,1245,9627,1,17,13,4,1.002,1.967
2015/3/2,1345,9631,3,18,2,16,1.001,1.047
2015/3/3,945,9581,-64,73,77,-4,1.006,0.442
2015/3/3,1045,9599,17,20,7,13,1.003,1.009
2015/3/3,1145,9592,-7,14,7,7,1.004,2.374
2015/3/3,1245,9615,23,23,0,23,1.001,1.343
2015/3/3,1345,9614,-1,13,5,8,1,1.037
2015/3/4,945,9616,36,55,10,45,0.999,0.552
2015/3/4,1045,9638,22,24,-3,27,0.997,0.939
2015/3/4,1145,9625,-13,11,11,0,0.998,2.213
2015/3/4,1245,9625,0,13,5,8,0.998,2.285
2015/3/4,1345,9622,-3,12,4,8,0.998,1.366
2015/3/5,945,9593,-29,81,39,42,1.001,0.353
2015/3/5,1045,9602,10,31,13,18,1,0.883
2015/3/5,1145,9603,1,19,7,12,1,1.874
2015/3/5,1245,9603,-1,8,2,6,1,4.31
2015/3/5,1345,9589,-13,17,14,3,1.002,1.237
2015/3/6,945,9610,19,57,13,44,1,0.475
2015/3/6,1045,9601,-8,21,17,4,1.001,1.372
2015/3/6,1145,9611,10,16,5,11,0.999,2.634
2015/3/6,1245,9627,16,20,4,16,0.997,1.107
2015/3/6,1345,9638,12,19,6,13,0.996,1.122
2015/3/9,945,9559,-21,41,36,5,1.004,0.437
2015/3/9,1045,9573,14,33,9,24,1.002,0.961
2015/3/9,1145,9574,3,10,2,8,1.002,2.65
2015/3/9,1245,9572,-2,15,6,9,1.002,2.394
2015/3/9,1345,9576,5,11,1,10,1.001,1.502
2015/3/10,945,9565,-9,34,20,14,1.002,0.542
2015/3/10,1045,9517,-49,58,55,3,1.006,0.538
2015/3/10,1145,9527,9,13,3,10,1.005,1.924
2015/3/10,1245,9535,9,20,3,17,1.003,1.799
2015/3/10,1345,9528,-7,17,17,0,1.003,0.978
2015/3/11,945,9508,42,57,-1,58,1.003,0.46
2015/3/11,1045,9520,12,22,8,14,1.002,0.915
2015/3/11,1145,9521,1,17,9,8,1.001,1.798
2015/3/11,1245,9539,18,17,-1,18,0.999,2.135
2015/3/11,1345,9519,-19,29,25,4,1,1.095
2015/3/12,945,9572,43,66,2,64,0.994,0.522
2015/3/12,1045,9579,7,22,1,21,0.994,1.25
2015/3/12,1145,9595,16,19,2,17,0.993,1.387
2015/3/12,1245,9599,3,14,6,8,0.993,2.302
2015/3/12,1345,9607,8,19,2,17,0.993,1.128
2015/3/13,945,9626,10,32,8,24,0.992,0.619
2015/3/13,1045,9612,-14,26,14,12,0.995,1.163
2015/3/13,1145,9613,0,11,7,4,0.996,3.097
2015/3/13,1245,9611,-1,12,6,6,0.997,2.93
2015/3/13,1345,9598,-12,27,13,14,0.999,0.996
2015/3/16,945,9570,-15,38,24,14,1.003,0.511
2015/3/16,1045,9568,-2,34,17,17,1.003,0.935
2015/3/16,1145,9568,2,14,9,5,1.003,2.245
2015/3/16,1245,9562,-6,13,11,2,1.003,2.864
2015/3/16,1345,9546,-16,28,17,11,1.004,0.697
2015/3/17,945,9624,44,63,20,43,0.996,0.411
2015/3/17,1045,9588,-35,56,42,14,1,0.608
2015/3/17,1145,9572,-16,27,18,9,1.001,1.452
2015/3/17,1245,9566,-6,27,8,19,1.001,1.546
2015/3/17,1345,9554,-12,20,14,6,1.002,1.268
2015/3/18,945,9604,46,43,4,39,0.997,0.835
2015/3/18,1045,9622,18,21,11,10,0.995,1.119
2015/3/18,1145,9631,9,22,12,10,0.995,2.367
2015/3/18,1245,9638,6,18,11,7,0.995,3.061
2015/3/19,945,9724,-10,119,22,97,0.988,0.454
2015/3/19,1045,9764,40,45,2,43,0.985,0.828
2015/3/19,1145,9758,-5,15,11,4,0.987,1.378
2015/3/19,1245,9758,0,12,4,8,0.989,2.116
2015/3/19,1345,9766,8,16,0,16,0.99,1.129
2015/3/20,945,9759,17,31,5,26,0.992,0.733
2015/3/20,1045,9749,-10,30,21,9,0.995,1.179
2015/3/20,1145,9747,-2,12,10,2,0.997,3.016
2015/3/20,1245,9746,-2,16,12,4,0.999,2.698
2015/3/20,1345,9757,11,18,4,14,0.999,1.322
2015/3/23,945,9742,-19,43,27,16,1,0.493
2015/3/23,1045,9758,16,25,10,15,0.999,0.931
2015/3/23,1145,9767,8,14,-1,15,0.998,1.848
2015/3/23,1245,9759,-8,11,8,3,0.999,2.395
2015/3/23,1345,9749,-9,14,10,4,1,1.092
2015/3/24,945,9716,-12,26,39,-13,1.003,0.555
2015/3/24,1045,9722,6,24,3,21,1.002,0.641
2015/3/24,1145,9706,-16,25,15,10,1.003,1.078
2015/3/24,1245,9711,5,11,4,7,1.003,1.949
2015/3/24,1345,9721,9,18,3,15,1.001,1.177
2015/3/25,945,9711,-10,35,20,15,1.002,0.509
2015/3/25,1045,9679,-33,35,34,1,1.005,0.604
2015/3/25,1145,9681,2,12,8,4,1.004,1.559
2015/3/25,1245,9678,-2,10,5,5,1.003,1.961
2015/3/25,1345,9689,11,14,2,12,1.001,1.14
2015/3/26,945,9590,10,42,19,23,1.01,0.502
2015/3/26,1045,9626,37,44,9,35,1.005,0.879
2015/3/26,1145,9597,-31,29,32,-3,1.007,1.309
2015/3/26,1245,9602,4,17,12,5,1.005,2.234
2015/3/26,1345,9609,7,23,4,19,1.003,1.016
2015/3/27,945,9601,-8,31,26,5,1.003,0.708
2015/3/27,1045,9539,-62,59,67,-8,1.008,0.559
2015/3/27,1145,9560,21,26,3,23,1.005,1.291
2015/3/27,1245,9547,-14,23,16,7,1.005,1.731
2015/3/27,1345,9541,-5,22,6,16,1.004,0.725
2015/3/30,945,9545,34,41,17,24,1.003,0.686
2015/3/30,1045,9536,-9,38,19,19,1.003,1.124
2015/3/30,1145,9542,7,21,14,7,1.002,1.788
2015/3/30,1245,9541,-1,15,9,6,1.001,3.097
2015/3/30,1345,9552,11,17,0,17,1,1.851
2015/3/31,945,9580,-20,37,30,7,0.997,0.697
2015/3/31,1045,9557,-24,38,32,6,0.999,0.924
2015/3/31,1145,9557,-1,18,6,12,0.999,1.498
2015/3/31,1245,9574,16,24,9,15,0.997,1.331
2015/3/31,1345,9582,7,24,12,12,0.997,0.933
2015/4/1,945,9520,-20,57,32,25,1.003,0.416
2015/4/1,1045,9509,-11,16,14,2,1.004,1.263
2015/4/1,1145,9500,-9,27,14,13,1.005,1.055
2015/4/1,1245,9522,22,25,-5,30,1.002,1.811
2015/4/1,1345,9507,-16,17,16,1,1.004,1.114
2015/4/2,945,9622,84,86,5,81,0.991,0.403
2015/4/2,1045,9621,0,20,9,11,0.992,1.259
2015/4/2,1145,9612,-9,15,11,4,0.993,2.38
2015/4/2,1245,9614,3,15,3,12,0.993,2.403
2015/4/2,1345,9613,-1,12,8,4,0.994,1.399
2015/4/7,945,9626,-27,41,30,11,0.994,0.706
2015/4/7,1045,9636,10,23,10,13,0.994,1.631
2015/4/7,1145,9620,-16,30,22,8,0.997,1.553
2015/4/7,1245,9627,9,12,1,11,0.997,2.818
2015/4/7,1345,9629,2,11,6,5,0.998,1.649
2015/4/8,945,9570,-63,64,63,1,1.005,0.395
2015/4/8,1045,9578,8,20,6,14,1.004,1.083
2015/4/8,1145,9577,-1,10,3,7,1.004,2.201
2015/4/8,1245,9569,-8,18,7,11,1.004,1.353
2015/4/8,1345,9570,0,14,12,2,1.004,1.048
2015/4/9,945,9662,83,91,-7,98,0.993,0.345
2015/4/9,1045,9626,-35,58,50,8,0.997,0.699
2015/4/9,1145,9605,-21,29,28,1,0.999,1.019
2015/4/9,1245,9577,-29,38,35,3,1.002,1.172
2015/4/9,1345,9572,-5,27,23,4,1.002,1.18
2015/4/10,945,9609,-19,55,56,-1,0.998,0.514
2015/4/10,1045,9602,-6,39,32,7,0.999,1.153
2015/4/10,1145,9633,31,37,-4,41,0.996,1.485
2015/4/10,1245,9619,-14,22,16,6,0.998,2.048
2015/4/10,1345,9631,13,21,4,17,0.998,1.693
2015/4/13,945,9647,-26,36,26,10,0.997,0.795
2015/4/13,1045,9647,-1,20,6,14,0.997,1.563
2015/4/13,1145,9652,6,19,11,8,0.997,1.674
2015/4/13,1245,9657,5,14,5,9,0.997,2.974
2015/4/13,1345,9658,2,10,7,3,0.997,1.384
2015/4/14,945,9646,5,43,23,20,0.999,0.531
2015/4/14,1045,9649,2,14,4,10,0.999,1.643
2015/4/14,1145,9653,5,13,6,7,0.999,2.242
2015/4/14,1245,9661,8,18,11,7,0.998,1.416
2015/4/14,1345,9645,-16,20,18,2,1,1.244
2015/4/15,945,9561,-65,88,93,-5,1.009,0.45
2015/4/15,1045,9571,11,29,8,21,1.007,1.071
2015/4/15,1145,9565,-6,24,6,18,1.006,1.797
2015/4/15,1245,9567,2,20,7,13,1.005,2.653
2015/4/16,945,9615,54,103,-5,108,0.999,0.29
2015/4/16,1045,9615,1,20,10,10,0.999,0.867
2015/4/16,1145,9622,7,9,2,7,0.998,1.775
2015/4/16,1245,9614,-8,19,19,0,0.999,1.606
2015/4/16,1345,9647,33,37,2,35,0.995,0.97
2015/4/17,945,9577,-42,51,52,-1,1.002,0.541
2015/4/17,1045,9582,5,21,12,9,1.001,1.282
2015/4/17,1145,9571,-11,13,13,0,1.002,2.255
2015/4/17,1245,9580,9,16,10,6,1.001,2.313
2015/4/17,1345,9584,5,21,7,14,1.001,1.328
2015/4/20,945,9518,-12,71,59,12,1.007,0.416
2015/4/20,1045,9530,11,29,14,15,1.005,1.277
2015/4/20,1145,9567,37,39,7,32,1,1.133
2015/4/20,1245,9572,5,23,11,12,0.999,1.558
2015/4/20,1345,9561,-11,16,12,4,1,1.427
2015/4/21,945,9562,-23,47,51,-4,0.999,0.501
2015/4/21,1045,9552,-10,23,23,0,1,1.175
2015/4/21,1145,9548,-4,29,16,13,1,1.12
2015/4/21,1245,9553,5,13,6,7,1,2.426
2015/4/21,1345,9556,2,13,0,13,0.999,1.634
2015/4/22,945,9574,13,42,29,13,0.998,0.486
2015/4/22,1045,9630,54,57,5,52,0.992,0.54
2015/4/22,1145,9625,-5,11,7,4,0.994,2.138
2015/4/22,1245,9627,1,19,2,17,0.994,1.644
2015/4/22,1345,9613,-14,24,23,1,0.996,1.027
2015/4/23,945,9767,111,104,-11,115,0.981,0.394
2015/4/23,1045,9757,-8,28,8,20,0.984,1.165
2015/4/23,1145,9784,28,38,2,36,0.984,1.462
2015/4/23,1245,9837,53,69,14,55,0.981,0.815
2015/4/23,1345,9838,0,42,16,26,0.984,0.929
2015/4/24,945,9961,81,135,39,96,0.975,0.412
2015/4/24,1045,9901,-59,102,76,26,0.984,0.743
2015/4/24,1145,9907,5,28,11,17,0.987,1.762
2015/4/24,1245,9926,18,22,4,18,0.988,2.394
2015/4/24,1345,9920,-5,39,33,6,0.991,1.338
2015/4/27,945,9980,22,56,23,33,0.988,0.714
2015/4/27,1045,10003,22,47,28,19,0.988,0.93
2015/4/27,1145,10017,15,31,10,21,0.989,2.035
2015/4/27,1245,10012,-5,21,11,10,0.992,2.793
2015/4/27,1345,10019,7,19,3,16,0.993,1.64
2015/4/28,945,9994,-28,56,39,17,0.997,0.708
2015/4/28,1045,9979,-15,32,16,16,0.999,1.395
2015/4/28,1145,9990,11,19,7,12,0.998,2.123
2015/4/28,1245,9986,-4,15,13,2,1,2.665
2015/4/28,1345,9990,4,20,2,18,1,1.423
2015/4/29,945,9970,-8,68,52,16,1.002,0.417
2015/4/29,1045,9885,-85,100,97,3,1.011,0.553
2015/4/29,1145,9920,35,34,12,22,1.006,1.154
2015/4/29,1245,9922,3,23,10,13,1.005,2.447
2015/4/29,1345,9909,-12,33,12,21,1.005,1.06
2015/4/30,945,9895,-7,46,35,11,1.005,0.669
2015/4/30,1045,9890,-5,31,-1,32,1.005,1.026
2015/4/30,1145,9894,3,27,22,5,1.004,1.348
2015/4/30,1245,9898,3,22,3,19,1.002,2.155
2015/4/30,1345,9874,-24,37,28,9,1.004,1.347
2015/5/4,945,9834,-63,75,77,-2,1.007,0.687
2015/5/4,1045,9871,37,68,21,47,1.002,0.86
2015/5/4,1145,9872,1,25,14,11,1.002,2.043
2015/5/4,1245,9882,10,23,14,9,1,1.996
2015/5/4,1345,9886,3,25,16,9,0.999,1.41
2015/5/5,945,9852,-14,64,26,38,1.002,0.512
2015/5/5,1045,9850,-2,26,8,18,1.002,1.626
2015/5/5,1145,9833,-17,35,19,16,1.003,1.242
2015/5/5,1245,9840,7,20,6,14,1.002,2.722
2015/5/5,1345,9849,8,18,2,16,1.001,1.614
2015/5/6,945,9798,-4,50,15,35,1.005,0.462
2015/5/6,1045,9846,50,57,0,57,1,0.794
2015/5/6,1145,9847,2,27,18,9,0.999,1.228
2015/5/6,1245,9844,-4,13,10,3,0.999,3.08
2015/5/6,1345,9847,4,14,10,4,0.999,1.524
2015/5/7,945,9753,-33,61,55,6,1.007,0.389
2015/5/7,1045,9760,7,25,19,6,1.006,0.971
2015/5/7,1145,9765,4,13,2,11,1.004,1.661
2015/5/7,1245,9755,-10,20,10,10,1.005,2.029
2015/5/7,1345,9753,-2,13,5,8,1.004,1.24
2015/5/8,945,9761,-8,40,22,18,1.003,0.65
2015/5/8,1045,9756,-5,23,8,15,1.003,1.122
2015/5/8,1145,9755,-1,11,4,7,1.002,2.482
2015/5/8,1245,9752,-3,10,3,7,1.001,3.36
2015/5/8,1345,9721,-31,39,31,8,1.004,0.99
2015/5/11,945,9730,-70,81,84,-3,1.003,0.476
2015/5/11,1045,9697,-32,55,55,0,1.006,0.66
2015/5/11,1145,9678,-19,47,26,21,1.007,0.797
2015/5/11,1245,9716,39,55,13,42,1.002,0.973
2015/5/11,1345,9723,7,27,9,18,1.001,1.156
2015/5/12,945,9680,-27,73,68,5,1.005,0.539
2015/5/12,1045,9711,31,44,6,38,1.001,0.973
2015/5/12,1145,9699,-12,23,18,5,1.002,2.837
2015/5/12,1245,9699,-1,13,1,12,1.001,3.328
2015/5/12,1345,9706,7,14,1,13,1,1.606
2015/5/13,945,9741,29,59,15,44,0.996,0.547
2015/5/13,1045,9735,-5,55,41,14,0.996,0.701
2015/5/13,1145,9746,11,18,4,14,0.996,2.628
2015/5/13,1245,9744,-2,16,7,9,0.996,2.628
2015/5/13,1345,9739,-4,14,11,3,0.997,2.007
2015/5/14,945,9645,-92,96,92,4,1.007,0.412
2015/5/14,1045,9650,5,22,14,8,1.006,1.192
2015/5/14,1145,9618,-33,33,31,2,1.009,1.116
2015/5/14,1245,9609,-9,22,12,10,1.009,1.35
2015/5/14,1345,9604,-5,25,20,5,1.009,1.106
2015/5/15,945,9613,-22,46,29,17,1.007,0.617
2015/5/15,1045,9571,-43,55,45,10,1.01,0.785
2015/5/15,1145,9600,28,62,3,59,1.005,0.962
2015/5/15,1245,9579,-22,30,26,4,1.006,1.669
2015/5/15,1345,9575,-6,17,9,8,1.005,1.775
2015/5/18,945,9556,-56,55,51,4,1.006,0.718
2015/5/18,1045,9574,18,27,11,16,1.003,1.635
2015/5/18,1145,9586,12,34,19,15,1.001,1.618
2015/5/18,1245,9583,-3,19,16,3,1.001,2.85
2015/5/18,1345,9598,16,29,4,25,0.999,1.49
2015/5/19,945,9707,91,106,1,105,0.987,0.382
2015/5/19,1045,9702,-3,34,21,13,0.989,1.058
2015/5/19,1145,9706,4,17,9,8,0.99,2.29
2015/5/19,1245,9707,0,17,7,10,0.991,2.706
2015/5/19,1345,9702,-6,18,12,6,0.993,1.317
2015/5/20,945,9679,-25,49,38,11,0.996,0.67
2015/5/20,1045,9691,13,33,10,23,0.996,1.627
2015/5/20,1145,9703,14,35,22,13,0.996,1.597
2015/5/20,1245,9688,-15,26,19,7,0.999,2.776
2015/5/21,945,9535,-110,180,157,23,1.015,0.314
2015/5/21,1045,9560,25,28,-1,29,1.012,0.919
2015/5/21,1145,9547,-12,21,12,9,1.012,1.468
2015/5/21,1245,9547,0,17,10,7,1.01,2.402
2015/5/21,1345,9541,-6,12,8,4,1.009,1.546
2015/5/22,945,9612,50,83,17,66,1,0.51
2015/5/22,1045,9642,30,44,5,39,0.996,0.937
2015/5/22,1145,9637,-5,18,12,6,0.996,2.25
2015/5/22,1245,9631,-7,12,9,3,0.996,3.258
2015/5/22,1345,9625,-7,21,10,11,0.996,1.307
2015/5/25,945,9578,-25,62,34,28,1.001,0.516
2015/5/25,1045,9632,54,54,8,46,0.995,0.747
2015/5/25,1145,9628,-4,17,5,12,0.997,2.721
2015/5/25,1245,9627,-1,8,3,5,0.997,6.438
2015/5/25,1345,9630,3,25,7,18,0.998,1.499
2015/5/26,945,9667,54,115,58,57,0.995,0.349
2015/5/26,1045,9646,-20,36,27,9,0.997,1.005
2015/5/26,1145,9660,14,39,11,28,0.996,1.375
2015/5/26,1245,9661,1,14,7,7,0.996,3.378
2015/5/26,1345,9659,-2,8,5,3,0.997,2.378
2015/5/27,945,9644,37,64,36,28,0.998,0.468
2015/5/27,1045,9690,45,49,-2,51,0.994,0.927
2015/5/27,1145,9683,-7,15,10,5,0.996,2.041
2015/5/27,1245,9696,13,19,2,17,0.995,2.114
2015/5/27,1345,9661,-35,37,34,3,0.999,1.122
2015/5/28,945,9691,-20,63,59,4,0.997,0.402
2015/5/28,1045,9723,32,38,5,33,0.994,1.067
2015/5/28,1145,9714,-9,16,12,4,0.996,2.421
2015/5/28,1245,9723,8,13,3,10,0.995,3.567
2015/5/28,1345,9731,7,20,0,20,0.995,0.99
2015/5/29,945,9702,-39,60,63,-3,0.999,0.493
2015/5/29,1045,9708,5,30,10,20,0.999,0.954
2015/5/29,1145,9704,-3,16,11,5,1,2.915
2015/5/29,1245,9703,-1,10,8,2,1,4.066
2015/5/29,1345,9703,1,33,25,8,1,0.901
2015/6/1,945,9605,-63,107,108,-1,1.01,0.368
2015/6/1,1045,9619,12,26,13,13,1.008,1.034
2015/6/1,1145,9627,9,19,11,8,1.006,1.984
2015/6/1,1245,9642,15,22,6,16,1.003,2.604
2015/6/1,1345,9630,-12,17,10,7,1.004,1.548
2015/6/2,945,9635,49,68,-2,70,1.002,0.392
2015/6/2,1045,9615,-20,20,20,0,1.003,1.54
2015/6/2,1145,9610,-4,14,9,5,1.003,2.388
2015/6/2,1245,9612,2,11,8,3,1.001,4.033
2015/6/2,1345,9607,-5,13,8,5,1.001,1.891
2015/6/3,945,9584,-56,64,58,6,1.003,0.435
2015/6/3,1045,9582,-2,29,12,17,1.003,0.851
2015/6/3,1145,9578,-4,15,7,8,1.003,2.095
2015/6/3,1245,9552,-26,32,26,6,1.005,1.033
2015/6/3,1345,9547,-4,17,5,12,1.005,0.946
2015/6/4,945,9526,-5,46,27,19,1.007,0.444
2015/6/4,1045,9496,-30,37,42,-5,1.009,0.991
2015/6/4,1145,9315,-181,175,184,-9,1.027,0.428
2015/6/4,1245,9351,36,46,22,24,1.02,0.989
2015/6/4,1345,9310,-42,59,50,9,1.022,0.98
2015/6/5,945,9277,-47,77,70,7,1.022,0.612
2015/6/5,1045,9308,31,53,14,39,1.015,1.337
2015/6/5,1145,9299,-9,31,15,16,1.013,2.635
2015/6/5,1245,9286,-13,25,14,11,1.012,2.291
2015/6/5,1345,9308,22,38,16,22,1.006,1.741
2015/6/8,945,9275,-37,77,37,40,1.008,0.761
2015/6/8,1045,9311,37,71,17,54,1.001,1.391
2015/6/8,1145,9345,33,51,4,47,0.995,1.326
2015/6/8,1245,9381,35,68,23,45,0.992,0.882
2015/6/8,1345,9348,-33,42,34,8,0.996,1.383
2015/6/9,945,9310,7,70,36,34,0.999,0.537
2015/6/9,1045,9272,-37,57,43,14,1.004,0.985
2015/6/9,1145,9238,-34,69,41,28,1.007,0.905
2015/6/9,1245,9228,-10,32,21,11,1.008,2.099
2015/6/9,1345,9237,9,34,-2,36,1.006,0.967
2015/6/10,945,9287,31,55,20,35,1,0.602
2015/6/10,1045,9296,10,52,32,20,0.999,0.873
2015/6/10,1145,9303,6,23,12,11,0.998,1.82
2015/6/10,1245,9301,-2,27,12,15,0.998,2.288
2015/6/10,1345,9284,-16,19,16,3,0.999,2.057
2015/6/11,945,9235,-93,83,88,-5,1.005,0.579
2015/6/11,1045,9287,51,75,12,63,0.998,0.876
2015/6/11,1145,9273,-14,30,24,6,1,1.634
2015/6/11,1245,9274,1,32,12,20,1,2.075
2015/6/11,1345,9288,15,17,-1,18,0.999,1.943
2015/6/12,945,9291,19,73,12,61,0.999,0.509
2015/6/12,1045,9264,-27,62,50,12,1.002,0.801
2015/6/12,1145,9259,-6,23,20,3,1.002,2.049
2015/6/12,1245,9270,11,15,3,12,1,3.475
2015/6/12,1345,9267,-2,11,6,5,1,2.713
2015/6/15,945,9273,1,78,45,33,0.999,0.437
2015/6/15,1045,9271,-2,28,14,14,1,1.409
2015/6/15,1145,9240,-30,41,34,7,1.003,1.491
2015/6/15,1245,9237,-3,22,5,17,1.003,1.69
2015/6/15,1345,9244,8,21,14,7,1.002,1.652
2015/6/16,945,9179,-65,86,79,7,1.009,0.423
2015/6/16,1045,9175,-4,24,13,11,1.008,0.955
2015/6/16,1145,9185,11,23,11,12,1.006,1.561
2015/6/16,1245,9180,-5,19,12,7,1.005,2.004
2015/6/16,1345,9215,34,43,3,40,1.001,1.332
2015/6/17,945,9193,-22,46,31,15,1.002,0.847
2015/6/17,1045,9199,6,25,21,4,1.001,2.206
2015/6/17,1145,9234,36,38,3,35,0.996,1.788
2015/6/17,1245,9217,-16,26,16,10,0.998,2.407
2015/6/18,945,9026,-18,194,194,0,1.017,0.362
2015/6/18,1045,9028,2,34,26,8,1.014,0.917
2015/6/18,1145,9041,12,19,6,13,1.011,1.941
2015/6/18,1245,9046,6,23,14,9,1.009,1.466
2015/6/18,1345,9049,2,16,9,7,1.007,1.36
2015/6/22,945,9193,85,93,5,88,0.991,0.417
2015/6/22,1045,9183,-10,19,7,12,0.992,1.604
2015/6/22,1145,9192,10,25,8,17,0.991,1.727
2015/6/22,1245,9201,9,15,2,13,0.99,3.095
2015/6/22,1345,9182,-19,29,19,10,0.991,1.075
2015/6/23,945,9247,26,38,9,29,0.986,0.48
2015/6/23,1045,9255,8,19,13,6,0.988,1.041
2015/6/23,1145,9224,-31,49,33,16,0.993,0.779
2015/6/23,1245,9226,1,12,7,5,0.995,2.843
2015/6/23,1345,9231,5,9,2,7,0.997,1.999
2015/6/24,945,9237,22,45,1,44,0.997,0.465
2015/6/24,1045,9225,-11,21,10,11,0.999,1.55
2015/6/24,1145,9223,-2,9,4,5,1,3.744
2015/6/24,1245,9226,4,11,0,11,1,3.551
2015/6/24,1345,9247,21,22,-1,23,0.998,1.42
2015/6/25,945,9354,86,103,16,87,0.987,0.326
2015/6/25,1045,9321,-33,62,37,25,0.991,0.67
2015/6/25,1145,9327,6,21,9,12,0.991,2.118
2015/6/25,1245,9336,8,24,15,9,0.992,1.39
2015/6/25,1345,9340,5,16,8,8,0.992,1.385
2015/6/26,945,9316,-32,33,17,16,0.996,0.627
2015/6/26,1045,9313,-3,25,22,3,0.997,1.458
2015/6/26,1145,9317,4,12,6,6,0.998,3.071
2015/6/26,1245,9328,11,22,10,12,0.998,2.252
2015/6/26,1345,9321,-7,12,13,-1,1,2.161
2015/6/29,945,9195,0,53,27,26,1.013,0.423
2015/6/29,1045,9172,-25,32,33,-1,1.013,1.213
2015/6/29,1145,9131,-41,65,48,17,1.016,0.639
2015/6/29,1245,9133,2,21,3,18,1.014,2.01
2015/6/29,1345,9138,5,36,7,29,1.011,0.8
2015/6/30,945,9143,-3,39,20,19,1.008,0.556
2015/6/30,1045,9156,13,21,3,18,1.005,1.571
2015/6/30,1145,9192,36,30,8,22,0.999,0.924
2015/6/30,1245,9187,-5,13,8,5,0.999,2.838
2015/6/30,1345,9212,25,34,5,29,0.994,0.979
2015/7/1,945,9277,92,90,4,86,0.987,0.465
2015/7/1,1045,9299,22,45,12,33,0.986,0.905
2015/7/1,1145,9301,2,25,16,9,0.987,1.331
2015/7/1,1245,9311,10,19,8,11,0.988,2.875
2015/7/1,1345,9294,-17,34,23,11,0.992,0.947
2015/7/2,945,9275,-25,65,50,15,0.995,0.562
2015/7/2,1045,9288,13,30,15,15,0.995,1.262
2015/7/2,1145,9294,6,21,12,9,0.996,1.988
2015/7/2,1245,9294,0,16,6,10,0.997,2.012
2015/7/2,1345,9277,-17,21,22,-1,1,2.266
2015/7/3,945,9184,-74,99,91,8,1.011,0.429
2015/7/3,1045,9198,15,39,12,27,1.008,0.943
2015/7/3,1145,9266,68,90,18,72,1,0.837
2015/7/3,1245,9276,9,32,11,21,0.999,1.604
2015/7/3,1345,9304,28,40,-1,41,0.995,1.152
2015/7/6,945,9259,24,84,38,46,0.999,0.564
2015/7/6,1045,9215,-44,50,58,-8,1.004,0.965
2015/7/6,1145,9216,0,50,19,31,1.003,0.981
2015/7/6,1245,9201,-15,22,23,-1,1.004,2.469
2015/7/6,1345,9197,-3,28,13,15,1.003,1.246
2015/7/7,945,9260,0,60,43,17,0.996,0.48
2015/7/7,1045,9270,11,36,18,18,0.996,1.402
2015/7/7,1145,9226,-44,68,52,16,1.002,0.786
2015/7/7,1245,9233,7,32,10,22,1,1.926
2015/7/7,1345,9242,9,26,2,24,0.999,1.582
2015/7/8,945,9028,-177,199,182,17,1.022,0.372
2015/7/8,1045,9006,-23,59,51,8,1.022,0.876
2015/7/8,1145,8950,-56,62,65,-3,1.026,0.992
2015/7/8,1245,8944,-6,53,21,32,1.024,0.911
2015/7/8,1345,8943,-1,39,27,12,1.021,1.107
2015/7/9,945,8779,-22,131,76,55,1.035,0.474
2015/7/9,1045,8838,59,156,101,55,1.023,0.674
2015/7/9,1145,8875,37,42,10,32,1.014,2.039
2015/7/9,1245,8868,-8,33,9,24,1.011,2.757
2015/7/9,1345,8873,6,41,28,13,1.006,1.81
2015/7/13,945,8945,10,58,26,32,0.995,0.694
2015/7/13,1045,8950,5,58,10,48,0.993,1.124
2015/7/13,1145,8978,27,47,15,32,0.99,1.474
2015/7/13,1245,8995,16,31,10,21,0.988,2.662
2015/7/13,1345,8994,-1,15,6,9,0.989,2.116
2015/7/14,945,9059,19,69,25,44,0.984,0.601
2015/7/14,1045,9035,-23,57,25,32,0.99,1.026
2015/7/14,1145,9031,-5,35,20,15,0.993,1.818
2015/7/14,1245,9026,-4,25,11,14,0.995,2.66
2015/7/14,1345,8984,-42,45,43,2,1.001,1.516
2015/7/15,945,9049,9,52,29,23,0.995,0.756
2015/7/15,1045,9026,-23,39,21,18,0.999,1.257
2015/7/15,1145,9012,-14,35,12,23,1.001,1.375
2015/7/15,1245,9022,9,40,15,25,1.001,2.578
2015/7/16,945,8936,1,142,115,27,1.009,0.376
2015/7/16,1045,8908,-27,45,37,8,1.011,0.963
2015/7/16,1145,8927,19,38,18,20,1.008,1.227
2015/7/16,1245,8919,-8,20,10,10,1.007,1.792
2015/7/16,1345,8918,0,26,11,15,1.006,1.172
2015/7/17,945,8892,-14,58,37,21,1.008,0.522
2015/7/17,1045,8925,33,55,10,45,1.002,1.042
2015/7/17,1145,8899,-25,29,27,2,1.004,1.986
2015/7/17,1245,8900,1,16,6,10,1.002,2.962
2015/7/17,1345,8912,12,16,4,12,1,2.054
2015/7/20,945,8958,-12,77,69,8,0.995,0.477
2015/7/20,1045,8924,-34,51,50,1,0.999,1.015
2015/7/20,1145,8833,-90,120,91,29,1.01,0.611
2015/7/20,1245,8858,25,40,7,33,1.006,1.39
2015/7/20,1345,8851,-6,27,20,7,1.006,1.301
2015/7/21,945,8853,-34,82,44,38,1.005,0.521
2015/7/21,1045,8881,27,61,29,32,1.002,0.878
2015/7/21,1145,8879,-1,20,16,4,1.001,2.475
2015/7/21,1245,8877,-2,31,5,26,1.001,1.913
2015/7/21,1345,8936,59,66,3,63,0.995,1.261
2015/7/22,945,8851,-31,35,25,10,1.003,0.606
2015/7/22,1045,8828,-23,63,30,33,1.005,0.736
2015/7/22,1145,8815,-13,37,34,3,1.005,1.305
2015/7/22,1245,8815,0,17,7,10,1.005,2.334
2015/7/22,1345,8815,0,26,11,15,1.004,1.305
2015/7/23,945,8764,-14,71,58,13,1.009,0.52
2015/7/23,1045,8727,-37,52,61,-9,1.012,1.022
2015/7/23,1145,8691,-36,50,43,7,1.015,0.901
2015/7/23,1245,8747,57,83,6,77,1.006,0.851
2015/7/23,1345,8755,7,29,1,28,1.003,1.275
2015/7/24,945,8699,-21,59,41,18,1.008,0.692
2015/7/24,1045,8668,-31,43,28,15,1.01,0.989
2015/7/24,1145,8693,25,44,15,29,1.005,1.629
2015/7/24,1245,8691,-3,27,8,19,1.004,2.581
2015/7/24,1345,8684,-7,20,12,8,1.003,1.974
2015/7/27,945,8646,9,68,19,49,1.006,0.599
2015/7/27,1045,8620,-26,47,43,4,1.008,1.411
2015/7/27,1145,8568,-53,73,60,13,1.013,0.833
2015/7/27,1245,8509,-58,81,65,16,1.018,0.812
2015/7/27,1345,8522,12,29,14,15,1.014,1.129
2015/7/28,945,8524,24,61,17,44,1.011,0.537
2015/7/28,1045,8585,60,100,0,100,1.002,0.699
2015/7/28,1145,8557,-28,41,34,7,1.004,1.476
2015/7/28,1245,8564,7,25,13,12,1.002,3.139
2015/7/28,1345,8541,-24,35,28,7,1.003,1.706
2015/7/29,945,8461,-72,108,87,21,1.011,0.544
2015/7/29,1045,8456,-5,46,36,10,1.01,1.076
2015/7/29,1145,8508,50,74,10,64,1.002,1.078
2015/7/29,1245,8525,17,49,10,39,0.999,1.254
2015/7/29,1345,8484,-41,46,45,1,1.004,1.501
2015/7/30,945,8615,95,98,-8,106,0.989,0.544
2015/7/30,1045,8616,1,32,16,16,0.99,1.136
2015/7/30,1145,8573,-42,64,47,17,0.995,1.143
2015/7/30,1245,8592,19,33,8,25,0.993,2.32
2015/7/30,1345,8610,19,32,0,32,0.991,1.43
2015/7/31,945,8524,-69,85,82,3,1.002,0.633
2015/7/31,1045,8561,35,51,6,45,0.998,1.062
2015/7/31,1145,8535,-25,43,32,11,1.003,1.614
2015/7/31,1245,8537,3,39,10,29,1.003,1.701
2015/7/31,1345,8570,33,66,20,46,0.999,1.1
2015/8/3,945,8433,-113,146,113,33,1.016,0.464
2015/8/3,1045,8432,-1,40,26,14,1.014,1.02
2015/8/3,1145,8456,24,47,10,37,1.009,1.568
2015/8/3,1245,8454,-2,30,6,24,1.007,2.054
2015/8/3,1345,8452,-3,25,12,13,1.006,1.471
2015/8/4,945,8534,47,81,18,63,0.995,0.476
2015/8/4,1045,8474,-60,59,52,7,1.002,0.92
2015/8/4,1145,8460,-14,41,21,20,1.003,1.254
2015/8/4,1245,8434,-26,38,26,12,1.005,1.3
2015/8/4,1345,8465,31,61,12,49,1,0.985
2015/8/5,945,8478,-26,70,40,30,0.998,0.564
2015/8/5,1045,8515,38,92,32,60,0.994,0.738
2015/8/5,1145,8514,-1,28,20,8,0.995,1.858
2015/8/5,1245,8519,6,28,21,7,0.996,2.08
2015/8/5,1345,8523,3,29,20,9,0.996,1.483
2015/8/6,945,8466,-75,121,113,8,1.003,0.544
2015/8/6,1045,8469,5,52,15,37,1.002,0.883
2015/8/6,1145,8395,-74,99,70,29,1.011,0.868
2015/8/6,1245,8400,6,47,15,32,1.009,1.559
2015/8/6,1345,8390,-9,46,40,6,1.01,1.18
2015/8/7,945,8382,22,83,13,70,1.009,0.549
2015/8/7,1045,8386,4,66,35,31,1.008,0.855
2015/8/7,1145,8416,30,33,-8,41,1.003,2.022
2015/8/7,1245,8386,-30,52,37,15,1.005,1.889
2015/8/7,1345,8389,2,17,9,8,1.003,2.541
2015/8/10,945,8384,-21,75,36,39,1.002,0.632
2015/8/10,1045,8376,-9,55,31,24,1.002,1.104
2015/8/10,1145,8438,62,70,2,68,0.994,1.068
2015/8/10,1245,8443,5,31,13,18,0.994,1.772
2015/8/10,1345,8445,2,29,16,13,0.994,1.522
2015/8/11,945,8516,11,58,40,18,0.987,0.505
2015/8/11,1045,8442,-74,87,86,1,0.998,0.665
2015/8/11,1145,8417,-25,53,34,19,1.001,1.015
2015/8/11,1245,8383,-33,61,36,25,1.005,1.112
2015/8/11,1345,8360,-23,33,36,-3,1.008,1.286
2015/8/12,945,8300,-65,102,90,12,1.015,0.482
2015/8/12,1045,8286,-13,63,52,11,1.015,0.922
2015/8/12,1145,8278,-8,34,28,6,1.015,1.765
2015/8/12,1245,8269,-8,40,14,26,1.015,1.514
2015/8/12,1345,8299,31,54,17,37,1.009,1.308
2015/8/13,945,8314,-34,60,49,11,1.005,0.716
2015/8/13,1045,8317,3,56,14,42,1.002,0.942
2015/8/13,1145,8307,-10,55,27,28,1.002,1.417
2015/8/13,1245,8321,14,40,23,17,0.999,1.533
2015/8/13,1345,8306,-16,24,22,2,1,2.048
2015/8/14,945,8284,22,63,50,13,1.001,0.633
2015/8/14,1045,8300,16,41,20,21,0.999,1.359
2015/8/14,1145,8307,6,24,8,16,0.999,2.234
2015/8/14,1245,8311,5,26,18,8,0.999,2.336
2015/8/14,1345,8325,13,20,3,17,0.997,2.198
2015/8/17,945,8256,-65,87,54,33,1.005,0.51
2015/8/17,1045,8248,-8,32,12,20,1.006,1.063
2015/8/17,1145,8246,-2,26,17,9,1.005,1.623
2015/8/17,1245,8244,-3,20,10,10,1.005,2.043
2015/8/17,1345,8238,-7,17,11,6,1.004,1.239
2015/8/18,945,8251,10,42,25,17,1.003,0.581
2015/8/18,1045,8214,-37,56,47,9,1.007,0.764
2015/8/18,1145,8190,-24,39,26,13,1.009,0.986
2015/8/18,1245,8179,-11,33,15,18,1.008,1.292
2015/8/18,1345,8171,-8,22,20,2,1.008,1.474
2015/8/19,945,8109,-69,82,70,12,1.014,0.653
2015/8/19,1045,8042,-66,91,77,14,1.02,0.805
2015/8/19,1145,8035,-8,22,17,5,1.019,2.022
2015/8/19,1245,8019,-16,36,21,15,1.018,1.7
2015/8/20,945,7964,15,120,76,44,1.021,0.353
2015/8/20,1045,7939,-25,91,50,41,1.021,0.644
2015/8/20,1145,7976,37,88,42,46,1.013,0.837
2015/8/20,1245,7996,19,38,10,28,1.007,1.649
2015/8/20,1345,7976,-20,31,23,8,1.007,1.777
2015/8/21,945,7851,-7,74,36,38,1.019,0.591
2015/8/21,1045,7788,-63,60,65,-5,1.023,1.009
2015/8/21,1145,7777,-12,37,16,21,1.02,1.104
2015/8/21,1245,7769,-9,32,18,14,1.018,1.876
2015/8/21,1345,7746,-23,42,36,6,1.018,1.433
2015/8/24,945,7509,-100,178,167,11,1.045,0.469
2015/8/24,1045,7185,-323,507,332,175,1.086,0.363
2015/8/24,1145,7324,140,232,73,159,1.055,0.779
2015/8/24,1245,7371,48,85,29,56,1.04,1.145
2015/8/24,1345,7340,-32,196,135,61,1.035,0.838
2015/8/25,945,7416,16,129,31,98,1.019,0.723
2015/8/25,1045,7545,127,205,61,144,0.996,0.844
2015/8/25,1145,7567,22,76,12,64,0.989,1.832
2015/8/25,1245,7575,8,57,22,35,0.986,2.069
2015/8/25,1345,7577,0,39,20,19,0.983,2.445
2015/8/26,945,7522,-3,143,53,90,0.989,0.715
2015/8/26,1045,7487,-36,97,76,21,0.994,1.189
2015/8/26,1145,7574,87,111,11,100,0.986,1.304
2015/8/26,1245,7648,74,77,-2,79,0.98,1.431
2015/8/26,1345,7607,-40,75,71,4,0.989,1.301
2015/8/27,945,7681,25,88,48,40,0.983,0.692
2015/8/27,1045,7658,-24,64,37,27,0.989,1.163
2015/8/27,1145,7689,31,41,9,32,0.987,2.018
2015/8/27,1245,7666,-22,52,44,8,0.991,1.997
2015/8/27,1345,7680,14,55,10,45,0.99,1.593
2015/8/28,945,7868,56,94,17,77,0.97,0.634
2015/8/28,1045,7875,7,67,27,40,0.974,1.022
2015/8/28,1145,7858,-17,28,25,3,0.981,2.215
2015/8/28,1245,7873,15,65,10,55,0.983,1.334
2015/8/28,1345,7876,3,25,7,18,0.985,1.529
2015/8/31,945,7834,3,53,21,32,0.993,0.762
2015/8/31,1045,7822,-12,40,40,0,0.996,1.332
2015/8/31,1145,7835,14,31,4,27,0.997,1.823
2015/8/31,1245,7870,35,41,-1,42,0.994,1.527
2015/8/31,1345,7969,101,183,65,118,0.984,0.676
2015/9/1,945,7892,-9,90,72,18,0.995,0.562
2015/9/1,1045,7875,-17,109,36,73,0.997,0.581
2015/9/1,1145,7888,12,43,8,35,0.996,1.273
2015/9/1,1245,7869,-20,28,26,2,0.999,2.189
2015/9/1,1345,7834,-36,56,50,6,1.003,1.166
2015/9/2,945,7818,50,81,34,47,1.004,0.564
2015/9/2,1045,7866,47,72,19,53,0.998,0.918
2015/9/2,1145,7960,93,130,25,105,0.987,0.902
2015/9/2,1245,7963,3,76,34,42,0.988,1.385
2015/9/2,1345,7945,-19,60,39,21,0.991,1.228
2015/9/3,945,7939,-22,129,64,65,0.993,0.643
2015/9/3,1045,7953,14,73,25,48,0.992,1.037
2015/9/3,1145,7946,-7,45,17,28,0.994,1.469
2015/9/3,1245,7958,13,37,13,24,0.993,2.02
2015/9/3,1345,7977,21,44,-1,45,0.992,1.894
2015/9/4,945,8026,95,124,13,111,0.987,0.652
2015/9/4,1045,7962,-65,90,67,23,0.998,0.888
2015/9/4,1145,7905,-57,87,65,22,1.006,0.879
2015/9/4,1245,7899,-5,46,19,27,1.006,1.394
2015/9/4,1345,7890,-9,31,25,6,1.007,1.428
2015/9/7,945,7996,146,158,12,146,0.992,0.527
2015/9/7,1045,7927,-69,89,66,23,1.001,0.896
2015/9/7,1145,7958,31,78,4,74,0.997,1.13
2015/9/7,1245,7936,-20,50,34,16,1,2.17
2015/9/7,1345,7932,-5,48,30,18,1,1.555
2015/9/8,945,7944,14,70,6,64,0.999,0.65
2015/9/8,1045,7967,24,56,10,46,0.995,0.997
2015/9/8,1145,7946,-22,49,33,16,0.998,1.387
2015/9/8,1245,7946,1,20,8,12,0.998,3.359
2015/9/8,1345,7976,31,40,-4,44,0.995,1.819
2015/9/9,945,8202,88,94,-4,98,0.971,0.467
2015/9/9,1045,8222,19,53,18,35,0.971,0.883
2015/9/9,1145,8270,48,48,2,46,0.969,1.09
2015/9/9,1245,8298,28,48,7,41,0.969,1.23
2015/9/9,1345,8332,34,52,8,44,0.97,0.998
2015/9/10,945,8243,17,72,21,51,0.984,0.592
2015/9/10,1045,8265,22,67,27,40,0.985,0.887
2015/9/10,1145,8271,7,43,4,39,0.988,1.582
2015/9/10,1245,8255,-16,32,24,8,0.994,2.499
2015/9/10,1345,8262,7,42,20,22,0.996,1.73
2015/9/11,945,8241,20,63,24,39,1,0.647
2015/9/11,1045,8262,21,53,33,20,0.998,0.948
2015/9/11,1145,8258,-5,25,17,8,0.999,2.007
2015/9/11,1245,8273,15,22,5,17,0.997,3.741
2015/9/11,1345,8263,-11,23,23,0,0.998,1.898
2015/9/14,945,8260,-59,70,80,-10,1,0.573
2015/9/14,1045,8280,20,39,0,39,0.997,0.917
2015/9/14,1145,8248,-32,53,40,13,1.001,1.184
2015/9/14,1245,8240,-7,43,13,30,1.002,1.273
2015/9/14,1345,8273,33,52,12,40,0.998,0.99
2015/9/15,945,8258,-42,78,75,3,1.001,0.552
2015/9/15,1045,8283,26,33,20,13,0.998,1.056
2015/9/15,1145,8251,-32,53,39,14,1.002,1.023
2015/9/15,1245,8238,-13,34,26,8,1.004,1.855
2015/9/15,1345,8237,-1,33,32,1,1.003,1.569
2015/9/16,945,8279,-31,71,62,9,0.998,0.749
2015/9/16,1045,8300,22,26,4,22,0.996,1.863
2015/9/16,1145,8341,41,67,17,50,0.991,1.552
2015/9/16,1245,8345,5,27,9,18,0.992,2.281
2015/9/17,945,8448,80,164,30,134,0.981,0.358
2015/9/17,1045,8435,-13,57,23,34,0.984,0.78
2015/9/17,1145,8439,5,30,17,13,0.986,1.639
2015/9/17,1245,8452,13,14,4,10,0.986,3.027
2015/9/17,1345,8437,-14,37,29,8,0.99,1.073
2015/9/18,945,8424,6,58,17,41,0.994,0.53
2015/9/18,1045,8437,12,38,19,19,0.994,0.897
2015/9/18,1145,8447,10,22,6,16,0.995,1.883
2015/9/18,1245,8451,3,21,7,14,0.996,2.108
2015/9/18,1345,8437,-15,24,22,2,0.999,1.845
2015/9/21,945,8240,-88,97,95,2,1.022,0.443
2015/9/21,1045,8255,15,42,23,19,1.018,1.09
2015/9/21,1145,8247,-8,27,13,14,1.017,1.657
2015/9/21,1245,8257,10,23,0,23,1.013,3.228
2015/9/21,1345,8270,13,30,7,23,1.009,1.233
2015/9/22,945,8290,-5,43,29,14,1.005,0.657
2015/9/22,1045,8328,38,49,12,37,0.999,0.725
2015/9/22,1145,8322,-6,18,9,9,0.999,2.096
2015/9/22,1245,8323,1,16,6,10,0.997,3.24
2015/9/22,1345,8330,7,21,8,13,0.995,1.559
2015/9/23,945,8212,-22,55,38,17,1.008,0.444
2015/9/23,1045,8168,-44,36,24,12,1.013,0.621
2015/9/23,1145,8156,-13,29,23,6,1.013,1.459
2015/9/23,1245,8148,-8,22,9,13,1.013,1.934
2015/9/23,1345,8140,-9,25,26,-1,1.013,1.117
2015/9/24,945,8176,-12,39,43,-4,1.007,0.55
2015/9/24,1045,8060,-116,139,126,13,1.02,0.503
2015/9/24,1145,8121,60,63,2,61,1.009,0.938
2015/9/24,1245,8103,-17,23,15,8,1.009,2.059
2015/9/24,1345,8091,-12,30,6,24,1.008,1.344
2015/9/25,945,8100,-42,88,49,39,1.005,0.526
2015/9/25,1045,8053,-48,73,53,20,1.01,0.769
2015/9/25,1145,8073,20,40,15,25,1.006,1.519
2015/9/25,1245,8107,33,40,2,38,1.001,2.186
2015/9/25,1345,8120,13,32,20,12,0.999,1.207
2015/9/30,945,8093,78,123,13,110,1,0.614
2015/9/30,1045,8086,-9,58,40,18,1,1.005
2015/9/30,1145,8155,70,81,8,73,0.991,1.02
2015/9/30,1245,8128,-26,43,41,2,0.995,1.725
2015/9/30,1345,8135,8,53,43,10,0.995,1.017
2015/10/1,945,8145,-29,61,32,29,0.994,0.685
2015/10/1,1045,8255,109,111,-5,116,0.981,0.602
2015/10/1,1145,8303,48,61,22,39,0.978,0.955
2015/10/1,1245,8313,11,44,17,27,0.979,1.795
2015/10/1,1345,8309,-5,34,8,26,0.982,1.434
2015/10/2,945,8287,4,50,17,33,0.988,0.833
2015/10/2,1045,8296,9,37,23,14,0.989,1.273
2015/10/2,1145,8305,10,26,2,24,0.991,1.984
2015/10/2,1245,8274,-31,36,36,0,0.996,2.665
2015/10/2,1345,8277,2,12,9,3,0.998,2.449
2015/10/5,945,8289,-69,92,88,4,0.999,0.522
2015/10/5,1045,8339,50,58,-6,64,0.994,1.003
2015/10/5,1145,8338,-2,26,12,14,0.996,1.432
2015/10/5,1245,8329,-10,28,26,2,0.997,1.748
2015/10/5,1345,8335,5,23,1,22,0.997,1.512
2015/10/6,945,8390,-41,91,88,3,0.992,0.379
2015/10/6,1045,8407,16,46,11,35,0.991,0.885
2015/10/6,1145,8371,-36,29,33,-4,0.997,1.692
2015/10/6,1245,8389,17,29,7,22,0.995,2.212
2015/10/6,1345,8370,-19,29,24,5,0.999,1.561
2015/10/7,945,8420,43,63,0,63,0.993,0.604
2015/10/7,1045,8441,21,39,4,35,0.992,0.844
2015/10/7,1145,8442,1,22,7,15,0.993,1.42
2015/10/7,1245,8493,50,52,-5,57,0.989,1.448
2015/10/7,1345,8492,-1,20,5,15,0.991,1.073
2015/10/8,945,8469,-65,81,75,6,0.995,0.506
2015/10/8,1045,8465,-4,52,20,32,0.996,0.783
2015/10/8,1145,8446,-19,46,40,6,0.999,1.378
2015/10/8,1245,8434,-13,38,26,12,1.001,1.479
2015/10/8,1345,8441,7,22,6,16,1.001,1.561
2015/10/12,945,8547,53,90,7,83,0.99,0.582
2015/10/12,1045,8557,10,53,22,31,0.99,0.955
2015/10/12,1145,8567,10,26,13,13,0.99,2.548
2015/10/12,1245,8552,-15,21,2,19,0.994,2.502
2015/10/12,1345,8552,0,26,20,6,0.994,1.382
2015/10/13,945,8545,-9,42,18,24,0.995,0.761
2015/10/13,1045,8533,-11,51,42,9,0.998,0.837
2015/10/13,1145,8531,-2,29,9,20,0.999,1.287
2015/10/13,1245,8548,17,24,4,20,0.998,2.493
2015/10/13,1345,8553,3,16,7,9,0.998,1.707
2015/10/14,945,8531,10,42,3,39,1.001,0.487
2015/10/14,1045,8530,-2,39,20,19,1.001,0.941
2015/10/14,1145,8543,13,30,11,19,0.999,1.178
2015/10/14,1245,8539,-5,16,9,7,1,2.697
2015/10/14,1345,8519,-20,21,22,-1,1.002,1.432
2015/10/15,945,8663,98,91,4,87,0.985,0.402
2015/10/15,1045,8621,-42,76,44,32,0.991,0.663
2015/10/15,1145,8631,11,25,4,21,0.991,1.733
2015/10/15,1245,8621,-9,25,22,3,0.994,2.305
2015/10/15,1345,8608,-13,25,22,3,0.996,1.369
2015/10/16,945,8624,36,43,1,42,0.995,0.623
2015/10/16,1045,8604,-20,29,20,9,0.998,1.354
2015/10/16,1145,8586,-16,44,29,15,1.001,1.157
2015/10/16,1245,8595,9,20,8,12,1.001,2.96
2015/10/16,1345,8607,11,23,3,20,1,1.883
2015/10/19,945,8620,-7,60,50,10,0.999,0.471
2015/10/19,1045,8620,-1,48,16,32,0.999,0.711
2015/10/19,1145,8619,-1,22,21,1,0.999,1.659
2015/10/19,1245,8614,-5,13,10,3,0.999,2.814
2015/10/19,1345,8624,9,11,2,9,0.998,2.062
2015/10/20,945,8657,13,30,6,24,0.995,0.691
2015/10/20,1045,8649,-8,21,9,12,0.996,1.093
2015/10/20,1145,8647,-3,14,7,7,0.997,2.218
2015/10/20,1245,8639,-8,19,9,10,0.998,2.172
2015/10/20,1345,8659,21,26,2,24,0.997,1.708
2015/10/21,945,8643,-47,64,61,3,0.999,0.697
2015/10/21,1045,8603,-40,42,45,-3,1.004,0.761
2015/10/21,1145,8619,15,22,-4,26,1.002,1.33
2015/10/21,1245,8621,3,19,8,11,1.002,2.226
2015/10/22,945,8603,15,58,21,37,1.004,0.373
2015/10/22,1045,8617,15,58,16,42,1.001,0.59
2015/10/22,1145,8609,-8,21,14,7,1.002,1.662
2015/10/22,1245,8604,-6,16,7,9,1.002,2.336
2015/10/22,1345,8595,-8,21,19,2,1.003,1.482
2015/10/23,945,8685,-57,72,67,5,0.993,0.425
2015/10/23,1045,8696,11,33,14,19,0.992,1.062
2015/10/23,1145,8691,-5,19,8,11,0.993,1.935
2015/10/23,1245,8678,-12,17,11,6,0.996,2.338
2015/10/23,1345,8692,13,26,3,23,0.995,1.399
2015/10/26,945,8726,-4,49,39,10,0.993,0.517
2015/10/26,1045,8727,0,22,17,5,0.994,1.252
2015/10/26,1145,8724,-3,11,8,3,0.995,2.771
2015/10/26,1245,8730,4,12,1,11,0.996,3.189
2015/10/26,1345,8736,7,16,5,11,0.997,1.578
2015/10/27,945,8702,-20,27,26,1,1.001,0.582
2015/10/27,1045,8679,-22,43,31,12,1.003,0.581
2015/10/27,1145,8666,-14,27,16,11,1.005,1.099
2015/10/27,1245,8669,3,12,8,4,1.004,3.029
2015/10/27,1345,8691,22,32,9,23,1.001,0.977
2015/10/28,945,8690,5,47,20,27,1.001,0.539
2015/10/28,1045,8642,-50,66,64,2,1.006,0.576
2015/10/28,1145,8619,-25,39,33,6,1.008,1.001
2015/10/28,1245,8632,13,16,4,12,1.005,2.103
2015/10/28,1345,8638,6,27,16,11,1.003,1.063
2015/10/29,945,8567,-114,95,116,-21,1.011,0.514
2015/10/29,1045,8574,5,43,42,1,1.009,0.72
2015/10/29,1145,8581,7,49,18,31,1.007,0.942
2015/10/29,1245,8575,-5,20,10,10,1.006,2.263
2015/10/29,1345,8550,-24,46,42,4,1.008,0.969
2015/10/30,945,8488,-72,84,90,-6,1.014,0.544
2015/10/30,1045,8576,88,95,9,86,1.001,0.656
2015/10/30,1145,8570,-8,40,28,12,1.001,1.144
2015/10/30,1245,8598,28,22,-7,29,0.997,2.041
2015/10/30,1345,8568,-30,34,25,9,1.001,1.465
2015/11/2,945,8535,0,65,32,33,1.003,0.697
2015/11/2,1045,8568,34,38,7,31,0.998,1.005
2015/11/2,1145,8572,5,37,26,11,0.998,1.328
2015/11/2,1245,8575,2,15,13,2,0.997,3.544
2015/11/2,1345,8583,8,32,11,21,0.997,1.535
2015/11/3,945,8719,54,93,19,74,0.982,0.443
2015/11/3,1045,8714,-6,31,13,18,0.985,1.153
2015/11/3,1145,8714,-1,17,9,8,0.987,3.087
2015/11/3,1245,8730,16,21,3,18,0.987,2.596
2015/11/3,1345,8721,-9,27,19,8,0.989,1.16
2015/11/4,945,8865,100,99,-15,114,0.976,0.402
2015/11/4,1045,8873,7,48,27,21,0.979,0.631
2015/11/4,1145,8880,8,17,5,12,0.981,1.815
2015/11/4,1245,8886,6,24,8,16,0.984,2.408
2015/11/4,1345,8882,-4,17,11,6,0.988,1.287
2015/11/5,945,8874,-5,60,18,42,0.991,0.581
2015/11/5,1045,8861,-13,44,38,6,0.995,1.129
2015/11/5,1145,8873,11,27,6,21,0.995,2.287
2015/11/5,1245,8885,13,17,-2,19,0.995,4.338
2015/11/5,1345,8870,-15,11,13,-2,0.999,2.513
2015/11/6,945,8770,-80,103,87,16,1.011,0.441
2015/11/6,1045,8710,-60,64,78,-14,1.017,0.641
2015/11/6,1145,8709,0,32,25,7,1.015,1.177
2015/11/6,1245,8682,-26,57,25,32,1.016,0.84
2015/11/6,1345,8689,8,56,32,24,1.013,0.704
2015/11/9,945,8718,41,151,30,121,1.008,0.483
2015/11/9,1045,8657,-61,100,69,31,1.013,0.699
2015/11/9,1145,8622,-36,60,38,22,1.015,1.094
2015/11/9,1245,8652,30,58,16,42,1.008,1.995
2015/11/9,1345,8631,-21,36,27,9,1.008,2.394
2015/11/10,945,8565,-16,80,27,53,1.013,0.624
2015/11/10,1045,8554,-12,33,21,12,1.012,1.499
2015/11/10,1145,8558,4,49,17,32,1.009,1.574
2015/11/10,1245,8545,-12,17,12,5,1.009,3.006
2015/11/10,1345,8532,-13,27,22,5,1.009,1.613
2015/11/11,945,8461,-46,104,88,16,1.015,0.449
2015/11/11,1045,8426,-34,58,37,21,1.017,0.734
2015/11/11,1145,8442,16,55,26,29,1.012,1.08
2015/11/11,1245,8414,-27,34,28,6,1.013,2.252
2015/11/11,1345,8380,-34,70,62,8,1.014,0.994
2015/11/12,945,8402,-2,63,46,17,1.01,0.628
2015/11/12,1045,8384,-19,74,54,20,1.01,0.909
2015/11/12,1145,8410,25,59,3,56,1.005,1.112
2015/11/12,1245,8413,3,30,14,16,1.003,2.404
2015/11/12,1345,8461,47,59,-1,60,0.995,1.501
2015/11/13,945,8450,70,116,22,94,0.995,0.546
2015/11/13,1045,8352,-97,131,97,34,1.007,0.672
2015/11/13,1145,8360,8,47,18,29,1.005,1.095
2015/11/13,1245,8340,-20,35,28,7,1.006,2.598
2015/11/13,1345,8356,16,30,0,30,1.004,1.32
2015/11/16,945,8235,-10,95,72,23,1.016,0.536
2015/11/16,1045,8265,29,56,22,34,1.011,1.234
2015/11/16,1145,8283,18,40,17,23,1.007,1.762
2015/11/16,1245,8279,-3,24,16,8,1.006,2.882
2015/11/16,1345,8290,12,23,10,13,1.003,2.236
2015/11/17,945,8477,107,97,4,93,0.981,0.501
2015/11/17,1045,8457,-20,40,33,7,0.983,1.194
2015/11/17,1145,8454,-3,53,35,18,0.985,1.464
2015/11/17,1245,8460,6,25,3,22,0.985,1.789
2015/11/17,1345,8440,-19,40,23,17,0.989,1.329
2015/11/18,945,8399,-41,48,51,-3,0.996,0.912
2015/11/18,1045,8391,-10,52,15,37,0.999,0.97
2015/11/18,1145,8374,-17,30,16,14,1.003,2.144
2015/11/18,1245,8369,-4,19,15,4,1.004,4.655
2015/11/19,945,8351,-20,62,34,28,1.008,0.401
2015/11/19,1045,8365,14,58,35,23,1.006,0.658
2015/11/19,1145,8395,30,33,3,30,1.001,1.532
2015/11/19,1245,8413,19,34,11,23,0.998,1.11
2015/11/19,1345,8447,34,50,13,37,0.993,0.958
2015/11/20,945,8440,10,50,35,15,0.994,0.656
2015/11/20,1045,8405,-34,66,57,9,0.998,0.937
2015/11/20,1145,8419,14,23,9,14,0.996,1.633
2015/11/20,1245,8419,1,27,20,7,0.997,2.168
2015/11/20,1345,8444,25,35,3,32,0.994,2.06
2015/11/23,945,8428,-60,91,83,8,0.998,0.558
2015/11/23,1045,8430,1,47,24,23,0.998,0.902
2015/11/23,1145,8474,43,36,-6,42,0.994,1.251
2015/11/23,1245,8455,-19,28,25,3,0.997,2.051
2015/11/23,1345,8478,24,29,5,24,0.995,1.636
2015/11/24,945,8440,-21,51,31,20,1,0.552
2015/11/24,1045,8450,10,67,44,23,0.999,0.631
2015/11/24,1145,8423,-27,52,29,23,1.002,0.843
2015/11/24,1245,8394,-30,66,34,32,1.006,1.057
2015/11/24,1345,8402,8,26,0,26,1.005,1.34
2015/11/25,945,8358,-54,85,52,33,1.009,0.578
2015/11/25,1045,8354,-4,38,24,14,1.009,1.033
2015/11/25,1145,8342,-12,38,16,22,1.009,1.143
2015/11/25,1245,8359,18,29,9,20,1.005,2.117
2015/11/25,1345,8388,28,41,2,39,1.001,1.43
2015/11/26,945,8480,68,101,45,56,0.989,0.46
2015/11/26,1045,8484,4,25,9,16,0.989,1.609
2015/11/26,1145,8507,23,30,7,23,0.987,1.836
2015/11/26,1245,8501,-7,30,12,18,0.989,2.379
2015/11/26,1345,8502,0,21,3,18,0.99,1.533
2015/11/27,945,8471,-49,65,49,16,0.995,0.617
2015/11/27,1045,8457,-13,25,6,19,0.998,1.038
2015/11/27,1145,8417,-40,52,43,9,1.004,1.089
2015/11/27,1245,8409,-8,33,17,16,1.006,1.511
2015/11/27,1345,8393,-16,48,32,16,1.008,1.061
2015/11/30,945,8214,-97,108,96,12,1.029,0.403
2015/11/30,1045,8238,25,43,38,5,1.023,0.931
2015/11/30,1145,8226,-12,34,28,6,1.021,1.721
2015/11/30,1245,8241,14,24,4,20,1.016,2.499
2015/11/30,1345,8300,60,108,45,63,1.006,0.709
2015/12/1,945,8341,-19,66,42,24,0.999,0.682
2015/12/1,1045,8437,96,100,-2,102,0.986,0.636
2015/12/1,1145,8449,12,26,-1,27,0.984,1.757
2015/12/1,1245,8447,-2,27,16,11,0.985,2.126
2015/12/1,1345,8456,9,31,6,25,0.984,1.269
2015/12/2,945,8490,57,80,10,70,0.982,0.578
2015/12/2,1045,8482,-8,35,28,7,0.986,1.023
2015/12/2,1145,8439,-42,69,45,24,0.994,0.871
2015/12/2,1245,8451,11,23,8,15,0.995,2.694
2015/12/2,1345,8452,0,18,7,11,0.997,1.98
2015/12/3,945,8433,45,85,15,70,1,0.614
2015/12/3,1045,8463,30,62,22,40,0.997,0.823
2015/12/3,1145,8445,-18,57,32,25,1,1.247
2015/12/3,1245,8476,31,51,14,37,0.996,1.398
2015/12/3,1345,8476,1,26,4,22,0.996,1.615
2015/12/4,945,8359,-2,68,40,28,1.01,0.511
2015/12/4,1045,8386,28,84,24,60,1.005,0.778
2015/12/4,1145,8388,2,26,10,16,1.003,1.765
2015/12/4,1245,8393,5,19,10,9,1.002,3.064
2015/12/4,1345,8397,4,17,2,15,1.001,2.242
2015/12/7,945,8491,-4,82,59,23,0.991,0.427
2015/12/7,1045,8473,-18,31,13,18,0.994,1.112
2015/12/7,1145,8479,6,26,13,13,0.993,2.349
2015/12/7,1245,8476,-4,18,9,9,0.994,3.464
2015/12/7,1345,8468,-8,20,16,4,0.995,1.678
2015/12/8,945,8381,-57,68,68,0,1.006,0.533
2015/12/8,1045,8358,-23,56,45,11,1.009,0.784
2015/12/8,1145,8341,-17,39,16,23,1.011,1.033
2015/12/8,1245,8343,0,24,17,7,1.01,2.009
2015/12/8,1345,8334,-10,25,16,9,1.011,1.165
2015/12/9,945,8265,-46,86,63,23,1.017,0.447
2015/12/9,1045,8237,-29,64,39,25,1.018,0.687
2015/12/9,1145,8237,-1,21,13,8,1.015,1.984
2015/12/9,1245,8249,13,27,15,12,1.01,2.004
2015/12/9,1345,8221,-27,35,31,4,1.011,1.27
2015/12/10,945,8150,-32,83,34,49,1.017,0.48
2015/12/10,1045,8125,-27,50,47,3,1.017,0.964
2015/12/10,1145,8141,16,40,6,34,1.012,1.531
2015/12/10,1245,8155,14,32,2,30,1.008,2.004
2015/12/10,1345,8188,31,49,20,29,1.002,0.893
2015/12/11,945,8178,-22,61,42,19,1.002,0.586
2015/12/11,1045,8140,-38,69,48,21,1.005,0.851
2015/12/11,1145,8138,-3,35,11,24,1.004,1.697
2015/12/11,1245,8121,-17,38,32,6,1.005,2.237
2015/12/11,1345,8071,-50,51,48,3,1.01,0.885
2015/12/14,945,8030,54,81,0,81,1.012,0.548
2015/12/14,1045,8035,5,43,26,17,1.01,1.19
2015/12/14,1145,8042,7,27,10,17,1.008,2.575
2015/12/14,1245,8049,8,29,16,13,1.006,1.998
2015/12/14,1345,8058,9,29,3,26,1.004,1.843
2015/12/15,945,8063,-14,85,74,11,1.001,0.523
2015/12/15,1045,8095,32,51,4,47,0.996,1.114
2015/12/15,1145,8087,-8,25,21,4,0.996,2.022
2015/12/15,1245,8092,4,28,6,22,0.995,2.414
2015/12/15,1345,8066,-26,38,35,3,0.998,1.515
2015/12/16,945,8126,-54,60,46,14,0.993,0.752
2015/12/16,1045,8180,54,66,11,55,0.988,0.876
2015/12/16,1145,8185,5,31,12,19,0.989,1.749
2015/12/16,1245,8203,19,24,-1,25,0.989,3.196
2015/12/17,945,8224,22,68,20,48,0.988,0.392
2015/12/17,1045,8272,48,50,2,48,0.984,0.706
2015/12/17,1145,8253,-19,26,15,11,0.989,1.537
2015/12/17,1245,8263,9,19,3,16,0.989,2.912
2015/12/17,1345,8281,18,49,22,27,0.989,0.923
2015/12/18,945,8231,-17,44,19,25,0.997,0.598
2015/12/18,1045,8258,27,48,23,25,0.995,0.98
2015/12/18,1145,8278,20,31,5,26,0.994,1.888
2015/12/18,1245,8274,-5,56,45,11,0.996,0.874
2015/12/18,1345,8231,-44,48,45,3,1.002,1.119
2015/12/21,945,8211,38,72,-6,78,1.004,0.575
2015/12/21,1045,8231,20,35,-1,36,1.001,0.914
2015/12/21,1145,8241,10,35,3,32,1,1.571
2015/12/21,1245,8239,-4,15,9,6,1,3.23
2015/12/21,1345,8280,41,40,3,37,0.995,0.973
2015/12/22,945,8229,-28,71,68,3,1.001,0.639
2015/12/22,1045,8254,25,42,10,32,0.998,1.12
2015/12/22,1145,8249,-5,55,29,26,0.998,1.103
2015/12/22,1245,8245,-4,27,19,8,0.998,1.933
2015/12/22,1345,8277,32,36,-1,37,0.994,1.427
2015/12/23,945,8319,18,63,11,52,0.991,0.492
2015/12/23,1045,8342,22,37,5,32,0.989,0.769
2015/12/23,1145,8313,-29,43,31,12,0.994,1.334
2015/12/23,1245,8317,5,14,6,8,0.994,4.045
2015/12/23,1345,8290,-28,35,27,8,0.999,1.329
2015/12/24,945,8337,-9,58,51,7,0.994,0.542
2015/12/24,1045,8329,-6,29,24,5,0.996,1.168
2015/12/24,1145,8319,-11,34,22,12,0.998,1.591
2015/12/24,1245,8322,3,16,4,12,0.999,3.277
2015/12/24,1345,8317,-5,30,6,24,1,1.33
2015/12/25,945,8338,3,39,7,32,0.998,0.91
2015/12/25,1045,8333,-6,22,15,7,0.999,1.452
2015/12/25,1145,8334,1,17,6,11,0.999,2.425
2015/12/25,1245,8343,9,8,-3,11,0.998,4.458
2015/12/25,1345,8376,33,22,-2,24,0.994,1.054
2015/12/28,945,8365,-5,38,29,9,0.996,0.526
2015/12/28,1045,8376,10,33,10,23,0.995,0.932
2015/12/28,1145,8373,-2,17,6,11,0.996,1.794
2015/12/28,1245,8373,0,13,6,7,0.997,2.939
2015/12/28,1345,8356,-18,25,18,7,0.999,1.041
2015/12/29,945,8290,-31,70,57,13,1.007,0.377
2015/12/29,1045,8276,-14,39,26,13,1.008,0.708
2015/12/29,1145,8292,15,40,18,22,1.006,0.924
2015/12/29,1245,8289,-4,19,10,9,1.005,2.416
2015/12/29,1345,8287,-3,22,15,7,1.005,1.071
2015/12/30,945,8293,-20,41,36,5,1.004,0.567
2015/12/30,1045,8246,-47,75,59,16,1.008,0.575
2015/12/30,1145,8232,-13,32,26,6,1.009,1.161
2015/12/30,1245,8239,7,16,8,8,1.006,3.442
2015/12/30,1345,8260,22,32,4,28,1.002,0.996
2015/12/31,945,8290,50,51,3,48,0.997,0.603
2015/12/31,1045,8275,-16,29,25,4,0.999,1.511
2015/12/31,1145,8259,-16,36,22,14,1.001,1.296
2015/12/31,1245,8278,19,25,6,19,0.998,1.912
2015/12/31,1345,8272,-5,33,23,10,0.999,0.887
2016/1/4,945,8134,-128,164,160,4,1.015,0.393
2016/1/4,1045,8084,-52,98,50,48,1.019,0.507
2016/1/4,1145,8097,13,47,17,30,1.016,1.004
2016/1/4,1245,8093,-3,47,29,18,1.015,1.514
2016/1/4,1345,8075,-17,33,16,17,1.015,1
2016/1/5,945,8122,23,77,-2,79,1.008,0.509
2016/1/5,1045,8075,-46,57,55,2,1.011,1.123
2016/1/5,1145,8081,6,31,24,7,1.008,2.244
2016/1/5,1245,8038,-43,55,50,5,1.011,1.437
2016/1/5,1345,8025,-12,37,23,14,1.01,1.212
2016/1/6,945,8010,-28,92,38,54,1.009,0.575
2016/1/6,1045,7917,-92,104,98,6,1.019,0.657
2016/1/6,1145,7940,23,49,10,39,1.014,1.151
2016/1/6,1245,7993,53,64,-5,69,1.005,1.368
2016/1/6,1345,7971,-22,49,15,34,1.007,1.237
2016/1/7,945,7845,-111,149,126,23,1.021,0.485
2016/1/7,1045,7808,-38,83,66,17,1.023,0.672
2016/1/7,1145,7762,-45,102,71,31,1.025,0.956
2016/1/7,1245,7769,7,40,29,11,1.02,1.76
2016/1/7,1345,7799,30,76,26,50,1.013,1.119
2016/1/8,945,7808,53,150,76,74,1.008,0.589
2016/1/8,1045,7837,30,70,16,54,1.002,1.062
2016/1/8,1145,7851,15,44,12,32,0.999,1.987
2016/1/8,1245,7854,2,32,10,22,0.998,3.175
2016/1/8,1345,7868,15,23,-1,24,0.994,1.783
2016/1/11,945,7710,-20,103,65,38,1.011,0.588
2016/1/11,1045,7764,54,67,21,46,1.003,0.913
2016/1/11,1145,7755,-8,39,10,29,1.003,1.818
2016/1/11,1245,7770,15,44,23,21,1.001,1.829
2016/1/11,1345,7740,-31,39,37,2,1.005,1.461
2016/1/12,945,7765,-35,77,43,34,1.002,0.632
2016/1/12,1045,7719,-45,70,65,5,1.008,0.951
2016/1/12,1145,7720,1,61,21,40,1.006,1.026
2016/1/12,1245,7708,-13,45,35,10,1.006,1.698
2016/1/12,1345,7709,2,34,11,23,1.004,1.127
2016/1/13,945,7808,24,78,41,37,0.992,0.533
2016/1/13,1045,7802,-5,50,30,20,0.994,0.906
2016/1/13,1145,7749,-53,64,51,13,1.001,0.973
2016/1/13,1245,7771,21,33,6,27,0.998,1.747
2016/1/13,1345,7806,35,44,0,44,0.994,1.331
2016/1/14,945,7687,40,89,9,80,1.007,0.516
2016/1/14,1045,7690,3,44,27,17,1.006,1.127
2016/1/14,1145,7693,1,33,23,10,1.005,1.708
2016/1/14,1245,7694,3,20,5,15,1.005,2.838
2016/1/14,1345,7716,21,39,8,31,1.002,1.448
2016/1/15,945,7729,-72,64,65,-1,1,0.633
2016/1/15,1045,7723,-6,43,32,11,1,1.066
2016/1/15,1145,7701,-22,34,36,-2,1.002,1.793
2016/1/15,1245,7664,-37,76,54,22,1.006,1.067
2016/1/15,1345,7665,0,59,30,29,1.004,0.834
2016/1/18,945,7704,191,170,-14,184,0.998,0.457
2016/1/18,1045,7689,-14,118,109,9,1,0.655
2016/1/18,1145,7766,78,66,-16,82,0.99,1.195
2016/1/18,1245,7774,7,49,19,30,0.99,1.579
2016/1/18,1345,7814,40,55,14,41,0.986,1.073
2016/1/19,945,7777,-9,61,38,23,0.99,0.763
2016/1/19,1045,7753,-24,69,66,3,0.994,1.053
2016/1/19,1145,7807,52,59,6,53,0.987,1.761
2016/1/19,1245,7835,28,33,6,27,0.985,2.044
2016/1/19,1345,7867,33,43,0,43,0.983,1.783
2016/1/20,945,7723,-74,93,81,12,1.005,0.834
2016/1/20,1045,7750,28,52,23,29,1.002,1.329
2016/1/20,1145,7717,-33,60,33,27,1.007,1.485
2016/1/20,1245,7705,-11,40,8,32,1.008,1.852
2016/1/21,945,7643,-16,114,73,41,1.015,0.423
2016/1/21,1045,7677,34,55,8,47,1.008,0.75
2016/1/21,1145,7675,-2,35,31,4,1.007,0.987
2016/1/21,1245,7650,-25,42,32,10,1.01,1.384
2016/1/21,1345,7613,-37,45,33,12,1.013,0.941
2016/1/22,945,7682,-48,73,53,20,1.002,0.718
2016/1/22,1045,7670,-12,50,34,16,1.002,0.982
2016/1/22,1145,7649,-20,45,38,7,1.004,1.357
2016/1/22,1245,7675,26,39,5,34,1,1.898
2016/1/22,1345,7748,72,81,4,77,0.99,0.829
2016/1/25,945,7836,68,115,45,70,0.98,0.598
2016/1/25,1045,7853,17,28,7,21,0.98,1.506
2016/1/25,1145,7849,-4,32,25,7,0.983,1.871
2016/1/25,1245,7862,13,19,2,17,0.983,2.788
2016/1/25,1345,7833,-29,40,38,2,0.99,1.309
2016/1/26,945,7777,-7,41,19,22,0.998,0.689
2016/1/26,1045,7760,-17,34,19,15,1.001,0.93
2016/1/26,1145,7786,26,48,24,24,0.999,1.067
2016/1/26,1245,7776,-10,28,22,6,1.002,2.456
2016/1/26,1345,7779,4,23,7,16,1.003,1.386
2016/1/27,945,7813,-37,59,46,13,1,0.655
2016/1/27,1045,7820,7,39,14,25,0.998,0.753
2016/1/27,1145,7787,-33,32,45,-13,1.002,1.42
2016/1/27,1245,7803,15,30,5,25,0.999,1.508
2016/1/27,1345,7839,35,50,2,48,0.994,1.04
2016/1/28,945,7880,80,84,-3,87,0.989,0.572
2016/1/28,1045,7882,1,32,21,11,0.99,0.907
2016/1/28,1145,7868,-13,26,9,17,0.993,1.505
2016/1/28,1245,7843,-24,47,37,10,0.998,1.508
2016/1/28,1345,7855,13,38,23,15,0.997,1.118
2016/1/29,945,7909,68,96,7,89,0.99,0.569
2016/1/29,1045,7937,28,41,-5,46,0.988,0.754
2016/1/29,1145,8065,128,132,8,124,0.973,0.552
2016/1/29,1245,8022,-44,70,49,21,0.982,1.028
2016/1/29,1345,8053,31,48,7,41,0.981,0.911
2016/1/30,945,8118,15,52,30,22,0.977,1.315
2016/1/30,1045,8139,21,38,14,24,0.977,2.285
2016/1/30,1145,8145,6,14,0,14,0.98,6.757
2016/1/30,1245,8143,-2,23,22,1,0.983,3.754
2016/1/30,1345,8163,20,30,4,26,0.985,2.827
2016/2/1,945,8112,-19,67,31,36,0.994,0.633
2016/2/1,1045,8132,19,38,18,20,0.995,0.917
2016/2/1,1145,8090,-43,67,44,23,1.002,0.725
2016/2/1,1245,8105,15,28,4,24,1.001,1.718
2016/2/1,1345,8124,19,50,13,37,0.999,0.832
2016/2/2,945,8093,14,58,26,32,1.003,0.556
2016/2/2,1045,8135,42,59,14,45,0.997,0.704
2016/2/2,1145,8111,-24,30,26,4,1,1.424
2016/2/2,1245,8104,-7,28,23,5,1.001,1.96
2016/2/2,1345,8105,1,32,24,8,1,1.321
2016/2/3,945,8014,-12,87,66,21,1.01,0.502
2016/2/3,1045,8032,19,38,16,22,1.007,0.971
2016/2/3,1145,8045,13,38,11,27,1.004,1.391
2016/2/3,1245,8066,21,43,19,24,1.001,1.398
2016/2/3,1345,8034,-32,51,35,16,1.004,1.103
2016/2/15,945,8030,110,119,10,109,1.003,0.577
2016/2/15,1045,8040,9,44,26,18,1.001,1.159
2016/2/15,1145,8047,7,30,17,13,0.998,1.991
2016/2/15,1245,8037,-10,26,19,7,0.999,2.992
2016/2/15,1345,8049,12,32,19,13,0.997,1.39
2016/2/16,945,8151,71,78,4,74,0.985,0.543
2016/2/16,1045,8199,47,46,-3,49,0.981,0.81
2016/2/16,1145,8202,3,24,2,22,0.982,1.535
2016/2/16,1245,8214,12,38,18,20,0.983,1.58
2016/2/16,1345,8205,-8,30,24,6,0.986,1.058
2016/2/17,945,8197,-35,55,51,4,0.991,0.845
2016/2/17,1045,8233,35,38,7,31,0.988,1.651
2016/2/17,1145,8217,-16,49,34,15,0.992,1.759
2016/2/17,1245,8214,-2,25,6,19,0.995,3.005
2016/2/18,945,8285,-5,124,47,77,0.989,0.382
2016/2/18,1045,8285,0,47,21,26,0.992,1.046
2016/2/18,1145,8293,8,30,9,21,0.993,1.663
2016/2/18,1245,8282,-11,15,13,2,0.995,2.932
2016/2/18,1345,8284,1,17,9,8,0.996,1.562
2016/2/19,945,8314,36,65,4,61,0.993,0.578
2016/2/19,1045,8294,-21,34,13,21,0.996,1.179
2016/2/19,1145,8297,2,20,9,11,0.997,2.123
2016/2/19,1245,8287,-10,19,10,9,0.999,2.766
2016/2/19,1345,8304,18,29,10,19,0.998,1.403
2016/2/22,945,8395,106,113,9,104,0.987,0.39
2016/2/22,1045,8280,-115,127,108,19,1.002,0.448
2016/2/22,1145,8292,12,31,10,21,1.001,1.377
2016/2/22,1245,8296,5,24,11,13,1,3.018
2016/2/22,1345,8302,6,22,8,14,1,1.742
2016/2/23,945,8314,-7,44,15,29,0.999,0.577
2016/2/23,1045,8307,-6,41,5,36,0.999,0.828
2016/2/23,1145,8303,-4,31,13,18,1,1.795
2016/2/23,1245,8304,2,17,6,11,1,3.032
2016/2/23,1345,8318,14,24,4,20,0.999,1.663
2016/2/24,945,8320,20,84,62,22,0.998,0.423
2016/2/24,1045,8251,-70,102,80,22,1.006,0.533
2016/2/24,1145,8250,-2,26,17,9,1.006,1.569
2016/2/24,1245,8232,-17,36,20,16,1.007,1.481
2016/2/24,1345,8248,16,27,5,22,1.005,1.308
2016/2/25,945,8299,12,61,33,28,0.998,0.526
2016/2/25,1045,8356,57,47,-10,57,0.991,0.966
2016/2/25,1145,8339,-17,46,36,10,0.994,1.138
2016/2/25,1245,8350,10,23,4,19,0.993,2.515
2016/2/25,1345,8337,-13,26,20,6,0.995,1.466
2016/2/26,945,8317,-73,86,99,-13,0.998,0.556
2016/2/26,1045,8343,26,38,6,32,0.995,1.031
2016/2/26,1145,8353,12,36,2,34,0.995,1.588
2016/2/26,1245,8362,11,22,1,21,0.995,2.477
2016/2/26,1345,8391,29,34,0,34,0.993,1.05
2016/3/1,945,8383,11,50,27,23,0.995,0.644
2016/3/1,1045,8437,54,78,15,63,0.99,0.644
2016/3/1,1145,8450,12,24,8,16,0.989,1.729
2016/3/1,1245,8483,34,27,-6,33,0.987,2.302
2016/3/1,1345,8448,-34,32,34,-2,0.992,1.196
2016/3/2,945,8525,-15,59,50,9,0.985,0.449
2016/3/2,1045,8523,-1,22,-1,23,0.988,0.966
2016/3/2,1145,8524,1,21,9,12,0.99,1.925
2016/3/2,1245,8523,-1,17,9,8,0.992,3.317
2016/3/2,1345,8517,-6,13,6,7,0.995,1.918
2016/3/3,945,8592,62,89,14,75,0.988,0.496
2016/3/3,1045,8534,-57,69,59,10,0.997,0.755
2016/3/3,1145,8562,28,32,-3,35,0.995,1.672
2016/3/3,1245,8554,-7,17,11,6,0.997,3.29
2016/3/3,1345,8566,11,17,3,14,0.997,1.502
2016/3/4,945,8560,-10,46,34,12,0.998,0.628
2016/3/4,1045,8587,27,57,21,36,0.995,0.764
2016/3/4,1145,8602,14,31,15,16,0.994,1.115
2016/3/4,1245,8610,8,19,8,11,0.994,2.643
2016/3/4,1345,8602,-8,35,14,21,0.996,0.986
2016/3/7,945,8668,63,84,17,67,0.989,0.516
2016/3/7,1045,8614,-54,37,32,5,0.996,1.013
2016/3/7,1145,8595,-19,58,36,22,0.999,0.984
2016/3/7,1245,8612,18,23,3,20,0.998,2.797
2016/3/7,1345,8605,-6,16,8,8,0.999,1.89
2016/3/8,945,8545,-66,67,73,-6,1.007,0.579
2016/3/8,1045,8553,8,31,3,28,1.006,0.785
2016/3/8,1145,8568,16,33,6,27,1.003,1.281
2016/3/8,1245,8596,27,33,3,30,1,1.623
2016/3/8,1345,8614,19,22,3,19,0.997,1.115
2016/3/9,945,8576,-37,77,56,21,1.002,0.497
2016/3/9,1045,8584,8,27,8,19,1,1.057
2016/3/9,1145,8584,-1,18,6,12,1,2.114
2016/3/9,1245,8589,6,18,8,10,0.999,2.941
2016/3/9,1345,8620,31,31,-1,32,0.995,1.215
2016/3/10,945,8658,29,68,11,57,0.991,0.497
2016/3/10,1045,8638,-20,61,34,27,0.995,0.826
2016/3/10,1145,8651,12,26,4,22,0.994,2.22
2016/3/10,1245,8636,-15,19,16,3,0.997,3.179
2016/3/10,1345,8641,4,10,5,5,0.997,1.666
2016/3/11,945,8649,31,42,1,41,0.996,0.595
2016/3/11,1045,8654,5,38,24,14,0.996,0.635
2016/3/11,1145,8676,22,34,8,26,0.994,1.481
2016/3/11,1245,8703,27,31,0,31,0.992,1.464
2016/3/11,1345,8707,4,17,-1,18,0.993,1.119
2016/3/14,945,8775,48,40,-7,47,0.987,0.556
2016/3/14,1045,8755,-18,33,12,21,0.99,1.046
2016/3/14,1145,8750,-5,18,14,4,0.992,2.09
2016/3/14,1245,8751,2,9,6,3,0.993,3.686
2016/3/14,1345,8741,-10,16,13,3,0.995,1.542
2016/3/15,945,8735,-4,35,15,20,0.998,0.664
2016/3/15,1045,8671,-64,62,74,-12,1.006,0.861
2016/3/15,1145,8639,-32,54,41,13,1.01,0.587
2016/3/15,1245,8613,-26,52,28,24,1.012,0.9
2016/3/15,1345,8603,-10,33,8,25,1.013,0.741
2016/3/16,945,8673,37,38,2,36,1.003,1.033
2016/3/16,1045,8660,-14,21,12,9,1.004,1.841
2016/3/16,1145,8661,2,23,18,5,1.002,2.872
2016/3/16,1245,8684,21,28,2,26,0.999,3.191
2016/3/17,945,8768,14,133,51,82,0.989,0.351
2016/3/17,1045,8735,-33,52,56,-4,0.993,1.084
2016/3/17,1145,8714,-22,37,16,21,0.996,0.917
2016/3/17,1245,8690,-24,46,39,7,0.999,1.566
2016/3/17,1345,8698,8,27,10,17,0.999,1.171
2016/3/18,945,8775,50,68,-4,72,0.991,0.575
2016/3/18,1045,8758,-17,38,15,23,0.995,0.99
2016/3/18,1145,8756,-1,24,4,20,0.996,1.83
2016/3/18,1245,8762,6,17,3,14,0.996,3.302
2016/3/18,1345,8763,1,21,16,5,0.997,1.286
2016/3/21,945,8724,-74,120,86,34,1.002,0.511
2016/3/21,1045,8751,27,46,11,35,0.999,1.013
2016/3/21,1145,8740,-10,29,19,10,1,2.084
2016/3/21,1245,8758,17,23,2,21,0.998,2.961
2016/3/21,1345,8745,-12,22,26,-4,1.001,1.322
2016/3/22,945,8708,-67,94,62,32,1.005,0.471
2016/3/22,1045,8703,-5,36,18,18,1.005,1.022
2016/3/22,1145,8687,-16,32,28,4,1.006,1.486
2016/3/22,1245,8689,2,35,6,29,1.005,1.188
2016/3/22,1345,8752,63,62,2,60,0.997,0.782
2016/3/23,945,8747,-14,58,40,18,0.997,0.532
2016/3/23,1045,8700,-47,56,62,-6,1.003,0.777
2016/3/23,1145,8716,16,28,22,6,1.001,1.495
2016/3/23,1245,8724,9,29,11,18,1,2.186
2016/3/23,1345,8721,-2,26,12,14,0.999,1.401
2016/3/24,945,8677,-8,67,17,50,1.004,0.492
2016/3/24,1045,8724,47,76,27,49,0.998,0.671
2016/3/24,1145,8693,-30,29,36,-7,1.002,1.809
2016/3/24,1245,8719,26,24,4,20,0.999,3.188
2016/3/24,1345,8714,-6,16,12,4,1,1.718
2016/3/25,945,8711,-16,82,48,34,1,0.624
2016/3/25,1045,8701,-10,43,30,13,1,1.176
2016/3/25,1145,8690,-11,34,15,19,1.002,1.397
2016/3/25,1245,8699,10,23,9,14,1,3.269
2016/3/25,1345,8702,4,17,2,15,1,1.962
2016/3/28,945,8684,-36,72,41,31,1.002,0.585
2016/3/28,1045,8708,23,46,25,21,0.999,0.712
2016/3/28,1145,8701,-6,37,16,21,1,1.398
2016/3/28,1245,8692,-9,19,15,4,1.001,2.214
2016/3/28,1345,8683,-9,19,19,0,1.002,1.849
2016/3/29,945,8663,-19,42,34,8,1.004,0.514
2016/3/29,1045,8584,-79,103,94,9,1.012,0.456
2016/3/29,1145,8590,6,27,17,10,1.01,1.167
2016/3/29,1245,8585,-5,18,19,-1,1.01,2.42
2016/3/29,1345,8600,14,45,9,36,1.007,0.815
2016/3/30,945,8705,60,78,-1,79,0.994,0.502
2016/3/30,1045,8698,-7,30,17,13,0.995,1.23
2016/3/30,1145,8716,18,21,3,18,0.992,1.822
2016/3/30,1245,8733,17,37,14,23,0.991,1.484
2016/3/30,1345,8740,7,32,7,25,0.99,1.001
2016/3/31,945,8761,-23,63,54,9,0.989,0.526
2016/3/31,1045,8732,-29,52,39,13,0.994,0.834
2016/3/31,1145,8722,-11,52,21,31,0.996,1.052
2016/3/31,1245,8707,-15,23,17,6,1,3.013
2016/3/31,1345,8715,9,42,23,19,1,1.089
2016/4/1,945,8673,3,53,16,37,1.005,0.595
2016/4/1,1045,8635,-37,63,45,18,1.009,0.746
2016/4/1,1145,8609,-26,43,32,11,1.012,1.365
2016/4/1,1245,8611,2,23,13,10,1.01,2.859
2016/4/1,1345,8629,18,29,9,20,1.007,1.4
2016/4/6,945,8485,-106,125,105,20,1.021,0.463
2016/4/6,1045,8476,-9,40,21,19,1.019,1.058
2016/4/6,1145,8477,1,23,6,17,1.016,1.883
2016/4/6,1245,8478,1,23,19,4,1.013,2.351
2016/4/6,1345,8460,-18,32,25,7,1.013,1.306
2016/4/7,945,8461,-9,63,32,31,1.01,0.609
2016/4/7,1045,8385,-76,73,72,1,1.017,0.7
2016/4/7,1145,8402,15,26,5,21,1.012,1.825
2016/4/7,1245,8440,38,46,5,41,1.005,1.534
2016/4/7,1345,8438,-2,25,21,4,1.003,1.419
2016/4/8,945,8457,69,77,-5,82,0.998,0.579
2016/4/8,1045,8456,-2,36,32,4,0.998,0.938
2016/4/8,1145,8465,9,42,16,26,0.997,1.36
2016/4/8,1245,8491,26,39,9,30,0.994,1.595
2016/4/8,1345,8484,-8,18,11,7,0.995,1.551
2016/4/11,945,8478,22,60,-3,63,0.995,0.591
2016/4/11,1045,8495,18,38,1,37,0.993,1.032
2016/4/11,1145,8519,23,42,11,31,0.992,1.026
2016/4/11,1245,8524,5,19,4,15,0.993,3.239
2016/4/11,1345,8514,-10,18,14,4,0.995,1.527
2016/4/12,945,8566,25,92,18,74,0.99,0.492
2016/4/12,1045,8531,-35,55,36,19,0.996,0.852
2016/4/12,1145,8480,-50,53,49,4,1.003,0.972
2016/4/12,1245,8497,18,38,9,29,1.001,1.717
2016/4/12,1345,8495,-1,16,6,10,1.001,2.014
2016/4/13,945,8615,73,102,16,86,0.988,0.441
2016/4/13,1045,8623,7,23,12,11,0.989,1.015
2016/4/13,1145,8618,-5,18,15,3,0.991,2.202
2016/4/13,1245,8625,7,11,2,9,0.991,3.822
2016/4/13,1345,8638,12,22,6,16,0.991,0.985
2016/4/14,945,8661,-44,64,63,1,0.99,0.512
2016/4/14,1045,8664,5,28,9,19,0.991,1.197
2016/4/14,1145,8659,-5,20,18,2,0.993,2.253
2016/4/14,1245,8667,7,17,10,7,0.994,3.504
2016/4/14,1345,8661,-7,15,8,7,0.997,1.553
2016/4/15,945,8685,65,83,-11,94,0.995,0.459
2016/4/15,1045,8673,-12,35,24,11,0.997,0.888
2016/4/15,1145,8684,11,21,11,10,0.996,1.819
2016/4/15,1245,8698,15,30,6,24,0.996,1.947
2016/4/15,1345,8716,18,36,2,34,0.994,1.261
2016/4/18,945,8645,-6,54,39,15,1.002,0.518
2016/4/18,1045,8652,7,27,13,14,1.001,1.17
2016/4/18,1145,8657,6,21,8,13,1,1.935
2016/4/18,1245,8658,1,9,2,7,1,5.073
2016/4/18,1345,8645,-13,25,23,2,1.001,1.609
2016/4/19,945,8638,-62,103,110,-7,1.003,0.342
2016/4/19,1045,8642,5,33,21,12,1.002,0.994
2016/4/19,1145,8603,-39,48,50,-2,1.006,1.486
2016/4/19,1245,8626,23,25,3,22,1.003,2.18
2016/4/19,1345,8636,10,18,12,6,1.001,1.47
2016/4/20,945,8628,-29,55,56,-1,1.002,0.706
2016/4/20,1045,8566,-63,75,72,3,1.009,0.842
2016/4/20,1145,8518,-48,66,58,8,1.014,0.978
2016/4/20,1245,8530,12,32,0,32,1.01,2.332
2016/4/21,945,8486,-27,79,48,31,1.014,0.468
2016/4/21,1045,8517,30,38,3,35,1.008,0.818
2016/4/21,1145,8516,-1,21,9,12,1.007,1.414
2016/4/21,1245,8516,0,13,5,8,1.005,3.852
2016/4/21,1345,8530,14,29,5,24,1.002,1.551
2016/4/22,945,8515,2,61,33,28,1.003,0.553
2016/4/22,1045,8539,25,48,21,27,0.998,0.792
2016/4/22,1145,8486,-52,69,44,25,1.003,0.75
2016/4/22,1245,8507,21,37,2,35,1,2.115
2016/4/22,1345,8498,-9,14,9,5,1.001,1.861
2016/4/25,945,8502,-17,38,13,25,1.001,0.658
2016/4/25,1045,8519,17,43,21,22,0.999,0.819
2016/4/25,1145,8528,9,11,7,4,0.998,2.785
2016/4/25,1245,8526,-2,14,8,6,0.998,4.978
2016/4/25,1345,8527,1,15,4,11,0.998,1.977
2016/4/26,945,8607,74,96,12,84,0.989,0.459
2016/4/26,1045,8550,-57,79,57,22,0.997,0.637
2016/4/26,1145,8547,-4,20,8,12,0.997,2.082
2016/4/26,1245,8579,31,33,1,32,0.994,2.077
2016/4/26,1345,8573,-6,25,15,10,0.996,1.326
2016/4/27,945,8536,-24,63,33,30,1.001,0.489
2016/4/27,1045,8585,49,51,4,47,0.995,0.82
2016/4/27,1145,8563,-22,33,19,14,0.999,1.931
2016/4/27,1245,8566,5,19,9,10,0.999,3.15
2016/4/27,1345,8557,-8,16,11,5,1,1.696
2016/4/28,945,8538,-48,83,61,22,1.003,0.474
2016/4/28,1045,8485,-53,89,68,21,1.008,0.523
2016/4/28,1145,8421,-63,74,61,13,1.015,0.636
2016/4/28,1245,8432,12,30,9,21,1.012,1.807
2016/4/28,1345,8417,-14,22,16,6,1.013,1.132
2016/4/29,945,8327,-48,69,68,1,1.021,0.505
2016/4/29,1045,8327,0,37,13,24,1.019,1.15
2016/4/29,1145,8324,-3,19,10,9,1.016,3.19
2016/4/29,1245,8322,-2,11,10,1,1.013,4.804
2016/4/29,1345,8309,-13,35,36,-1,1.012,1.444
2016/5/3,945,8248,-71,102,82,20,1.016,0.591
2016/5/3,1045,8262,13,65,23,42,1.011,0.863
2016/5/3,1145,8269,7,17,6,11,1.008,3.218
2016/5/3,1245,8264,-5,24,20,4,1.006,2.808
2016/5/3,1345,8259,-6,18,7,11,1.005,1.612
2016/5/4,945,8241,3,41,16,25,1.005,0.505
2016/5/4,1045,8180,-62,61,61,0,1.012,0.589
2016/5/4,1145,8170,-10,26,14,12,1.011,1.074
2016/5/4,1245,8130,-41,37,47,-10,1.014,1.837
2016/5/4,1345,8177,47,84,12,72,1.006,0.671
2016/5/5,945,8138,-22,59,43,16,1.009,0.618
2016/5/5,1045,8129,-9,40,25,15,1.009,1.063
2016/5/5,1145,8110,-19,38,23,15,1.01,1.224
2016/5/5,1245,8144,33,49,14,35,1.003,1.696
2016/5/5,1345,8142,-3,35,33,2,1.002,1.326
2016/5/6,945,8110,-8,62,22,40,1.005,0.616
2016/5/6,1045,8117,9,79,23,56,1.002,0.821
2016/5/6,1145,8101,-16,36,20,16,1.003,1.595
2016/5/6,1245,8109,6,27,14,13,1.002,2.743
2016/5/6,1345,8102,-7,19,23,-4,1.002,1.949
2016/5/9,945,8103,-38,58,57,1,1.002,0.58
2016/5/9,1045,8108,6,55,12,43,1.001,0.76
2016/5/9,1145,8111,3,25,17,8,1,2.063
2016/5/9,1245,8107,-3,18,19,-1,1.001,4.185
2016/5/9,1345,8114,6,28,7,21,0.999,1.506
2016/5/10,945,8097,-19,57,17,40,1.001,0.467
2016/5/10,1045,8156,59,83,24,59,0.994,0.547
2016/5/10,1145,8148,-8,40,13,27,0.995,1.254
2016/5/10,1245,8167,19,22,-2,24,0.994,2.58
2016/5/10,1345,8153,-14,17,13,4,0.996,1.765
2016/5/11,945,8106,-71,85,86,-1,1.002,0.471
2016/5/11,1045,8125,19,47,3,44,1,0.701
2016/5/11,1145,8131,7,30,9,21,0.999,1.558
2016/5/11,1245,8122,-9,17,10,7,1.001,3.38
2016/5/11,1345,8125,3,11,3,8,1.001,1.875
2016/5/12,945,8113,17,72,42,30,1.002,0.521
2016/5/12,1045,8112,-2,35,20,15,1.002,1.035
2016/5/12,1145,8116,4,62,12,50,1.001,1.028
2016/5/12,1245,8107,-9,18,11,7,1.002,3.645
2016/5/12,1345,8084,-25,30,30,0,1.004,1.932
2016/5/13,945,8047,-20,65,24,41,1.007,0.483
2016/5/13,1045,7992,-54,59,57,2,1.013,0.716
2016/5/13,1145,7976,-16,45,22,23,1.014,0.939
2016/5/13,1245,8006,31,40,4,36,1.008,1.702
2016/5/13,1345,8019,13,36,11,25,1.005,1.266
2016/5/16,945,8028,7,62,22,40,1.003,0.579
2016/5/16,1045,8058,29,50,7,43,0.998,1.08
2016/5/16,1145,8064,7,31,21,10,0.997,1.52
2016/5/16,1245,8070,5,18,11,7,0.995,4.051
2016/5/16,1345,8062,-8,16,10,6,0.996,1.796
2016/5/17,945,8047,-29,58,46,12,0.998,0.629
2016/5/17,1045,8059,13,45,6,39,0.996,0.852
2016/5/17,1145,8122,63,88,4,84,0.989,0.892
2016/5/17,1245,8142,20,27,1,26,0.989,1.198
2016/5/17,1345,8150,8,24,2,22,0.99,1.232
2016/5/18,945,8094,1,58,20,38,0.997,0.81
2016/5/18,1045,8137,43,57,6,51,0.993,1.317
2016/5/18,1145,8132,-5,21,7,14,0.994,2.612
2016/5/18,1245,8134,2,15,4,11,0.995,4.343
2016/5/19,945,8028,-90,112,125,-13,1.009,0.44
2016/5/19,1045,8052,21,50,4,46,1.005,0.674
2016/5/19,1145,8042,-10,19,12,7,1.006,2.057
2016/5/19,1245,8030,-13,22,13,9,1.008,2.138
2016/5/19,1345,8034,4,31,24,7,1.006,1.096
2016/5/20,945,8062,27,102,63,39,1.001,0.428
2016/5/20,1045,8100,37,49,13,36,0.996,0.784
2016/5/20,1145,8102,2,55,18,37,0.996,0.75
2016/5/20,1245,8107,5,18,7,11,0.995,3.876
2016/5/20,1345,8104,-3,21,5,16,0.995,2.041
2016/5/23,945,8187,66,137,1,136,0.985,0.429
2016/5/23,1045,8275,88,100,18,82,0.976,0.59
2016/5/23,1145,8328,53,60,-2,62,0.973,1.267
2016/5/23,1245,8343,15,32,12,20,0.975,1.614
2016/5/23,1345,8346,2,27,4,23,0.978,1.334
2016/5/24,945,8302,-27,55,43,12,0.987,0.77
2016/5/24,1045,8297,-4,35,30,5,0.99,1.674
2016/5/24,1145,8299,2,21,12,9,0.992,2.984
2016/5/24,1245,8301,1,10,3,7,0.994,4.919
2016/5/24,1345,8283,-19,28,21,7,0.999,1.923
2016/5/25,945,8361,20,61,32,29,0.992,0.485
2016/5/25,1045,8367,6,23,8,15,0.994,1.474
2016/5/25,1145,8400,34,51,12,39,0.991,1.045
2016/5/25,1245,8389,-11,25,18,7,0.993,2.211
2016/5/25,1345,8385,-5,19,10,9,0.994,1.308
2016/5/26,945,8388,-13,38,20,18,0.994,0.629
2016/5/26,1045,8368,-19,35,19,16,0.998,0.851
2016/5/26,1145,8374,6,22,13,9,0.998,1.955
2016/5/26,1245,8386,12,11,1,10,0.997,4.917
2016/5/26,1345,8385,-1,17,14,3,0.999,2.028
2016/5/27,945,8423,7,78,45,33,0.995,0.389
2016/5/27,1045,8415,-8,26,17,9,0.997,1.349
2016/5/27,1145,8416,1,13,10,3,0.997,3.072
2016/5/27,1245,8433,17,24,9,15,0.995,1.712
2016/5/27,1345,8462,28,33,5,28,0.992,1.031
2016/5/30,945,8478,-3,47,2,45,0.991,0.509
2016/5/30,1045,8472,-6,45,25,20,0.993,0.759
2016/5/30,1145,8487,14,31,13,18,0.993,1.476
2016/5/30,1245,8491,5,19,4,15,0.994,2.722
2016/5/30,1345,8508,16,42,25,17,0.993,0.701
2016/5/31,945,8539,40,58,3,55,0.99,0.595
2016/5/31,1045,8463,-75,86,82,4,1,0.586
2016/5/31,1145,8498,36,53,10,43,0.997,1.345
2016/5/31,1245,8490,-8,21,13,8,0.999,2.941
2016/5/31,1345,8515,26,37,5,32,0.997,0.92
2016/6/1,945,8525,35,62,24,38,0.995,0.549
2016/6/1,1045,8576,51,63,12,51,0.99,0.658
2016/6/1,1145,8576,0,18,5,13,0.991,2.422
2016/6/1,1245,8581,5,16,9,7,0.992,2.41
2016/6/1,1345,8563,-18,32,26,6,0.995,1.178
2016/6/2,945,8580,12,47,19,28,0.994,0.659
2016/6/2,1045,8541,-38,69,69,0,0.999,0.65
2016/6/2,1145,8545,4,40,13,27,0.999,1.135
2016/6/2,1245,8555,10,23,5,18,0.999,2.533
2016/6/2,1345,8552,-3,31,12,19,1,1.625
2016/6/3,945,8576,15,42,9,33,0.998,0.757
2016/6/3,1045,8553,-23,41,25,16,1.001,0.905
2016/6/3,1145,8554,1,21,7,14,1.001,2.333
2016/6/3,1245,8563,9,16,6,10,0.999,2.654
2016/6/3,1345,8566,3,15,4,11,0.999,1.59
2016/6/4,945,8566,0,10,4,6,0.999,1.927
2016/6/4,1045,8578,12,19,7,12,0.997,1.964
2016/6/4,1145,8583,6,17,7,10,0.997,3.603
2016/6/4,1245,8579,-4,10,6,4,0.998,5.112
2016/6/4,1345,8576,-3,9,7,2,0.999,2.354
2016/6/6,945,8585,10,85,70,15,0.998,0.253
2016/6/6,1045,8520,-64,93,80,13,1.005,0.409
2016/6/6,1145,8541,20,29,9,20,1.003,1.252
2016/6/6,1245,8558,17,24,7,17,1,1.681
2016/6/6,1345,8575,17,25,8,17,0.998,0.987
2016/6/7,945,8662,48,59,3,56,0.989,0.402
2016/6/7,1045,8665,2,44,19,25,0.99,0.797
2016/6/7,1145,8665,1,32,4,28,0.991,1.464
2016/6/7,1245,8668,3,11,7,4,0.991,2.755
2016/6/7,1345,8666,-3,15,9,6,0.993,1.355
2016/6/8,945,8718,45,64,24,40,0.988,0.492
2016/6/8,1045,8706,-12,48,26,22,0.991,0.843
2016/6/8,1145,8713,7,35,2,33,0.992,1.278
2016/6/8,1245,8697,-16,24,25,-1,0.996,2.284
2016/6/8,1345,8718,21,21,-9,30,0.995,1.442
2016/6/13,945,8542,-93,108,89,19,1.016,0.424
2016/6/13,1045,8541,-1,30,19,11,1.014,1.126
2016/6/13,1145,8540,-1,20,10,10,1.013,1.819
2016/6/13,1245,8509,-31,43,38,5,1.015,1.372
2016/6/13,1345,8525,17,26,3,23,1.012,1.052
2016/6/14,945,8529,34,63,17,46,1.009,0.574
2016/6/14,1045,8545,14,30,12,18,1.005,1.306
2016/6/14,1145,8561,15,24,5,19,1.001,2.076
2016/6/14,1245,8567,5,10,0,10,0.999,3.975
2016/6/14,1345,8575,8,12,3,9,0.996,1.547
2016/6/15,945,8536,-16,90,62,28,1,0.526
2016/6/15,1045,8563,27,49,17,32,0.997,1.244
2016/6/15,1145,8575,12,22,13,9,0.995,2.75
2016/6/15,1245,8596,21,31,11,20,0.993,2.132
2016/6/16,945,8358,-52,267,247,20,1.021,0.408
2016/6/16,1045,8280,-77,85,81,4,1.028,0.491
2016/6/16,1145,8291,13,48,4,44,1.024,0.93
2016/6/16,1245,8268,-24,30,30,0,1.024,1.964
2016/6/16,1345,8283,16,35,9,26,1.018,1.029
2016/6/17,945,8425,77,77,2,75,0.999,0.475
2016/6/17,1045,8421,-4,23,10,13,0.998,1.233
2016/6/17,1145,8397,-23,32,25,7,0.999,2.157
2016/6/17,1245,8395,-2,20,5,15,0.997,2.256
2016/6/17,1345,8395,1,22,4,18,0.995,1.724
2016/6/20,945,8479,-24,83,37,46,0.986,0.549
2016/6/20,1045,8467,-12,36,15,21,0.989,1.207
2016/6/20,1145,8456,-12,40,12,28,0.993,1.718
2016/6/20,1245,8459,3,16,5,11,0.994,3.259
2016/6/20,1345,8469,9,19,1,18,0.995,1.748
2016/6/21,945,8498,39,60,-3,63,0.993,0.57
2016/6/21,1045,8504,6,31,21,10,0.994,0.752
2016/6/21,1145,8506,3,16,1,15,0.994,2.411
2016/6/21,1245,8507,1,10,6,4,0.995,3.439
2016/6/21,1345,8510,3,13,4,9,0.996,1.383
2016/6/22,945,8475,-35,45,40,5,1.001,0.496
2016/6/22,1045,8493,18,34,1,33,0.998,0.823
2016/6/22,1145,8505,13,34,25,9,0.997,0.802
2016/6/22,1245,8515,10,13,4,9,0.997,3.379
2016/6/22,1345,8509,-6,14,8,6,0.998,1.392
2016/6/23,945,8498,-17,41,28,13,1,0.662
2016/6/23,1045,8487,-12,34,14,20,1.001,0.849
2016/6/23,1145,8498,11,25,12,13,1,1.509
2016/6/23,1245,8497,-1,9,4,5,1,5.548
2016/6/23,1345,8510,13,18,2,16,0.998,1.891
2016/6/24,945,8521,21,206,15,191,0.997,0.23
2016/6/24,1045,8306,-216,224,218,6,1.023,0.399
2016/6/24,1145,8227,-80,122,136,-14,1.031,0.589
2016/6/24,1245,8220,-5,112,32,80,1.028,0.817
2016/6/24,1345,8237,18,65,12,53,1.023,1.181
2016/6/27,945,8305,55,74,8,66,1.011,0.794
2016/6/27,1045,8314,10,36,13,23,1.008,1.8
2016/6/27,1145,8329,14,28,10,18,1.004,3.051
2016/6/27,1245,8323,-5,21,13,8,1.002,4.708
2016/6/27,1345,8325,0,15,9,6,1,3.304
2016/6/28,945,8340,66,84,4,80,0.996,0.759
2016/6/28,1045,8345,5,25,11,14,0.993,1.461
2016/6/28,1145,8380,34,41,7,34,0.989,1.315
2016/6/28,1245,8379,-1,11,6,5,0.991,3.396
2016/6/28,1345,8376,-3,20,10,10,0.993,1.286
2016/6/29,945,8489,97,95,-2,97,0.982,0.466
2016/6/29,1045,8449,-40,83,44,39,0.989,0.63
2016/6/29,1145,8463,15,24,7,17,0.989,1.64
2016/6/29,1245,8459,-4,18,6,12,0.991,3.817
2016/6/29,1345,8436,-23,33,27,6,0.995,1.516
2016/6/30,945,8468,-24,68,40,28,0.994,0.508
2016/6/30,1045,8515,48,69,13,56,0.99,0.619
2016/6/30,1145,8524,8,26,18,8,0.991,1.467
2016/6/30,1245,8539,16,16,1,15,0.991,3.357
2016/6/30,1345,8518,-21,31,21,10,0.995,1.087
2016/7/1,945,8621,53,81,11,70,0.985,0.506
2016/7/1,1045,8611,-9,40,8,32,0.988,1.058
2016/7/1,1145,8630,20,26,8,18,0.987,1.905
2016/7/1,1245,8626,-5,16,10,6,0.99,3.301
2016/7/1,1345,8626,0,23,5,18,0.992,1.458
2016/7/4,945,8661,25,57,-6,63,0.989,0.607
2016/7/4,1045,8656,-4,38,23,15,0.992,0.786
2016/7/4,1145,8655,-1,21,13,8,0.994,2.303
2016/7/4,1245,8635,-20,34,21,13,0.998,1.488
2016/7/4,1345,8630,-5,13,10,3,0.999,1.932
2016/7/5,945,8606,6,58,19,39,1.003,0.464
2016/7/5,1045,8620,14,28,15,13,1.001,0.968
2016/7/5,1145,8622,1,22,2,20,1.001,2.345
2016/7/5,1245,8615,-7,10,7,3,1.001,5.308
2016/7/5,1345,8609,-6,11,7,4,1.002,2.118
2016/7/6,945,8456,-96,108,103,5,1.019,0.314
2016/7/6,1045,8456,-1,32,19,13,1.017,0.804
2016/7/6,1145,8458,2,22,15,7,1.014,1.428
2016/7/6,1245,8451,-7,17,14,3,1.013,2.631
2016/7/6,1345,8468,17,27,4,23,1.008,0.943
2016/7/7,945,8547,39,57,24,33,0.998,0.493
2016/7/7,1045,8547,0,22,9,13,0.997,1.734
2016/7/7,1145,8549,1,11,6,5,0.996,2.955
2016/7/7,1245,8554,4,11,5,6,0.995,4.696
2016/7/7,1345,8562,8,15,1,14,0.993,2.001
2016/7/11,945,8736,53,68,12,56,0.975,0.386
2016/7/11,1045,8732,-4,35,4,31,0.979,1.068
2016/7/11,1145,8728,-4,19,10,9,0.982,2.294
2016/7/11,1245,8723,-5,8,5,3,0.986,4.929
2016/7/11,1345,8736,13,16,-2,18,0.987,1.318
2016/7/12,945,8790,39,53,-1,54,0.984,0.473
2016/7/12,1045,8778,-12,34,17,17,0.988,0.944
2016/7/12,1145,8786,8,14,5,9,0.99,1.818
2016/7/12,1245,8782,-3,13,8,5,0.993,3.012
2016/7/12,1345,8777,-6,15,7,8,0.996,1.183
2016/7/13,945,8795,-30,84,42,42,0.996,0.357
2016/7/13,1045,8742,-53,73,57,16,1.003,0.638
2016/7/13,1145,8778,36,50,7,43,0.999,1.135
2016/7/13,1245,8789,10,20,6,14,0.998,1.737
2016/7/13,1345,8793,4,11,7,4,0.998,1.538
2016/7/14,945,8818,18,60,11,49,0.996,0.535
2016/7/14,1045,8826,9,34,13,21,0.995,1.063
2016/7/14,1145,8833,8,18,8,10,0.995,2.571
2016/7/14,1245,8814,-19,21,21,0,0.998,2.578
2016/7/14,1345,8813,-1,26,7,19,0.998,1.322
2016/7/15,945,8892,46,74,5,69,0.99,0.458
2016/7/15,1045,8911,19,35,8,27,0.989,0.865
2016/7/15,1145,8913,2,14,3,11,0.99,2.996
2016/7/15,1245,8910,-3,18,15,3,0.992,2.118
2016/7/15,1345,8911,1,25,9,16,0.993,0.937
2016/7/18,945,8999,81,84,-1,85,0.985,0.495
2016/7/18,1045,8988,-11,22,6,16,0.988,1.158
2016/7/18,1145,8994,6,14,5,9,0.989,2.645
2016/7/18,1245,8991,-4,16,6,10,0.991,3.122
2016/7/18,1345,8998,7,18,3,15,0.993,1.3
2016/7/19,945,8997,-23,72,37,35,0.995,0.437
2016/7/19,1045,9015,18,39,1,38,0.994,1.021
2016/7/19,1145,9012,-3,29,20,9,0.995,1.317
2016/7/19,1245,9008,-4,15,8,7,0.997,3.239
2016/7/19,1345,9033,24,24,0,24,0.995,1.523
2016/7/20,945,9034,24,48,-1,49,0.996,0.606
2016/7/20,1045,8997,-37,54,45,9,1.001,0.916
2016/7/20,1145,9001,4,27,-2,29,1,1.324
2016/7/20,1245,8998,-3,23,5,18,1.001,2.764
2016/7/21,945,8995,73,92,19,73,1,0.397
2016/7/21,1045,8997,2,20,9,11,1,0.99
2016/7/21,1145,9004,6,17,5,12,0.999,1.907
2016/7/21,1245,8995,-9,16,13,3,1,2.345
2016/7/21,1345,8984,-10,28,10,18,1.001,0.969
2016/7/22,945,8958,-7,56,26,30,1.003,0.512
2016/7/22,1045,8965,7,33,14,19,1.002,1.092
2016/7/22,1145,8948,-17,29,19,10,1.003,1.88
2016/7/22,1245,8951,3,15,4,11,1.002,2.924
2016/7/22,1345,8925,-27,27,28,-1,1.005,1.643
2016/7/25,945,8871,-96,143,156,-13,1.011,0.328
2016/7/25,1045,8862,-9,69,10,59,1.011,0.622
2016/7/25,1145,8839,-23,36,31,5,1.012,1.787
2016/7/25,1245,8836,-3,17,14,3,1.01,4.002
2016/7/25,1345,8891,55,68,12,56,1.002,0.91
2016/7/26,945,8919,48,66,9,57,0.998,0.509
2016/7/26,1045,8916,-3,40,23,17,0.998,1.049
2016/7/26,1145,8928,13,18,5,13,0.996,2.738
2016/7/26,1245,8926,-3,17,9,8,0.996,3.711
2016/7/26,1345,8965,40,46,0,46,0.992,1.515
2016/7/27,945,9019,3,71,25,46,0.986,0.458
2016/7/27,1045,9008,-11,31,8,23,0.989,1.39
2016/7/27,1145,8976,-31,58,49,9,0.994,0.972
2016/7/27,1245,8980,4,40,12,28,0.995,1.413
2016/7/27,1345,8976,-5,23,19,4,0.997,1.267
2016/7/28,945,9006,24,84,4,80,0.995,0.485
2016/7/28,1045,9025,19,34,-6,40,0.994,1.193
2016/7/28,1145,9004,-21,23,15,8,0.998,1.93
2016/7/28,1245,9003,-1,23,0,23,0.999,1.945
2016/7/28,1345,8981,-23,27,26,1,1.002,1.619
2016/7/29,945,8981,-22,63,33,30,1.002,0.536
2016/7/29,1045,8970,-11,63,25,38,1.002,0.761
2016/7/29,1145,8947,-23,38,31,7,1.005,1.718
2016/7/29,1245,8933,-13,35,24,11,1.006,1.101
2016/7/29,1345,8893,-40,68,64,4,1.01,0.928
2016/8/1,945,9002,62,89,23,66,0.997,0.519
2016/8/1,1045,9018,16,23,9,14,0.995,1.234
2016/8/1,1145,9022,4,19,11,8,0.995,2.219
2016/8/1,1245,9017,-5,19,7,12,0.996,3.135
2016/8/1,1345,9041,24,34,-1,35,0.993,1.173
2016/8/2,945,9017,3,42,18,24,0.996,0.719
2016/8/2,1045,9011,-6,24,18,6,0.997,1.253
2016/8/2,1145,9014,3,16,5,11,0.997,2.951
2016/8/2,1245,9011,-3,10,5,5,0.998,4.921
2016/8/2,1345,9015,5,23,13,10,0.999,1.246
2016/8/3,945,8943,29,87,5,82,1.006,0.314
2016/8/3,1045,8951,8,40,21,19,1.005,0.709
2016/8/3,1145,8951,0,15,11,4,1.004,2.763
2016/8/3,1245,8946,-4,15,9,6,1.004,2.266
2016/8/3,1345,8933,-14,21,16,5,1.004,1.276
2016/8/4,945,8920,-70,73,72,1,1.006,0.487
2016/8/4,1045,8933,13,50,8,42,1.003,0.708
2016/8/4,1145,8944,11,26,9,17,1.001,1.943
2016/8/4,1245,8955,10,20,4,16,0.999,3.305
2016/8/4,1345,8971,16,17,1,16,0.997,1.44
2016/8/5,945,9063,67,87,-3,90,0.987,0.403
2016/8/5,1045,9065,2,21,9,12,0.988,1.098
2016/8/5,1145,9059,-6,25,10,15,0.99,2.194
2016/8/5,1245,9059,1,10,6,4,0.992,4.958
2016/8/5,1345,9063,5,18,0,18,0.992,1.112
2016/8/8,945,9090,-43,71,58,13,0.991,0.485
2016/8/8,1045,9089,-1,42,16,26,0.993,0.958
2016/8/8,1145,9085,-3,14,10,4,0.995,3.167
2016/8/8,1245,9092,7,12,3,9,0.996,3.961
2016/8/8,1345,9116,24,32,5,27,0.995,1.104
2016/8/9,945,9135,13,44,5,39,0.994,0.54
2016/8/9,1045,9123,-12,27,22,5,0.996,1.073
2016/8/9,1145,9120,-3,22,10,12,0.997,1.801
2016/8/9,1245,9123,4,18,4,14,0.997,2.867
2016/8/9,1345,9118,-5,24,22,2,0.999,1.241
2016/8/10,945,9110,-26,62,42,20,1,0.403
2016/8/10,1045,9128,19,22,4,18,0.998,1.066
2016/8/10,1145,9145,17,22,5,17,0.996,1.314
2016/8/10,1245,9158,12,31,9,22,0.996,1.265
2016/8/10,1345,9145,-11,20,22,-2,0.998,0.985
2016/8/11,945,9152,27,41,-2,43,0.997,0.638
2016/8/11,1045,9046,-106,94,113,-19,1.009,0.562
2016/8/11,1145,9063,19,71,9,62,1.006,0.653
2016/8/11,1245,9065,2,22,15,7,1.005,2.268
2016/8/11,1345,9085,20,32,9,23,1.003,1.176
2016/8/12,945,9128,-1,42,21,21,0.998,0.594
2016/8/12,1045,9124,-4,31,9,22,0.998,1.146
2016/8/12,1145,9141,17,25,4,21,0.996,1.85
2016/8/12,1245,9135,-6,10,5,5,0.997,3.621
2016/8/12,1345,9130,-4,12,9,3,0.997,2.102
2016/8/15,945,9146,-1,74,15,59,0.996,0.561
2016/8/15,1045,9115,-31,48,38,10,0.999,0.887
2016/8/15,1145,9124,9,16,3,13,0.999,2.063
2016/8/15,1245,9122,-2,13,10,3,1,3.613
2016/8/15,1345,9125,4,11,4,7,1,1.792
2016/8/16,945,9130,-25,41,25,16,1,0.525
2016/8/16,1045,9091,-38,73,44,29,1.004,0.469
2016/8/16,1145,9091,-1,19,14,5,1.004,1.658
2016/8/16,1245,9087,-3,44,9,35,1.004,1.237
2016/8/16,1345,9088,1,24,19,5,1.003,1.229
2016/8/17,945,9096,23,34,12,22,1.001,0.941
2016/8/17,1045,9070,-27,35,33,2,1.004,1.411
2016/8/17,1145,9091,21,25,5,20,1.001,2.309
2016/8/17,1245,9088,-3,11,9,2,1.001,4.31
2016/8/18,945,9024,14,133,99,34,1.007,0.426
2016/8/18,1045,9048,23,38,11,27,1.003,0.871
2016/8/18,1145,9046,-1,14,10,4,1.002,2.004
2016/8/18,1245,9042,-5,8,7,1,1.002,2.867
2016/8/18,1345,9042,0,13,4,9,1.001,1.222
2016/8/19,945,9072,22,55,37,18,0.998,0.458
2016/8/19,1045,8977,-95,115,94,21,1.008,0.359
2016/8/19,1145,8996,18,37,2,35,1.005,1.386
2016/8/19,1245,8983,-13,32,15,17,1.005,2.097
2016/8/19,1345,8946,-36,47,43,4,1.008,1.157
2016/8/22,945,8892,-49,79,57,22,1.014,0.513
2016/8/22,1045,8871,-21,60,49,11,1.015,0.926
2016/8/22,1145,8877,7,29,5,24,1.012,1.643
2016/8/22,1245,8890,13,22,5,17,1.008,2.6
2016/8/22,1345,8892,2,21,13,8,1.007,1.696
2016/8/23,945,8959,38,36,-11,47,0.998,0.832
2016/8/23,1045,8956,-3,21,12,9,0.997,1.066
2016/8/23,1145,8968,11,18,7,11,0.995,1.826
2016/8/23,1245,8985,17,21,3,18,0.993,1.933
2016/8/23,1345,8984,0,14,1,13,0.993,1.265
2016/8/24,945,8969,-33,59,38,21,0.995,0.494
2016/8/24,1045,8955,-13,27,30,-3,0.998,1.133
2016/8/24,1145,8975,19,20,7,13,0.997,1.806
2016/8/24,1245,8975,0,9,6,3,0.998,4.747
2016/8/24,1345,8956,-19,28,24,4,1.001,1.424
2016/8/25,945,9018,76,84,15,69,0.994,0.383
2016/8/25,1045,9050,32,39,-1,40,0.991,0.824
2016/8/25,1145,9050,0,17,8,9,0.992,1.724
2016/8/25,1245,9047,-2,10,7,3,0.993,4.074
2016/8/25,1345,9072,24,34,1,33,0.991,0.937
2016/8/26,945,9068,13,49,17,32,0.992,0.583
2016/8/26,1045,9087,19,35,3,32,0.991,1.02
2016/8/26,1145,9072,-14,18,16,2,0.994,2.263
2016/8/26,1245,9072,-1,8,5,3,0.996,5.035
2016/8/26,1345,9080,7,12,2,10,0.996,1.719
2016/8/29,945,8953,-92,107,122,-15,1.011,0.341
2016/8/29,1045,8998,45,36,-5,41,1.005,0.811
2016/8/29,1145,9023,26,32,4,28,1.002,1.029
2016/8/29,1245,9021,-2,11,11,0,1.002,2.689
2016/8/29,1345,9042,21,26,2,24,0.999,1.293
2016/8/30,945,9053,-22,43,32,11,0.998,0.558
2016/8/30,1045,9037,-15,25,18,7,1,1.144
2016/8/30,1145,9037,0,22,11,11,0.999,1.878
2016/8/30,1245,9031,-6,9,7,2,1,3.701
2016/8/30,1345,9036,4,32,17,15,0.999,0.981
2016/8/31,945,8977,-41,101,83,18,1.005,0.382
2016/8/31,1045,9027,49,60,10,50,1,0.759
2016/8/31,1145,9025,-3,17,8,9,1,2.888
2016/8/31,1245,9022,-3,8,5,3,1,5.267
2016/8/31,1345,8976,-46,62,54,8,1.006,0.708
2016/9/1,945,8917,-54,86,63,23,1.011,0.409
2016/9/1,1045,8927,10,56,12,44,1.008,0.899
2016/9/1,1145,8932,6,35,5,30,1.007,2.007
2016/9/1,1245,8937,6,22,11,11,1.005,2.345
2016/9/1,1345,8941,3,23,17,6,1.003,1.425
2016/9/2,945,8953,5,43,20,23,1.001,0.676
2016/9/2,1045,8931,-23,50,23,27,1.003,0.702
2016/9/2,1145,8942,10,34,10,24,1.001,2.078
2016/9/2,1245,8934,-9,21,9,12,1.001,3.258
2016/9/2,1345,8931,-3,11,8,3,1,2.528
2016/9/5,945,9047,47,48,8,40,0.988,0.463
2016/9/5,1045,9040,-7,15,5,10,0.99,1.889
2016/9/5,1145,9056,16,19,4,15,0.99,1.893
2016/9/5,1245,9065,9,13,-1,14,0.99,2.826
2016/9/5,1345,9062,-4,10,3,7,0.992,1.345
2016/9/6,945,9125,52,56,-6,62,0.986,0.551
2016/9/6,1045,9123,-2,21,7,14,0.988,1.088
2016/9/6,1145,9148,25,31,3,28,0.988,1.278
2016/9/6,1245,9138,-11,15,11,4,0.991,2.008
2016/9/6,1345,9150,12,30,10,20,0.992,0.916
2016/9/7,945,9221,65,90,26,64,0.986,0.36
2016/9/7,1045,9237,15,23,7,16,0.986,1.223
2016/9/7,1145,9253,16,28,5,23,0.987,1.258
2016/9/7,1245,9257,4,14,4,10,0.988,2.616
2016/9/7,1345,9253,-5,15,6,9,0.991,1.066
2016/9/8,945,9250,-1,38,3,35,0.993,0.615
2016/9/8,1045,9239,-11,22,9,13,0.996,1.463
2016/9/8,1145,9245,6,16,5,11,0.996,2.693
2016/9/8,1245,9239,-6,12,7,5,0.998,4.002
2016/9/8,1345,9239,0,10,9,1,0.999,1.834
2016/9/9,945,9130,-52,52,48,4,1.011,0.331
2016/9/9,1045,9131,0,31,13,18,1.01,0.834
2016/9/9,1145,9140,9,30,10,20,1.008,1.389
2016/9/9,1245,9134,-5,16,2,14,1.007,2.237
2016/9/9,1345,9127,-6,13,9,4,1.007,1.299
2016/9/10,945,8973,43,68,26,42,1.021,0.535
2016/9/10,1045,8973,1,22,9,13,1.017,1.999
2016/9/10,1145,8983,10,20,3,17,1.013,3.784
2016/9/10,1245,8995,12,25,6,19,1.009,3.551
2016/9/10,1345,8953,-43,44,45,-1,1.011,1.388
2016/9/12,945,8932,-58,77,57,20,1.011,0.31
2016/9/12,1045,8923,-9,34,26,8,1.01,0.799
2016/9/12,1145,8943,20,26,0,26,1.006,1.634
2016/9/12,1245,8925,-18,22,19,3,1.005,1.94
2016/9/12,1345,8899,-27,38,37,1,1.006,0.855
2016/9/13,945,8932,-42,51,38,13,1.003,0.508
2016/9/13,1045,8911,-20,118,23,95,1.005,0.396
2016/9/13,1145,8909,-2,53,23,30,1.004,1.004
2016/9/13,1245,8892,-16,30,18,12,1.005,2.129
2016/9/13,1345,8906,15,22,4,18,1.003,1.765
2016/9/14,945,8912,46,88,30,58,1,0.554
2016/9/14,1045,8897,-16,52,32,20,1.002,1.079
2016/9/14,1145,8895,-2,17,11,6,1.002,3.286
2016/9/14,1245,8881,-14,29,18,11,1.003,2.11
2016/9/14,1345,8874,-8,26,23,3,1.003,1.432
2016/9/19,945,9089,140,119,1,118,0.979,0.533
2016/9/19,1045,9095,6,22,3,19,0.98,1.538
2016/9/19,1145,9137,42,51,10,41,0.978,1.21
2016/9/19,1245,9143,6,19,2,17,0.98,2.762
2016/9/19,1345,9151,8,33,7,26,0.982,0.984
2016/9/20,945,9146,4,49,18,31,0.985,0.666
2016/9/20,1045,9137,-9,28,4,24,0.989,1.121
2016/9/20,1145,9146,10,19,6,13,0.99,2.199
2016/9/20,1245,9148,2,10,6,4,0.993,4.079
2016/9/20,1345,9141,-8,12,9,3,0.996,2.293
2016/9/21,945,9137,8,45,23,22,0.999,0.728
2016/9/21,1045,9151,15,21,2,19,0.998,2.31
2016/9/21,1145,9169,19,26,5,21,0.996,1.156
2016/9/21,1245,9192,23,37,8,29,0.994,1.471
2016/9/22,945,9170,-51,95,92,3,0.998,0.264
2016/9/22,1045,9199,29,43,-2,45,0.995,0.838
2016/9/22,1145,9181,-18,19,15,4,0.997,2.278
2016/9/22,1245,9179,-1,13,4,9,0.998,3.529
2016/9/22,1345,9188,9,15,7,8,0.997,1.371
2016/9/23,945,9213,-21,47,23,24,0.996,0.532
2016/9/23,1045,9223,9,26,17,9,0.995,1.211
2016/9/23,1145,9234,11,20,2,18,0.995,2.844
2016/9/23,1245,9234,0,9,3,6,0.996,4.286
2016/9/23,1345,9236,2,15,12,3,0.997,1.371
2016/9/26,945,9171,-51,66,50,16,1.004,0.419
2016/9/26,1045,9172,1,32,10,22,1.004,0.932
2016/9/26,1145,9173,1,11,4,7,1.003,3.439
2016/9/26,1245,9160,-13,22,13,9,1.004,2.382
2016/9/26,1345,9154,-7,17,11,6,1.005,1.235
2016/10/3,945,9176,-29,69,54,15,1.002,0.339
2016/10/3,1045,9183,6,20,9,11,1.001,1.394
2016/10/3,1145,9197,12,22,3,19,0.999,2.102
2016/10/3,1245,9194,-3,12,8,4,0.999,4.459
2016/10/3,1345,9194,0,15,7,8,0.999,1.943
2016/10/4,945,9224,22,52,15,37,0.995,0.432
2016/10/4,1045,9241,15,24,4,20,0.994,1.163
2016/10/4,1145,9248,7,10,4,6,0.994,1.974
2016/10/4,1245,9238,-10,19,11,8,0.996,2.305
2016/10/4,1345,9247,10,24,12,12,0.996,1.278
2016/10/5,945,9243,33,37,1,36,0.996,0.527
2016/10/5,1045,9253,10,28,9,19,0.996,0.918
2016/10/5,1145,9256,2,18,10,8,0.996,1.708
2016/10/5,1245,9247,-9,18,12,6,0.998,2.335
2016/10/5,1345,9240,-7,13,6,7,0.999,1.357
2016/10/6,945,9211,-70,57,63,-6,1.003,0.381
2016/10/6,1045,9227,16,27,7,20,1.001,1.077
2016/10/6,1145,9232,4,25,8,17,1.001,1.416
2016/10/6,1245,9242,10,16,3,13,0.999,2.536
2016/10/6,1345,9256,14,18,4,14,0.998,1.087
2016/10/7,945,9252,2,33,17,16,0.999,0.535
2016/10/7,1045,9254,0,15,2,13,0.999,1.409
2016/10/7,1145,9251,-3,11,9,2,0.999,2.511
2016/10/7,1245,9251,0,7,4,3,0.999,4.297
2016/10/7,1345,9253,3,6,2,4,0.999,1.925
2016/10/11,945,9293,-7,70,50,20,0.995,0.32
2016/10/11,1045,9211,-82,102,80,22,1.004,0.4
2016/10/11,1145,9154,-57,69,58,11,1.01,0.688
2016/10/11,1245,9186,32,38,0,38,1.006,1.673
2016/10/11,1345,9191,5,22,12,10,1.005,1.067
2016/10/12,945,9219,39,51,-4,55,1.001,0.579
2016/10/12,1045,9230,11,25,8,17,0.999,1.228
2016/10/12,1145,9258,28,34,6,28,0.996,1.662
2016/10/12,1245,9260,2,12,2,10,0.996,4.129
2016/10/12,1345,9260,0,27,14,13,0.996,1.315
2016/10/13,945,9241,-27,38,23,15,0.998,0.732
2016/10/13,1045,9194,-47,61,50,11,1.002,0.527
2016/10/13,1145,9203,9,33,9,24,1.001,1.281
2016/10/13,1245,9203,-1,13,7,6,1.002,3.115
2016/10/13,1345,9203,0,23,15,8,1.002,1.213
2016/10/14,945,9184,-23,54,40,14,1.004,0.488
2016/10/14,1045,9155,-29,50,48,2,1.007,0.93
2016/10/14,1145,9183,27,37,1,36,1.003,1.278
2016/10/14,1245,9191,6,15,3,12,1.002,3.013
2016/10/14,1345,9169,-22,32,23,9,1.003,1.687
2016/10/17,945,9067,-111,100,98,2,1.014,0.406
2016/10/17,1045,9125,58,75,10,65,1.005,0.717
2016/10/17,1145,9177,52,68,16,52,0.999,0.793
2016/10/17,1245,9167,-11,18,19,-1,1,2.846
2016/10/17,1345,9166,-2,16,6,10,0.999,1.831
2016/10/18,945,9205,22,62,11,51,0.995,0.59
2016/10/18,1045,9198,-8,36,12,24,0.996,1.327
2016/10/18,1145,9193,-4,12,9,3,0.997,3.93
2016/10/18,1245,9205,13,22,3,19,0.996,3.121
2016/10/18,1345,9212,7,21,6,15,0.995,1.213
2016/10/19,945,9283,60,68,4,64,0.988,0.668
2016/10/19,1045,9289,6,25,1,24,0.989,1.496
2016/10/19,1145,9292,3,14,7,7,0.991,2.232
2016/10/19,1245,9293,2,18,7,11,0.992,2.945
2016/10/20,945,9292,23,62,5,57,0.993,0.388
2016/10/20,1045,9280,-12,22,15,7,0.996,1.082
2016/10/20,1145,9281,2,28,2,26,0.996,1.099
2016/10/20,1245,9278,-3,7,4,3,0.998,4.549
2016/10/20,1345,9278,-1,11,6,5,0.999,1.919
2016/10/21,945,9310,51,60,12,48,0.996,0.506
2016/10/21,1045,9259,-51,62,44,18,1.002,0.582
2016/10/21,1145,9271,12,14,4,10,1.001,2.478
2016/10/21,1245,9279,8,13,4,9,1,3.843
2016/10/21,1345,9264,-15,24,24,0,1.001,1.359
2016/10/24,945,9271,-23,53,54,-1,1.001,0.428
2016/10/24,1045,9310,39,34,3,31,0.996,1.185
2016/10/24,1145,9306,-3,13,9,4,0.997,2.449
2016/10/24,1245,9303,-3,9,6,3,0.997,4.824
2016/10/24,1345,9309,6,14,1,13,0.997,1.844
2016/10/25,945,9324,-4,28,12,16,0.996,0.586
2016/10/25,1045,9348,25,30,2,28,0.994,0.753
2016/10/25,1145,9378,30,38,3,35,0.992,0.93
2016/10/25,1245,9386,8,20,8,12,0.992,1.663
2016/10/25,1345,9374,-12,15,14,1,0.994,1.105
2016/10/26,945,9345,5,40,18,22,0.998,0.424
2016/10/26,1045,9349,3,19,6,13,0.998,1.499
2016/10/26,1145,9344,-5,15,6,9,0.999,2.755
2016/10/26,1245,9336,-8,22,13,9,1,2.085
2016/10/26,1345,9336,-1,10,5,5,1.001,1.929
2016/10/27,945,9318,-6,34,30,4,1.003,0.566
2016/10/27,1045,9271,-46,55,44,11,1.008,0.474
2016/10/27,1145,9294,23,29,3,26,1.004,1.358
2016/10/27,1245,9290,-5,17,14,3,1.004,2.201
2016/10/27,1345,9287,-4,16,13,3,1.003,1.342
2016/10/28,945,9274,-12,52,39,13,1.004,0.474
2016/10/28,1045,9280,6,31,23,8,1.003,1.109
2016/10/28,1145,9274,-6,12,11,1,1.003,2.237
2016/10/28,1245,9278,4,11,7,4,1.001,4.025
2016/10/28,1345,9280,3,19,3,16,1,1.314
2016/10/31,945,9228,-35,85,31,54,1.005,0.359
2016/10/31,1045,9232,5,28,11,17,1.004,1.234
2016/10/31,1145,9282,50,55,5,50,0.998,0.827
2016/10/31,1245,9294,12,22,4,18,0.997,2.1
2016/10/31,1345,9283,-12,17,17,0,0.998,1.297
2016/11/1,945,9260,1,38,4,34,1,0.524
2016/11/1,1045,9281,21,29,11,18,0.998,0.948
2016/11/1,1145,9285,4,14,6,8,0.997,2.823
2016/11/1,1245,9279,-6,14,7,7,0.998,3.602
2016/11/1,1345,9280,0,10,3,7,0.998,2.507
2016/11/2,945,9175,-24,55,50,5,1.009,0.363
2016/11/2,1045,9172,-4,27,15,12,1.009,0.87
2016/11/2,1145,9170,-2,16,7,9,1.008,1.897
2016/11/2,1245,9160,-10,15,10,5,1.008,2.097
2016/11/2,1345,9160,1,20,4,16,1.006,1.019
2016/11/3,945,9124,-7,45,36,9,1.009,0.513
2016/11/3,1045,9121,-3,21,12,9,1.008,1.273
2016/11/3,1145,9094,-27,44,28,16,1.009,0.867
2016/11/3,1245,9108,14,33,12,21,1.005,1.776
2016/11/3,1345,9088,-20,32,22,10,1.006,1.173
2016/11/4,945,9083,25,47,11,36,1.005,0.564
2016/11/4,1045,9063,-20,36,25,11,1.006,1.015
2016/11/4,1145,9071,9,22,6,16,1.004,2.314
2016/11/4,1245,9068,-2,12,6,6,1.003,4.233
2016/11/4,1345,9064,-4,6,3,3,1.003,2.395
2016/11/7,945,9158,27,48,5,43,0.992,0.537
2016/11/7,1045,9187,30,24,9,15,0.99,0.95
2016/11/7,1145,9187,0,12,5,7,0.99,3.015
2016/11/7,1245,9194,6,14,6,8,0.99,2.53
2016/11/7,1345,9196,3,13,2,11,0.991,1.109
2016/11/8,945,9181,-35,48,49,-1,0.995,0.436
2016/11/8,1045,9189,7,27,0,27,0.995,0.767
2016/11/8,1145,9197,8,24,8,16,0.995,1.343
2016/11/8,1245,9210,13,19,5,14,0.995,2.28
2016/11/8,1345,9225,15,20,2,18,0.995,1.212
2016/11/9,945,9161,-62,127,146,-19,1.003,0.286
2016/11/9,1045,9017,-145,232,197,35,1.019,0.292
2016/11/9,1145,8966,-50,135,112,23,1.023,0.612
2016/11/9,1245,8950,-16,86,72,14,1.022,0.782
2016/11/9,1345,8929,-22,61,23,38,1.022,1.024
2016/11/10,945,9152,12,50,34,16,0.996,0.905
2016/11/10,1045,9180,28,40,12,28,0.993,1.845
2016/11/10,1145,9178,-2,16,13,3,0.993,4.661
2016/11/10,1245,9183,6,17,5,12,0.992,5.134
2016/11/10,1345,9177,-7,16,14,2,0.993,2.611
2016/11/11,945,8985,-63,81,72,9,1.012,0.654
2016/11/11,1045,8956,-29,40,34,6,1.013,1.241
2016/11/11,1145,8981,26,35,11,24,1.01,1.83
2016/11/11,1245,8965,-16,20,22,-2,1.012,3.564
2016/11/11,1345,8967,1,23,5,18,1.012,1.101
2016/11/14,945,8905,-52,86,70,16,1.017,0.523
2016/11/14,1045,8941,36,72,8,64,1.01,0.745
2016/11/14,1145,8959,17,59,29,30,1.005,1.12
2016/11/14,1245,8940,-21,39,25,14,1.005,2.249
2016/11/14,1345,8945,6,23,10,13,1.002,2.047
2016/11/15,945,8968,68,72,7,65,0.997,0.564
2016/11/15,1045,8950,-18,44,16,28,0.999,1.037
2016/11/15,1145,8955,5,25,16,9,0.999,1.24
2016/11/15,1245,8958,3,15,10,5,0.998,3.642
2016/11/15,1345,8938,-20,28,23,5,1,1.791
2016/11/16,945,8992,2,31,21,10,0.994,0.862
2016/11/16,1045,9027,36,37,2,35,0.992,1.145
2016/11/16,1145,9011,-16,31,23,8,0.994,1.91
2016/11/16,1245,9002,-9,32,15,17,0.996,1.9
2016/11/17,945,8929,-13,96,73,23,1.004,0.376
2016/11/17,1045,8949,21,33,12,21,1.002,0.845
2016/11/17,1145,8950,0,20,9,11,1.002,1.928
2016/11/17,1245,8941,-8,16,7,9,1.003,2.648
2016/11/17,1345,8962,22,19,-2,21,1,1.512
2016/11/18,945,8941,-38,47,32,15,1.003,0.525
2016/11/18,1045,8962,21,35,5,30,1,1.104
2016/11/18,1145,8993,31,44,5,39,0.996,0.957
2016/11/18,1245,8995,2,18,11,7,0.996,1.846
2016/11/18,1345,8987,-9,23,14,9,0.996,1.457
2016/11/21,945,8992,12,32,13,19,0.996,0.692
2016/11/21,1045,9020,28,27,2,25,0.994,0.906
2016/11/21,1145,9019,0,13,7,6,0.995,2.362
2016/11/21,1245,9015,-4,13,6,7,0.996,3.25
2016/11/21,1345,9017,2,8,1,7,0.996,2.064
2016/11/22,945,9096,46,45,-2,47,0.989,0.455
2016/11/22,1045,9138,42,47,2,45,0.986,0.642
2016/11/22,1145,9153,15,18,4,14,0.986,1.309
2016/11/22,1245,9162,10,12,2,10,0.987,2.687
2016/11/22,1345,9140,-23,24,22,2,0.991,0.915
2016/11/23,945,9164,14,26,4,22,0.99,0.642
2016/11/23,1045,9178,15,24,10,14,0.991,0.923
2016/11/23,1145,9177,-1,16,15,1,0.992,1.809
2016/11/23,1245,9172,-5,22,10,12,0.995,1.612
2016/11/23,1345,9175,3,10,6,4,0.996,1.718
2016/11/24,945,9120,-36,46,44,2,1.003,0.515
2016/11/24,1045,9144,23,24,5,19,1.001,1.019
2016/11/24,1145,9152,7,22,13,9,1,1.169
2016/11/24,1245,9143,-10,14,11,3,1.001,2.996
2016/11/24,1345,9142,-2,14,7,7,1.001,1.659
2016/11/25,945,9187,45,55,1,54,0.996,0.529
2016/11/25,1045,9160,-27,46,32,14,0.999,0.61
2016/11/25,1145,9167,7,22,7,15,0.998,2.119
2016/11/25,1245,9165,-3,14,10,4,0.998,3.206
2016/11/25,1345,9162,-2,11,8,3,0.999,1.927
2016/11/28,945,9231,74,88,7,81,0.991,0.403
2016/11/28,1045,9230,-1,33,15,18,0.992,0.778
2016/11/28,1145,9234,4,25,14,11,0.993,1.56
2016/11/28,1245,9224,-11,16,14,2,0.995,2.801
2016/11/28,1345,9223,-1,15,4,11,0.996,1.226
2016/11/29,945,9224,2,34,11,23,0.997,0.583
2016/11/29,1045,9225,1,32,3,29,0.997,0.866
2016/11/29,1145,9229,3,21,9,12,0.997,1.606
2016/11/29,1245,9227,-2,11,7,4,0.998,3.373
2016/11/29,1345,9203,-25,32,27,5,1.001,0.956
2016/11/30,945,9233,22,38,12,26,0.999,0.553
2016/11/30,1045,9215,-19,18,14,4,1.001,1.136
2016/11/30,1145,9198,-17,26,23,3,1.002,1.181
2016/11/30,1245,9194,-4,23,6,17,1.002,1.05
2016/11/30,1345,9226,32,37,4,33,0.999,0.789
2016/12/1,945,9239,10,46,25,21,0.997,0.479
2016/12/1,1045,9268,30,38,7,31,0.994,0.847
2016/12/1,1145,9267,-2,16,12,4,0.995,2.308
2016/12/1,1245,9263,-4,15,5,10,0.996,2.95
2016/12/1,1345,9261,-2,15,4,11,0.996,1.547
2016/12/2,945,9159,-40,46,35,11,1.007,0.411
2016/12/2,1045,9164,5,20,13,7,1.006,1.423
2016/12/2,1145,9173,9,25,9,16,1.004,1.823
2016/12/2,1245,9159,-13,17,16,1,1.006,3.011
2016/12/2,1345,9165,6,13,7,6,1.005,1.504
2016/12/5,945,9145,-14,66,38,28,1.006,0.46
2016/12/5,1045,9162,16,39,12,27,1.003,0.831
2016/12/5,1145,9154,-8,16,12,4,1.003,2.069
2016/12/5,1245,9157,4,12,7,5,1.001,5.397
2016/12/5,1345,9157,0,9,1,8,1,1.684
2016/12/6,945,9281,49,46,4,42,0.987,0.404
2016/12/6,1045,9268,-13,18,11,7,0.99,1.265
2016/12/6,1145,9275,7,11,2,9,0.99,2.987
2016/12/6,1245,9270,-5,11,6,5,0.992,3.989
2016/12/6,1345,9262,-9,12,9,3,0.994,1.277
2016/12/7,945,9278,-22,34,27,7,0.994,0.517
2016/12/7,1045,9272,-6,24,12,12,0.996,0.84
2016/12/7,1145,9263,-8,10,9,1,0.998,2.427
2016/12/7,1245,9251,-12,13,13,0,1,2.016
2016/12/7,1345,9263,12,19,4,15,1,1.266
2016/12/8,945,9326,-34,43,32,11,0.995,0.513
2016/12/8,1045,9349,24,42,11,31,0.993,0.599
2016/12/8,1145,9368,18,21,-1,22,0.992,1.321
2016/12/8,1245,9362,-6,10,8,2,0.993,2.132
2016/12/8,1345,9367,5,20,3,17,0.994,1.025
2016/12/9,945,9396,19,33,2,31,0.991,0.552
2016/12/9,1045,9385,-11,22,13,9,0.994,1.211
2016/12/9,1145,9388,3,11,5,6,0.995,2.886
2016/12/9,1245,9388,0,6,4,2,0.996,4.003
2016/12/9,1345,9390,2,10,2,8,0.997,1.424
2016/12/12,945,9434,14,39,6,33,0.993,0.453
2016/12/12,1045,9369,-65,76,65,11,1.001,0.464
2016/12/12,1145,9359,-10,23,14,9,1.003,1.367
2016/12/12,1245,9363,4,16,13,3,1.002,2.084
2016/12/12,1345,9355,-8,20,16,4,1.003,1.283
2016/12/13,945,9364,24,34,10,24,1.002,0.582
2016/12/13,1045,9363,-1,11,5,6,1.001,1.789
2016/12/13,1145,9363,0,9,5,4,1.001,3.784
2016/12/13,1245,9366,3,8,5,3,1.001,4.211
2016/12/13,1345,9378,12,17,3,14,0.999,1.428
2016/12/14,945,9378,-31,50,33,17,0.999,0.514
2016/12/14,1045,9377,-1,14,10,4,0.998,1.283
2016/12/14,1145,9373,-5,23,3,20,0.999,0.918
2016/12/14,1245,9375,3,11,4,7,0.999,2.426
2016/12/14,1345,9370,-5,13,12,1,1,1.269
2016/12/15,945,9341,11,42,11,31,1.003,0.341
2016/12/15,1045,9324,-19,39,20,19,1.004,0.646
2016/12/15,1145,9345,22,33,4,29,1.002,1.171
2016/12/15,1245,9355,10,22,7,15,1,1.691
2016/12/15,1345,9368,12,21,6,15,0.999,1.134
2016/12/16,945,9344,-23,31,22,9,1.001,0.553
2016/12/16,1045,9355,12,24,9,15,0.999,1.204
2016/12/16,1145,9348,-6,13,10,3,1,2.417
2016/12/16,1245,9345,-3,12,4,8,1,2.44
2016/12/16,1345,9312,-33,35,33,2,1.003,0.971
2016/12/19,945,9278,-12,49,39,10,1.006,0.516
2016/12/19,1045,9273,-5,22,15,7,1.006,1.147
2016/12/19,1145,9280,7,14,6,8,1.005,2.465
2016/12/19,1245,9272,-8,18,15,3,1.005,2.322
2016/12/19,1345,9246,-25,34,30,4,1.007,0.827
2016/12/20,945,9226,-35,47,40,7,1.008,0.581
2016/12/20,1045,9217,-8,27,25,2,1.008,0.939
2016/12/20,1145,9217,0,20,12,8,1.006,1.325
2016/12/20,1245,9231,14,21,4,17,1.003,1.849
2016/12/20,1345,9260,30,33,1,32,0.999,1.119
2016/12/21,945,9237,-24,35,30,5,1.001,0.841
2016/12/21,1045,9244,7,22,3,19,1,1.485
2016/12/21,1145,9239,-5,15,13,2,1,2.489
2016/12/21,1245,9230,-9,14,11,3,1.001,2.496
2016/12/22,945,9183,-28,81,66,15,1.005,0.34
2016/12/22,1045,9155,-28,38,27,11,1.007,0.755
2016/12/22,1145,9151,-4,25,16,9,1.007,1.35
2016/12/22,1245,9141,-10,21,16,5,1.007,1.82
2016/12/22,1345,9130,-11,29,22,7,1.008,0.808
2016/12/23,945,9117,2,34,7,27,1.008,0.524
2016/12/23,1045,9124,6,35,23,12,1.006,0.818
2016/12/23,1145,9112,-13,20,14,6,1.006,1.734
2016/12/23,1245,9099,-13,20,18,2,1.006,2.196
2016/12/23,1345,9090,-10,18,16,2,1.005,1.517
2016/12/26,945,9108,1,33,23,10,1.002,0.704
2016/12/26,1045,9100,-9,20,9,11,1.002,1.302
2016/12/26,1145,9104,3,16,4,12,1.001,2.705
2016/12/26,1245,9110,6,17,7,10,1,2.636
2016/12/26,1345,9123,12,16,3,13,0.998,1.694
2016/12/27,945,9113,-10,24,17,7,0.999,0.714
2016/12/27,1045,9117,5,16,10,6,0.999,1.262
2016/12/27,1145,9117,0,5,2,3,0.999,4.894
2016/12/27,1245,9112,-4,7,5,2,0.999,3.27
2016/12/27,1345,9113,2,12,7,5,0.999,1.5
2016/12/28,945,9189,79,83,4,79,0.991,0.285
2016/12/28,1045,9186,-3,15,10,5,0.992,0.892
2016/12/28,1145,9192,6,12,6,6,0.993,1.612
2016/12/28,1245,9204,12,17,6,11,0.992,1.345
2016/12/28,1345,9211,7,11,0,11,0.992,0.893
2016/12/29,945,9191,3,28,5,23,0.995,0.463
2016/12/29,1045,9196,6,21,15,6,0.996,0.839
2016/12/29,1145,9200,5,15,3,12,0.996,2.111
2016/12/29,1245,9199,0,14,12,2,0.997,2.114
2016/12/29,1345,9184,-16,28,19,9,1,0.861
2016/12/30,945,9266,51,51,16,35,0.992,0.395
2016/12/30,1045,9238,-28,48,30,18,0.996,0.705
2016/12/30,1145,9257,19,30,8,22,0.994,1.387
2016/12/30,1245,9259,2,11,7,4,0.995,2.848
2016/12/30,1345,9262,3,12,6,6,0.995,1.364
2017/1/3,945,9246,-20,38,23,15,0.998,0.517
2017/1/3,1045,9264,19,29,11,18,0.996,0.933
2017/1/3,1145,9261,-2,11,5,6,0.997,3.144
2017/1/3,1245,9262,1,9,2,7,0.998,5.067
2017/1/3,1345,9281,19,22,-1,23,0.997,1.587
2017/1/4,945,9274,-7,30,17,13,0.998,0.549
2017/1/4,1045,9280,7,24,15,9,0.997,0.803
2017/1/4,1145,9283,4,12,9,3,0.998,1.647
2017/1/4,1245,9274,-10,6,12,-6,0.999,3.761
2017/1/4,1345,9273,-1,9,4,5,0.999,1.382
2017/1/5,945,9323,53,59,2,57,0.994,0.332
2017/1/5,1045,9322,1,21,6,15,0.995,1.023
2017/1/5,1145,9347,24,31,2,29,0.993,1.209
2017/1/5,1245,9343,-4,12,11,1,0.994,2.191
2017/1/5,1345,9340,-4,11,12,-1,0.995,1.083
2017/1/6,945,9361,8,19,3,16,0.994,0.766
2017/1/6,1045,9358,-3,16,2,14,0.995,1.419
2017/1/6,1145,9373,16,20,1,19,0.994,1.837
2017/1/6,1245,9366,-7,11,9,2,0.996,2.797
2017/1/6,1345,9367,2,8,3,5,0.997,1.833
2017/1/9,945,9395,16,33,14,19,0.995,0.446
2017/1/9,1045,9340,-54,75,60,15,1.002,0.415
2017/1/9,1145,9344,4,17,4,13,1.001,1.742
2017/1/9,1245,9348,4,19,9,10,1.001,2.27
2017/1/9,1345,9344,-3,13,9,4,1.001,1.664
2017/1/10,945,9348,16,26,-1,27,1.001,0.587
2017/1/10,1045,9335,-14,17,13,4,1.002,1.515
2017/1/10,1145,9329,-6,15,6,9,1.002,1.449
2017/1/10,1245,9334,5,12,3,9,1.001,3.144
2017/1/10,1345,9342,8,12,3,9,1,1.68
2017/1/11,945,9344,-51,54,50,4,1,0.46
2017/1/11,1045,9353,9,22,5,17,0.999,1.069
2017/1/11,1145,9356,4,12,6,6,0.998,1.811
2017/1/11,1245,9350,-6,9,6,3,0.999,2.944
2017/1/11,1345,9338,-12,19,14,5,1.001,0.93
2017/1/12,945,9415,62,75,10,65,0.993,0.347
2017/1/12,1045,9426,10,19,7,12,0.992,0.941
2017/1/12,1145,9416,-10,17,9,8,0.994,1.473
2017/1/12,1245,9412,-5,12,4,8,0.995,1.868
2017/1/12,1345,9410,-1,13,12,1,0.997,1.116
2017/1/13,945,9371,-17,36,26,10,1.001,0.476
2017/1/13,1045,9373,2,16,13,3,1.001,1.27
2017/1/13,1145,9376,2,9,5,4,1.001,3.721
2017/1/13,1245,9374,-1,8,5,3,1.001,4.133
2017/1/13,1345,9374,0,7,5,2,1.001,2.062
2017/1/16,945,9287,-73,68,55,13,1.011,0.317
2017/1/16,1045,9287,0,18,12,6,1.009,1.183
2017/1/16,1145,9290,3,12,3,9,1.008,2.122
2017/1/16,1245,9288,-2,7,5,2,1.006,3.127
2017/1/16,1345,9286,-2,10,9,1,1.005,1.251
2017/1/17,945,9326,44,52,7,45,1,0.515
2017/1/17,1045,9339,12,24,4,20,0.998,1.132
2017/1/17,1145,9338,-2,6,3,3,0.998,4.223
2017/1/17,1245,9335,-3,9,8,1,0.998,3.582
2017/1/17,1345,9341,7,10,3,7,0.997,1.481
2017/1/18,945,9333,-3,32,13,19,0.997,0.676
2017/1/18,1045,9333,0,12,8,4,0.998,1.715
2017/1/18,1145,9331,-2,12,6,6,0.998,2.088
2017/1/18,1245,9343,13,24,6,18,0.997,1.487
2017/1/19,945,9308,-29,93,39,54,1.002,0.229
2017/1/19,1045,9308,-1,28,6,22,1.002,0.95
2017/1/19,1145,9308,0,10,4,6,1.002,3.327
2017/1/19,1245,9307,-1,7,3,4,1.002,4.668
2017/1/19,1345,9306,-1,14,3,11,1.001,1.599
2017/1/20,945,9315,32,38,7,31,1,0.64
2017/1/20,1045,9315,0,12,1,11,1,2.555
2017/1/20,1145,9333,18,26,5,21,0.998,1.112
2017/1/20,1245,9330,-3,5,5,0,0.998,7.569
2017/1/20,1345,9330,0,8,2,6,0.998,1.485
2017/1/23,945,9422,103,89,-1,90,0.988,0.334
2017/1/23,1045,9417,-6,14,5,9,0.99,1.377
2017/1/23,1145,9405,-13,16,11,5,0.992,1.649
2017/1/23,1245,9414,9,15,3,12,0.992,2.409
2017/1/23,1345,9407,-7,18,11,7,0.994,0.905
2017/1/24,945,9435,12,45,15,30,0.993,0.457
2017/1/24,1045,9438,3,10,3,7,0.994,2.221
2017/1/24,1145,9439,0,7,6,1,0.995,3.144
2017/1/24,1245,9441,3,5,2,3,0.996,5.66
2017/1/24,1345,9446,5,27,18,9,0.996,0.781
2017/2/2,945,9455,-45,52,50,2,0.997,0.386
2017/2/2,1045,9418,-37,72,40,32,1.001,0.458
2017/2/2,1145,9434,16,33,11,22,1,1.245
2017/2/2,1245,9428,-6,17,7,10,1.001,2.66
2017/2/2,1345,9375,-51,56,56,0,1.007,0.858
2017/2/3,945,9438,20,35,20,15,1,0.547
2017/2/3,1045,9423,-15,40,25,15,1.001,0.979
2017/2/3,1145,9436,14,29,6,23,1,2.032
2017/2/3,1245,9427,-9,18,10,8,1.001,3.74
2017/2/3,1345,9439,12,20,3,17,0.999,1.703
2017/2/6,945,9489,12,59,11,48,0.994,0.474
2017/2/6,1045,9497,8,27,7,20,0.993,1.194
2017/2/6,1145,9519,22,29,6,23,0.992,1.268
2017/2/6,1245,9525,6,18,8,10,0.992,2.7
2017/2/6,1345,9505,-19,25,21,4,0.995,0.916
2017/2/7,945,9510,11,30,2,28,0.996,0.678
2017/2/7,1045,9509,-1,18,14,4,0.996,1.238
2017/2/7,1145,9517,8,13,2,11,0.997,2.555
2017/2/7,1245,9520,3,7,4,3,0.997,3.33
2017/2/7,1345,9520,0,11,5,6,0.998,1.624
2017/2/8,945,9496,-17,72,39,33,1.001,0.335
2017/2/8,1045,9490,-5,20,6,14,1.002,1.178
2017/2/8,1145,9516,27,28,4,24,0.999,0.95
2017/2/8,1245,9513,-3,11,9,2,0.999,2.769
2017/2/8,1345,9515,2,13,11,2,0.999,1.539
2017/2/9,945,9550,32,44,-1,45,0.995,0.442
2017/2/9,1045,9571,21,34,4,30,0.994,0.795
2017/2/9,1145,9562,-9,17,15,2,0.995,1.908
2017/2/9,1245,9567,4,10,2,8,0.995,4.142
2017/2/9,1345,9576,8,19,3,16,0.995,1.319
2017/2/10,945,9637,37,61,10,51,0.989,0.415
2017/2/10,1045,9656,19,32,8,24,0.989,0.995
2017/2/10,1145,9671,16,35,4,31,0.989,1.073
2017/2/10,1245,9665,-6,23,16,7,0.991,1.527
2017/2/10,1345,9658,-7,32,12,20,0.993,1.003
2017/2/13,945,9690,20,27,-2,29,0.992,0.617
2017/2/13,1045,9695,6,24,1,23,0.993,1.139
2017/2/13,1145,9686,-9,8,10,-2,0.995,2.773
2017/2/13,1245,9694,8,13,6,7,0.995,2.687
2017/2/13,1345,9705,12,14,-1,15,0.995,1.53
2017/2/14,945,9726,-3,46,28,18,0.995,0.423
2017/2/14,1045,9745,19,41,3,38,0.994,0.984
2017/2/14,1145,9714,-32,39,44,-5,0.998,1.064
2017/2/14,1245,9720,6,28,3,25,0.998,1.066
2017/2/14,1345,9710,-9,19,15,4,0.999,1.583
2017/2/15,945,9743,17,23,2,21,0.996,1.087
2017/2/15,1045,9750,6,23,15,8,0.996,1.408
2017/2/15,1145,9782,32,34,6,28,0.993,1.61
2017/2/15,1245,9791,9,20,7,13,0.994,2.292
2017/2/16,945,9788,-31,74,64,10,0.995,0.324
2017/2/16,1045,9788,1,36,11,25,0.996,0.867
2017/2/16,1145,9769,-18,26,21,5,0.998,1.735
2017/2/16,1245,9774,5,21,7,14,0.998,1.648
2017/2/16,1345,9772,-1,19,5,14,0.999,1.267
2017/2/17,945,9761,1,39,25,14,1,0.623
2017/2/17,1045,9771,11,22,7,15,1,1.392
2017/2/17,1145,9767,-5,12,10,2,1,3.391
2017/2/17,1245,9767,0,5,3,2,1.001,6.393
2017/2/17,1345,9762,-6,8,7,1,1.001,2.746
2017/2/18,945,9783,5,16,5,11,0.998,1.292
2017/2/18,1045,9783,-1,6,3,3,0.998,4.57
2017/2/18,1145,9785,3,4,1,3,0.998,5.677
2017/2/18,1245,9785,1,3,1,2,0.998,8.67
2017/2/18,1345,9788,4,4,-1,5,0.998,2.535
2017/2/20,945,9771,-15,62,43,19,1,0.222
2017/2/20,1045,9779,9,24,11,13,0.999,0.574
2017/2/20,1145,9778,0,10,4,6,1,1.686
2017/2/20,1245,9765,-12,14,13,1,1.001,2.143
2017/2/20,1345,9766,1,32,3,29,1.001,0.506
2017/2/21,945,9740,-37,52,43,9,1.003,0.396
2017/2/21,1045,9739,-2,21,15,6,1.003,0.949
2017/2/21,1145,9739,-1,14,10,4,1.003,1.719
2017/2/21,1245,9749,11,24,3,21,1.001,1.383
2017/2/21,1345,9766,17,24,5,19,0.999,0.978
2017/2/22,945,9789,6,55,38,17,0.997,0.33
2017/2/22,1045,9795,5,18,3,15,0.996,1.352
2017/2/22,1145,9792,-2,17,15,2,0.997,1.654
2017/2/22,1245,9775,-17,27,19,8,0.999,1.589
2017/2/22,1345,9783,8,10,2,8,0.998,1.83
2017/2/23,945,9819,39,61,-3,64,0.994,0.472
2017/2/23,1045,9793,-25,26,23,3,0.998,1.071
2017/2/23,1145,9782,-12,23,13,10,0.999,1.403
2017/2/23,1245,9778,-4,8,9,-1,1,3.787
2017/2/23,1345,9772,-6,19,7,12,1.001,1.222
2017/2/24,945,9775,5,51,6,45,1.001,0.455
2017/2/24,1045,9760,-16,28,26,2,1.002,1.063
2017/2/24,1145,9763,3,9,8,1,1.001,3.565
2017/2/24,1245,9772,9,13,4,9,1,2.805
2017/2/24,1345,9761,-11,22,14,8,1.001,1.256
2017/3/1,945,9744,-22,39,18,21,1.003,0.463
2017/3/1,1045,9706,-38,43,43,0,1.006,0.64
2017/3/1,1145,9690,-16,34,22,12,1.007,0.798
2017/3/1,1245,9684,-6,14,13,1,1.007,3.021
2017/3/1,1345,9682,-3,12,8,4,1.006,1.209
2017/3/2,945,9745,-16,51,39,12,0.999,0.457
2017/3/2,1045,9685,-60,57,60,-3,1.005,0.681
2017/3/2,1145,9665,-21,40,22,18,1.006,0.991
2017/3/2,1245,9659,-6,23,7,16,1.006,1.969
2017/3/2,1345,9691,31,41,5,36,1.002,1.242
2017/3/3,945,9653,5,34,13,21,1.004,0.707
2017/3/3,1045,9653,-1,37,7,30,1.003,0.801
2017/3/3,1145,9648,-5,26,24,2,1.003,1.407
2017/3/3,1245,9642,-6,15,9,6,1.003,2.788
2017/3/3,1345,9629,-13,13,16,-3,1.004,1.871
2017/3/6,945,9656,17,49,12,37,1,0.601
2017/3/6,1045,9667,11,28,13,15,0.998,1.067
2017/3/6,1145,9673,7,18,2,16,0.997,2.501
2017/3/6,1245,9664,-8,12,9,3,0.998,4.934
2017/3/6,1345,9683,18,26,1,25,0.997,1.489
2017/3/7,945,9694,1,31,19,12,0.996,0.571
2017/3/7,1045,9717,24,34,7,27,0.994,0.85
2017/3/7,1145,9715,-1,10,5,5,0.995,2.734
2017/3/7,1245,9715,0,8,5,3,0.995,3.554
2017/3/7,1345,9727,13,27,7,20,0.995,0.992
2017/3/8,945,9709,-27,43,35,8,0.998,0.45
2017/3/8,1045,9719,10,15,6,9,0.997,1.057
2017/3/8,1145,9746,27,32,2,30,0.995,0.881
2017/3/8,1245,9758,12,22,7,15,0.995,1.395
2017/3/8,1345,9748,-10,17,12,5,0.997,1.184
2017/3/9,945,9656,-83,78,82,-4,1.007,0.374
2017/3/9,1045,9658,1,26,10,16,1.006,0.705
2017/3/9,1145,9653,-5,15,13,2,1.006,2.313
2017/3/9,1245,9656,3,11,4,7,1.005,3.376
2017/3/9,1345,9652,-4,20,13,7,1.005,1.071
2017/3/10,945,9574,-73,91,72,19,1.012,0.437
2017/3/10,1045,9587,13,30,6,24,1.009,0.914
2017/3/10,1145,9602,16,28,10,18,1.006,1.262
2017/3/10,1245,9631,29,38,10,28,1.002,1.564
2017/3/10,1345,9625,-5,21,14,7,1.001,1.47
2017/3/13,945,9664,20,48,30,18,0.996,0.568
2017/3/13,1045,9682,18,31,7,24,0.994,1.276
2017/3/13,1145,9687,5,18,11,7,0.994,1.871
2017/3/13,1245,9685,-2,13,8,5,0.995,3.565
2017/3/13,1345,9692,7,17,3,14,0.994,1.575
2017/3/14,945,9745,32,33,0,33,0.989,0.577
2017/3/14,1045,9758,13,19,-1,20,0.99,1.246
2017/3/14,1145,9758,0,13,9,4,0.992,1.537
2017/3/14,1245,9751,-6,10,9,1,0.994,3.005
2017/3/14,1345,9749,-2,11,6,5,0.995,1.148
2017/3/15,945,9726,-16,32,21,11,0.999,0.677
2017/3/15,1045,9743,17,15,-3,18,0.998,1.608
2017/3/15,1145,9748,5,13,4,9,0.998,1.872
2017/3/15,1245,9744,-4,14,4,10,0.999,2.24
2017/3/16,945,9847,42,120,3,117,0.99,0.315
2017/3/16,1045,9843,-4,24,1,23,0.991,0.948
2017/3/16,1145,9838,-4,11,9,2,0.993,2.226
2017/3/16,1245,9834,-4,11,10,1,0.994,3.235
2017/3/16,1345,9840,6,19,4,15,0.994,1.065
2017/3/17,945,9858,8,33,12,21,0.993,0.553
2017/3/17,1045,9862,4,22,5,17,0.994,1.405
2017/3/17,1145,9866,3,14,7,7,0.995,1.911
2017/3/17,1245,9863,-4,7,5,2,0.997,4.116
2017/3/17,1345,9890,26,34,6,28,0.995,0.923
2017/3/20,945,9878,8,33,10,23,0.997,0.54
2017/3/20,1045,9906,28,37,1,36,0.994,0.904
2017/3/20,1145,9901,-5,15,7,8,0.996,1.646
2017/3/20,1245,9891,-10,14,10,4,0.997,3.033
2017/3/20,1345,9895,4,13,8,5,0.997,1.302
2017/3/21,945,9953,27,37,0,37,0.992,0.427
2017/3/21,1045,9966,12,17,1,16,0.992,0.841
2017/3/21,1145,9958,-7,21,22,-1,0.994,1.044
2017/3/21,1245,9966,7,15,7,8,0.994,1.882
2017/3/21,1345,9962,-4,11,9,2,0.995,1.108
2017/3/22,945,9888,-2,55,18,37,1.003,0.385
2017/3/22,1045,9873,-14,39,31,8,1.005,0.834
2017/3/22,1145,9883,10,19,4,15,1.003,1.795
2017/3/22,1245,9889,6,13,1,12,1.003,2.411
2017/3/22,1345,9898,9,25,9,16,1.002,1.111
2017/3/23,945,9911,-30,73,41,32,1,0.443
2017/3/23,1045,9916,5,27,12,15,1,1.112
2017/3/23,1145,9914,-2,13,5,8,0.999,2.575
2017/3/23,1245,9903,-10,27,20,7,1,1.854
2017/3/23,1345,9909,6,23,12,11,0.999,1.379
2017/3/24,945,9907,-20,32,17,15,0.999,0.561
2017/3/24,1045,9907,0,30,6,24,0.999,0.801
2017/3/24,1145,9904,-3,17,11,6,1,2.096
2017/3/24,1245,9899,-5,10,9,1,1.001,4.549
2017/3/24,1345,9901,1,8,4,4,1.001,2.015
2017/3/27,945,9897,19,52,-1,53,1,0.413
2017/3/27,1045,9903,5,23,14,9,1,1.076
2017/3/27,1145,9892,-10,22,11,11,1.001,1.325
2017/3/27,1245,9879,-12,18,15,3,1.002,2.351
2017/3/27,1345,9865,-14,24,25,-1,1.003,1.021
2017/3/28,945,9895,-25,41,32,9,1,0.443
2017/3/28,1045,9878,-18,30,30,0,1.001,0.962
2017/3/28,1145,9859,-19,28,25,3,1.003,0.876
2017/3/28,1245,9829,-29,50,26,24,1.006,0.661
2017/3/28,1345,9883,54,58,1,57,0.999,0.863
2017/3/29,945,9866,-36,42,34,8,1.001,0.725
2017/3/29,1045,9863,-2,28,17,11,1.001,1.03
2017/3/29,1145,9864,0,15,11,4,1.001,2.229
2017/3/29,1245,9858,-5,16,9,7,1.001,2.289
2017/3/29,1345,9862,4,15,5,10,1.001,1.623
2017/3/30,945,9857,-7,54,31,23,1.001,0.592
2017/3/30,1045,9857,1,21,12,9,1,1.405
2017/3/30,1145,9856,0,12,6,6,1,2.42
2017/3/30,1245,9864,8,13,1,12,0.999,3.377
2017/3/30,1345,9850,-13,21,18,3,1.001,1.387
2017/3/31,945,9855,-3,28,17,11,1,0.653
2017/3/31,1045,9847,-9,25,13,12,1.001,0.753
2017/3/31,1145,9845,-1,9,6,3,1.001,2.434
2017/3/31,1245,9844,-1,8,6,2,1.001,3.607
2017/3/31,1345,9821,-24,34,25,9,1.003,0.783
2017/4/5,945,9932,83,86,-3,89,0.992,0.357
2017/4/5,1045,9934,3,18,4,14,0.992,1.055
2017/4/5,1145,9919,-15,21,19,2,0.994,1.554
2017/4/5,1245,9925,5,20,4,16,0.994,1.571
2017/4/5,1345,9961,35,50,7,43,0.991,0.84
2017/4/6,945,9922,-8,30,19,11,0.996,0.607
2017/4/6,1045,9894,-28,49,35,14,1,0.718
2017/4/6,1145,9895,2,20,11,9,1,1.763
2017/4/6,1245,9898,3,14,6,8,1,3.217
2017/4/6,1345,9897,0,11,5,6,1.001,1.864
2017/4/7,945,9820,-83,96,77,19,1.009,0.318
2017/4/7,1045,9786,-35,66,52,14,1.012,0.607
2017/4/7,1145,9847,61,61,3,58,1.004,0.9
2017/4/7,1245,9854,7,15,4,11,1.002,2.311
2017/4/7,1345,9863,9,18,7,11,1.001,1.373
2017/4/10,945,9858,-10,49,34,15,1.001,0.708
2017/4/10,1045,9870,12,31,7,24,0.999,1.431
2017/4/10,1145,9875,6,19,3,16,0.998,2.925
2017/4/10,1245,9872,-2,13,7,6,0.998,4.762
2017/4/10,1345,9876,4,10,3,7,0.997,3.058
2017/4/11,945,9884,18,49,11,38,0.996,0.516
2017/4/11,1045,9815,-68,84,76,8,1.004,0.468
2017/4/11,1145,9824,9,24,11,13,1.003,1.382
2017/4/11,1245,9822,-2,14,6,8,1.003,2.601
2017/4/11,1345,9816,-6,16,15,1,1.003,1.202
2017/4/12,945,9796,-22,49,29,20,1.005,0.465
2017/4/12,1045,9821,25,36,9,27,1.002,0.862
2017/4/12,1145,9820,-1,16,5,11,1.001,2.412
2017/4/12,1245,9805,-15,14,15,-1,1.002,3.643
2017/4/12,1345,9814,9,13,3,10,1.001,2.253
2017/4/13,945,9861,59,77,8,69,0.995,0.473
2017/4/13,1045,9824,-37,51,37,14,0.999,0.744
2017/4/13,1145,9843,19,26,2,24,0.997,1.729
2017/4/13,1245,9848,5,16,7,9,0.997,2.191
2017/4/13,1345,9846,-3,16,5,11,0.997,1.631
2017/4/14,945,9764,-42,61,43,18,1.006,0.394
2017/4/14,1045,9756,-8,37,28,9,1.006,0.928
2017/4/14,1145,9751,-5,25,9,16,1.006,1.18
2017/4/14,1245,9747,-4,21,13,8,1.006,2.497
2017/4/14,1345,9716,-31,39,34,5,1.008,0.985
2017/4/17,945,9701,-39,59,53,6,1.009,0.589
2017/4/17,1045,9704,3,36,12,24,1.007,0.814
2017/4/17,1145,9724,20,34,9,25,1.004,1.243
2017/4/17,1245,9725,0,14,2,12,1.003,2.614
2017/4/17,1345,9722,-4,17,11,6,1.002,1.985
2017/4/18,945,9741,-16,36,31,5,0.999,0.595
2017/4/18,1045,9735,-7,20,11,9,0.999,1.138
2017/4/18,1145,9732,-4,16,5,11,1,2.264
2017/4/18,1245,9732,0,10,3,7,0.999,3.845
2017/4/18,1345,9737,5,11,5,6,0.999,1.636
2017/4/19,945,9670,-30,45,34,11,1.005,0.507
2017/4/19,1045,9676,6,33,23,10,1.004,1.11
2017/4/19,1145,9661,-15,29,24,5,1.006,1.851
2017/4/19,1245,9663,2,16,7,9,1.005,2.472
2017/4/20,945,9628,30,83,39,44,1.007,0.385
2017/4/20,1045,9616,-11,40,24,16,1.007,0.734
2017/4/20,1145,9617,0,11,5,6,1.006,2.725
2017/4/20,1245,9612,-4,13,6,7,1.005,3.172
2017/4/20,1345,9615,3,14,12,2,1.003,1.469
2017/4/21,945,9675,10,33,13,20,0.996,0.544
2017/4/21,1045,9678,3,14,6,8,0.996,1.513
2017/4/21,1145,9697,19,24,6,18,0.994,1.224
2017/4/21,1245,9691,-6,11,6,5,0.995,3.052
2017/4/21,1345,9697,6,15,9,6,0.994,1.298
2017/4/24,945,9710,-37,54,56,-2,0.995,0.447
2017/4/24,1045,9703,-8,30,11,19,0.996,0.683
2017/4/24,1145,9695,-8,16,12,4,0.998,1.822
2017/4/24,1245,9702,7,22,13,9,0.998,2.11
2017/4/24,1345,9705,4,13,8,5,0.999,1.568
2017/4/25,945,9763,17,46,11,35,0.993,0.421
2017/4/25,1045,9779,16,36,9,27,0.993,0.783
2017/4/25,1145,9789,10,22,8,14,0.993,1.69
2017/4/25,1245,9791,1,9,4,5,0.994,3.614
2017/4/25,1345,9813,22,40,14,26,0.992,0.917
2017/4/26,945,9841,-14,34,23,11,0.991,0.578
2017/4/26,1045,9855,13,32,16,16,0.991,0.855
2017/4/26,1145,9836,-19,30,27,3,0.994,1.428
2017/4/26,1245,9844,8,22,4,18,0.995,1.915
2017/4/26,1345,9841,-3,16,17,-1,0.996,1.639
2017/4/27,945,9829,0,23,13,10,0.998,0.773
2017/4/27,1045,9827,0,26,7,19,0.999,0.916
2017/4/27,1145,9834,7,14,5,9,0.999,1.897
2017/4/27,1245,9836,2,9,0,9,0.999,3.517
2017/4/27,1345,9839,3,12,11,1,0.999,1.113
2017/4/28,945,9873,26,50,11,39,0.996,0.513
2017/4/28,1045,9853,-20,36,18,18,0.998,0.639
2017/4/28,1145,9844,-9,15,13,2,0.999,2.473
2017/4/28,1245,9839,-4,13,9,4,1,2.3
2017/4/28,1345,9857,18,22,2,20,0.998,1.182
2017/5/2,945,9937,38,43,13,30,0.991,0.435
2017/5/2,1045,9936,-1,22,14,8,0.992,1.17
2017/5/2,1145,9943,7,15,3,12,0.992,2.036
2017/5/2,1245,9943,0,9,7,2,0.993,3.804
2017/5/2,1345,9932,-11,16,14,2,0.995,1.183
2017/5/3,945,9957,11,26,3,23,0.994,0.647
2017/5/3,1045,9954,-3,18,12,6,0.995,0.99
2017/5/3,1145,9947,-7,12,7,5,0.997,1.847
2017/5/3,1245,9946,-1,5,3,2,0.998,4.46
2017/5/3,1345,9936,-10,9,11,-2,1,1.368
2017/5/4,945,9944,-7,42,16,26,1,0.446
2017/5/4,1045,9939,-5,20,9,11,1,1.142
2017/5/4,1145,9964,25,11,-14,25,0.998,1.464
2017/5/4,1245,9955,-9,10,5,5,0.999,2.098
2017/5/4,1345,9959,3,13,3,10,0.999,1.447
2017/5/5,945,9911,-35,39,37,2,1.003,0.44
2017/5/5,1045,9918,7,23,5,18,1.002,0.69
2017/5/5,1145,9905,-13,23,16,7,1.003,1.095
2017/5/5,1245,9900,-4,15,9,6,1.003,1.659
2017/5/5,1345,9889,-10,26,16,10,1.004,0.991
2017/5/8,945,9912,-17,54,47,7,1.001,0.407
2017/5/8,1045,9915,4,24,4,20,1.001,1.139
2017/5/8,1145,9907,-7,17,10,7,1.001,2.348
2017/5/8,1245,9910,3,10,2,8,1,3.322
2017/5/8,1345,9921,12,21,5,16,0.999,1.175
2017/5/9,945,9983,67,72,11,61,0.992,0.362
2017/5/9,1045,9949,-34,65,44,21,0.996,0.56
2017/5/9,1145,9936,-14,15,13,2,0.998,2.011
2017/5/9,1245,9906,-30,40,32,8,1.001,1.133
2017/5/9,1345,9904,-2,28,25,3,1.002,1.292
2017/5/10,945,9948,10,41,11,30,0.997,0.601
2017/5/10,1045,9934,-14,20,17,3,0.999,1.598
2017/5/10,1145,9942,8,13,3,10,0.999,2.682
2017/5/10,1245,9939,-3,8,3,5,0.999,4.393
2017/5/10,1345,9947,8,17,8,9,0.999,1.725
2017/5/11,945,9965,3,28,9,19,0.997,0.581
2017/5/11,1045,9990,24,31,7,24,0.995,0.629
2017/5/11,1145,9968,-22,29,23,6,0.997,1.171
2017/5/11,1245,9983,16,12,-5,17,0.996,2.733
2017/5/11,1345,9987,5,15,8,7,0.996,1.335
2017/5/12,945,9987,5,27,8,19,0.997,0.607
2017/5/12,1045,9978,-10,21,18,3,0.998,1.072
2017/5/12,1145,9978,1,11,8,3,0.999,2.237
2017/5/12,1245,9976,-2,13,3,10,0.999,1.947
2017/5/12,1345,9981,6,15,3,12,0.999,1.67
2017/5/12,1345,10038,10038,-99999,-10038,-89961,0.894,#DIV/0!
2017/5/15,1345,10022,10022,-99999,-10022,-89977,0.796,#DIV/0!
2017/5/17,945,9988,-5,36,34,2,0.799,0.487
2017/5/17,1045,9993,5,17,13,4,0.799,1.271
2017/5/17,1145,9983,-10,18,13,5,0.8,1.211
2017/5/17,1245,9982,-1,10,3,7,0.8,1.575
2017/5/17,1345,9944,-38,20,56,-36,0.803,0.763
2017/5/18,1345,9951,9951,-99999,-9951,-90048,0.702,#DIV/0!
2017/5/19,1345,9981,9981,-99999,-9981,-90018,0.6,#DIV/0!
2017/5/22,1345,10007,10007,-99999,-10007,-89992,0.499,#DIV/0!
2017/5/24,945,10005,-2,24,17,7,0.599,0.319
2017/5/24,1045,10020,16,23,7,16,0.698,0.626
2017/5/24,1145,10025,5,9,5,4,0.698,0.905
2017/5/24,1245,10026,1,6,2,4,0.698,1.923
2017/5/24,1345,10020,-6,8,7,1,0.699,0.879
2017/5/24,1345,10125,10125,-99999,-10125,-89874,0.593,#DIV/0!
2017/5/25,1345,10087,10087,-99999,-10087,-89912,0.496,#DIV/0!
2017/5/26,1345,10014,10014,-99999,-10014,-89985,0.5,#DIV/0!
2017/5/31,1345,10079,10079,-99999,-10079,-89920,0.496,#DIV/0!
2017/6/1,1345,10145,10145,-99999,-10145,-89854,0.493,#DIV/0!
2017/6/3,945,10144,-3,16,9,7,0.495,0.576
2017/6/3,1045,10144,1,6,4,2,0.496,1.695
2017/6/3,1145,10151,7,6,-1,7,0.497,1.912
2017/6/3,1245,10157,6,11,2,9,0.498,0.742
2017/6/3,1345,10157,0,4,3,1,0.499,0.474
2017/6/3,1345,10204,10204,-99999,-10204,-89795,0.497,#DIV/0!
2017/6/5,1345,10185,10185,-99999,-10185,-89814,0.498,#DIV/0!
2017/6/6,1345,10193,10193,-99999,-10193,-89806,0.497,#DIV/0!
2017/6/7,1345,10220,10220,-99999,-10220,-89779,0.496,#DIV/0!
2017/6/8,1345,10202,10202,-99999,-10202,-89797,0.497,#DIV/0!
2017/6/9,1345,10100,10100,-99999,-10100,-89899,0.401,#DIV/0!
2017/6/12,1345,10139,10139,-99999,-10139,-89860,0.3,#DIV/0!
2017/6/13,1345,10072,10072,-99999,-10072,-89927,0.201,#DIV/0!
2017/6/15,945,10030,-21,50,42,8,0.201,0.109
2017/6/15,1045,10063,33,49,4,45,0.199,0.293
2017/6/15,1145,10050,-13,21,13,8,0.299,0.763
2017/6/15,1245,10050,-1,11,7,4,0.399,1.706
2017/6/15,1345,10073,23,26,2,24,0.498,0.737
2017/6/16,945,10080,2,25,6,19,0.598,0.417
2017/6/16,1045,10091,11,29,11,18,0.697,0.638
2017/6/16,1145,10135,43,43,-4,47,0.794,0.835
2017/6/16,1245,10139,5,13,5,8,0.893,1.214
2017/6/16,1345,10146,8,22,13,9,0.993,0.948
2017/6/19,945,10223,59,55,-3,58,0.986,0.568
2017/6/19,1045,10238,16,30,3,27,0.987,0.953
2017/6/19,1145,10245,7,15,-1,16,0.988,1.815
2017/6/19,1245,10237,-8,9,8,1,0.99,2.565
2017/6/19,1345,10239,2,17,12,5,0.992,1.233
2017/6/20,945,10320,44,52,0,52,0.986,0.505
2017/6/20,1045,10320,1,24,6,18,0.989,1.171
2017/6/20,1145,10349,29,34,4,30,0.988,1.392
2017/6/20,1245,10323,-27,26,24,2,0.993,1.223
2017/6/20,1345,10322,-2,19,13,6,0.994,1.344
2017/6/21,945,10311,38,38,-2,40,0.997,0.691
2017/6/21,1045,10327,17,22,2,20,0.996,1.43
2017/6/21,1145,10312,-15,30,13,17,0.998,1.235
2017/6/21,1245,10335,23,35,9,26,0.997,1.724
2017/6/22,945,10198,0,197,173,24,1.01,0.348
2017/6/22,1045,10202,4,29,10,19,1.008,1.196
2017/6/22,1145,10220,18,21,3,18,1.006,1.958
2017/6/22,1245,10215,-4,19,16,3,1.005,1.884
2017/6/22,1345,10231,17,19,0,19,1.002,1.615
2017/6/23,945,10213,-8,32,32,0,1.003,0.615
2017/6/23,1045,10220,7,35,8,27,1.002,0.813
2017/6/23,1145,10211,-9,21,15,6,1.002,1.94
2017/6/23,1245,10213,2,9,4,5,1,5.004
2017/6/23,1345,10215,1,10,3,7,0.999,2.33
2017/6/26,945,10311,104,107,6,101,0.99,0.345
2017/6/26,1045,10338,27,105,57,48,0.988,0.462
2017/6/26,1145,10380,41,40,-2,42,0.986,1.108
2017/6/26,1245,10371,-9,33,16,17,0.988,1.376
2017/6/26,1345,10381,10,31,11,20,0.989,1.207
2017/6/27,945,10384,-6,56,28,28,0.99,0.53
2017/6/27,1045,10357,-28,33,29,4,0.994,1.246
2017/6/27,1145,10379,22,24,3,21,0.993,2.72
2017/6/27,1245,10377,-2,16,11,5,0.995,2.867
2017/6/27,1345,10368,-9,22,17,5,0.998,2.36
2017/6/28,945,10336,33,48,6,42,1.002,0.557
2017/6/28,1045,10268,-67,88,67,21,1.009,0.511
2017/6/28,1145,10277,9,34,15,19,1.007,1.345
2017/6/28,1245,10272,-6,21,12,9,1.007,2.658
2017/6/28,1345,10261,-11,27,26,1,1.007,1.376
2017/6/29,945,10319,-6,50,37,13,1,0.531
2017/6/29,1045,10323,4,27,19,8,0.999,1.114
2017/6/29,1145,10327,3,14,3,11,0.999,3.086
2017/6/29,1245,10293,-34,39,35,4,1.001,2.172
2017/6/29,1345,10297,3,41,4,37,1,0.917
2017/6/30,945,10230,10,47,13,34,1.006,0.514
2017/6/30,1045,10235,4,33,22,11,1.004,0.927
2017/6/30,1145,10237,2,12,6,6,1.004,3.394
2017/6/30,1245,10246,9,16,2,14,1.003,3.866
2017/6/30,1345,10252,6,15,11,4,1.002,1.121
2017/7/3,945,10283,23,46,6,40,0.998,0.563
2017/7/3,1045,10244,-39,54,41,13,1.002,0.826
2017/7/3,1145,10250,6,23,9,14,1,2
2017/7/3,1245,10260,9,12,2,10,0.999,4.785
2017/7/3,1345,10289,29,32,-1,33,0.995,1.466
2017/7/4,945,10270,-33,50,33,17,0.998,0.499
2017/7/4,1045,10274,4,32,24,8,0.998,0.842
2017/7/4,1145,10254,-21,33,21,12,1,0.888
2017/7/4,1245,10237,-17,24,19,5,1.002,1.205
2017/7/4,1345,10217,-21,35,28,7,1.004,0.88
2017/7/5,945,10209,-6,44,40,4,1.004,0.565
2017/7/5,1045,10239,30,77,9,68,1.001,0.467
2017/7/5,1145,10263,24,40,11,29,0.998,1.057
2017/7/5,1245,10271,8,19,1,18,0.998,2.946
2017/7/5,1345,10301,30,37,3,34,0.995,1.256
2017/7/6,945,10273,-50,70,55,15,0.998,0.575
2017/7/6,1045,10249,-24,27,15,12,1,1.05
2017/7/6,1145,10255,6,30,18,12,0.999,1.767
2017/7/6,1245,10253,-2,17,11,6,1,4.035
2017/7/6,1345,10267,14,27,3,24,0.998,1.875
2017/7/7,945,10210,-15,43,36,7,1.004,0.585
2017/7/7,1045,10224,14,37,14,23,1.003,1.145
2017/7/7,1145,10221,-2,16,7,9,1.003,2.555
2017/7/7,1245,10207,-14,23,17,6,1.004,1.968
2017/7/7,1345,10203,-4,16,12,4,1.004,1.382
2017/7/10,945,10191,-35,53,42,11,1.004,0.509
2017/7/10,1045,10233,42,56,9,47,0.999,0.692
2017/7/10,1145,10234,1,13,2,11,0.999,2.228
2017/7/10,1245,10210,-24,29,24,5,1.001,2.279
2017/7/10,1345,10210,0,13,5,8,1,1.923
2017/7/11,945,10312,80,87,8,79,0.99,0.375
2017/7/11,1045,10332,19,35,6,29,0.99,0.94
2017/7/11,1145,10344,12,25,6,19,0.989,1.679
2017/7/11,1245,10337,-6,16,9,7,0.991,2.426
2017/7/11,1345,10342,5,18,14,4,0.992,0.976
2017/7/12,945,10364,18,53,19,34,0.991,0.528
2017/7/12,1045,10356,-8,29,9,20,0.994,0.897
2017/7/12,1145,10360,5,14,4,10,0.994,2.717
2017/7/12,1245,10358,-1,18,3,15,0.996,2.178
2017/7/12,1345,10339,-19,24,21,3,0.999,1.662
2017/7/13,945,10387,-6,56,43,13,0.996,0.428
2017/7/13,1045,10425,38,66,12,54,0.993,0.579
2017/7/13,1145,10429,5,24,13,11,0.994,1.711
2017/7/13,1245,10435,5,12,2,10,0.994,3.844
2017/7/13,1345,10420,-16,21,18,3,0.996,1.451
2017/7/14,945,10409,-11,31,13,18,0.998,0.664
2017/7/14,1045,10417,8,22,7,15,0.998,1.291
2017/7/14,1145,10413,-5,10,4,6,0.999,3.034
2017/7/14,1245,10410,-3,8,5,3,0.999,5.815
2017/7/14,1345,10403,-7,15,11,4,1.001,2.097
2017/7/17,945,10443,-15,39,37,2,0.997,0.484
2017/7/17,1045,10423,-21,39,30,9,1,0.568
2017/7/17,1145,10434,11,26,8,18,0.999,1.55
2017/7/17,1245,10435,1,13,4,9,0.999,3.488
2017/7/17,1345,10436,1,21,1,20,0.999,1.199
2017/7/18,945,10441,14,36,2,34,0.998,0.548
2017/7/18,1045,10428,-13,14,13,1,1,1.257
2017/7/18,1145,10440,11,15,1,14,0.999,2.507
2017/7/18,1245,10446,7,18,10,8,0.998,1.959
2017/7/18,1345,10462,16,25,4,21,0.997,1.235
2017/7/19,945,10507,28,37,1,36,0.993,0.602
2017/7/19,1045,10536,29,26,2,24,0.991,0.837
2017/7/19,1145,10535,-1,13,6,7,0.992,1.871
2017/7/19,1245,10499,-36,44,37,7,0.996,0.845
2017/7/20,945,10396,-15,125,117,8,1.006,0.395
2017/7/20,1045,10383,-13,24,11,13,1.007,0.758
2017/7/20,1145,10387,5,9,3,6,1.006,2.786
2017/7/20,1245,10393,7,11,-4,15,1.005,3.193
2017/7/20,1345,10390,-3,15,5,10,1.005,1.464
2017/7/21,945,10331,-47,57,52,5,1.01,0.484
2017/7/21,1045,10340,8,25,12,13,1.008,1.062
2017/7/21,1145,10337,-3,16,6,10,1.006,2.415
2017/7/21,1245,10342,5,12,3,9,1.004,3.143
2017/7/21,1345,10329,-12,17,14,3,1.003,1.495
